id,name,hash,time,ind,otd,ad,bc
0_7347850,in-city_city10-2_city10,7347850,0,0,3,3,0
1_2937985,noop_in-city_city10-2_city10,2937985,1,1,1,2,0
1_7656764,drive-truck_truck10_city10-1_city10-2_city10,7656764,1,9,7,16,0
0_5132250,location_city4-1,5132250,0,0,3,3,0
1_2839184,noop_location_city4-1,2839184,1,1,1,2,0
1_4013645,drive-truck_truck4_city4-1_city4-2_city4,4013645,1,8,5,13,0
0_6497300,city_city9,6497300,0,0,3,3,0
1_4005501,noop_city_city9,4005501,1,1,1,2,0
1_5227117,drive-truck_truck9_city9-1_city9-2_city9,5227117,1,8,5,13,0
0_5132251,location_city4-2,5132251,0,0,3,3,0
1_2839185,noop_location_city4-2,2839185,1,1,1,2,0
0_1988052,in-city_city4-1_city4,1988052,0,0,3,3,0
1_7198704,noop_in-city_city4-1_city4,7198704,1,1,1,2,0
0_6461254,at_truck9_city9-1,6461254,0,0,2,2,0
1_3507679,noop_at_truck9_city9-1,3507679,1,2,4,6,0
0_323304,airport_city4-2,323304,0,0,73,73,0
1_1627007,noop_airport_city4-2,1627007,1,1,1,2,0
1_6883250,fly-airplane_plane1_city6-2_city4-2,6883250,1,13,105,118,0
1_799939,fly-airplane_plane2_city3-2_city4-2,799939,1,14,106,120,0
1_6022145,fly-airplane_plane3_city7-2_city4-2,6022145,1,14,106,120,0
1_2895747,fly-airplane_plane4_city3-2_city4-2,2895747,1,14,106,120,0
0_7586955,at_package5_city1-2,7586955,0,0,6,6,0
1_1731339,noop_at_package5_city1-2,1731339,1,1,6,7,0
0_5781406,in-city_city3-1_city3,5781406,0,0,3,3,0
1_2991081,noop_in-city_city3-1_city3,2991081,1,1,1,2,0
1_5371146,drive-truck_truck3_city3-1_city3-2_city3,5371146,1,8,6,14,0
0_6823957,at_package1_city2-2,6823957,0,0,6,6,0
1_968341,noop_at_package1_city2-2,968341,1,1,6,7,0
0_1642757,at_truck6_city6-1,1642757,0,0,2,2,0
1_6690159,noop_at_truck6_city6-1,6690159,1,2,4,6,0
1_1298643,drive-truck_truck6_city6-1_city6-2_city6,1298643,1,8,5,13,0
0_5328858,location_city7-1,5328858,0,0,3,3,0
1_3035792,noop_location_city7-1,3035792,1,1,1,2,0
1_7942119,drive-truck_truck7_city7-1_city7-2_city7,7942119,1,8,6,14,0
0_5328859,location_city7-2,5328859,0,0,9,9,0
1_3035793,noop_location_city7-2,3035793,1,1,1,2,0
1_7889752,load-airplane_package4_plane3_city7-2,7889752,1,15,111,126,0
0_7303760,at_package3_city3-2,7303760,0,0,6,6,0
1_1448144,noop_at_package3_city3-2,1448144,1,3,10,13,0
1_6416259,load-airplane_package3_plane2_city3-2,6416259,1,16,113,129,0
1_6830526,load-airplane_package3_plane4_city3-2,6830526,1,16,113,129,0
0_3557810,in-city_city3-2_city3,3557810,0,0,3,3,0
1_767485,noop_in-city_city3-2_city3,767485,1,1,1,2,0
0_3715160,airplane_plane1,3715160,0,0,95,95,0
1_5018863,noop_airplane_plane1,5018863,1,1,1,2,0
1_7079858,fly-airplane_plane1_city6-2_city7-2,7079858,1,13,105,118,0
1_6817714,fly-airplane_plane1_city6-2_city3-2,6817714,1,13,105,118,0
1_6752178,fly-airplane_plane1_city6-2_city2-2,6752178,1,13,105,118,0
1_7210930,fly-airplane_plane1_city6-2_city9-2,7210930,1,13,105,118,0
1_6948786,fly-airplane_plane1_city6-2_city5-2,6948786,1,13,105,118,0
1_6686642,fly-airplane_plane1_city6-2_city1-2,6686642,1,13,105,118,0
1_7767629,fly-airplane_plane1_city6-2_city10-2,7767629,1,13,105,118,0
1_7145394,fly-airplane_plane1_city6-2_city8-2,7145394,1,13,105,118,0
0_3715161,airplane_plane2,3715161,0,0,96,96,0
1_5018864,noop_airplane_plane2,5018864,1,1,1,2,0
1_996547,fly-airplane_plane2_city3-2_city7-2,996547,1,14,106,120,0
1_931011,fly-airplane_plane2_city3-2_city6-2,931011,1,14,106,120,0
1_668867,fly-airplane_plane2_city3-2_city2-2,668867,1,14,106,120,0
1_1127619,fly-airplane_plane2_city3-2_city9-2,1127619,1,14,106,120,0
1_865475,fly-airplane_plane2_city3-2_city5-2,865475,1,14,106,120,0
1_603331,fly-airplane_plane2_city3-2_city1-2,603331,1,14,106,120,0
1_2629551,fly-airplane_plane2_city3-2_city10-2,2629551,1,14,106,120,0
1_1062083,fly-airplane_plane2_city3-2_city8-2,1062083,1,14,106,120,0
0_7104561,city_city10,7104561,0,0,3,3,0
1_1281200,noop_city_city10,1281200,1,1,1,2,0
0_519912,airport_city7-2,519912,0,0,73,73,0
1_1823615,noop_airport_city7-2,1823615,1,1,1,2,0
1_5956609,fly-airplane_plane3_city7-2_city3-2,5956609,1,14,106,120,0
1_6153217,fly-airplane_plane3_city7-2_city6-2,6153217,1,14,106,120,0
1_5891073,fly-airplane_plane3_city7-2_city2-2,5891073,1,14,106,120,0
1_6349825,fly-airplane_plane3_city7-2_city9-2,6349825,1,14,106,120,0
1_6087681,fly-airplane_plane3_city7-2_city5-2,6087681,1,14,106,120,0
1_5825537,fly-airplane_plane3_city7-2_city1-2,5825537,1,14,106,120,0
1_3351128,fly-airplane_plane3_city7-2_city10-2,3351128,1,14,106,120,0
1_6284289,fly-airplane_plane3_city7-2_city8-2,6284289,1,14,106,120,0
1_3092355,fly-airplane_plane4_city3-2_city7-2,3092355,1,14,106,120,0
0_3715162,airplane_plane3,3715162,0,0,96,96,0
1_5018865,noop_airplane_plane3,5018865,1,1,1,2,0
0_7024213,in-city_city9-1_city9,7024213,0,0,3,3,0
1_4233888,noop_in-city_city9-1_city9,4233888,1,1,1,2,0
0_3715163,airplane_plane4,3715163,0,0,96,96,0
1_5018866,noop_airplane_plane4,5018866,1,1,1,2,0
1_3026819,fly-airplane_plane4_city3-2_city6-2,3026819,1,14,106,120,0
1_2764675,fly-airplane_plane4_city3-2_city2-2,2764675,1,14,106,120,0
1_3223427,fly-airplane_plane4_city3-2_city9-2,3223427,1,14,106,120,0
1_2961283,fly-airplane_plane4_city3-2_city5-2,2961283,1,14,106,120,0
1_2699139,fly-airplane_plane4_city3-2_city1-2,2699139,1,14,106,120,0
1_3090940,fly-airplane_plane4_city3-2_city10-2,3090940,1,14,106,120,0
1_3157891,fly-airplane_plane4_city3-2_city8-2,3157891,1,14,106,120,0
0_7351164,in-city_city2-2_city2,7351164,0,0,3,3,0
1_4560839,noop_in-city_city2-2_city2,4560839,1,1,1,2,0
1_6728647,drive-truck_truck2_city2-1_city2-2_city2,6728647,1,8,6,14,0
0_5066714,location_city3-1,5066714,0,0,3,3,0
1_2773648,noop_location_city3-1,2773648,1,1,1,2,0
0_5915915,at_truck7_city7-1,5915915,0,0,2,2,0
1_2962340,noop_at_truck7_city7-1,2962340,1,2,5,7,0
0_5066715,location_city3-2,5066715,0,0,10,10,0
1_2773649,noop_location_city3-2,2773649,1,1,1,2,0
0_4800617,in-city_city9-2_city9,4800617,0,0,3,3,0
1_2010292,noop_in-city_city9-2_city9,2010292,1,1,1,2,0
0_1097418,at_truck4_city4-1,1097418,0,0,2,2,0
1_6144820,noop_at_truck4_city4-1,6144820,1,2,4,6,0
0_257768,airport_city3-2,257768,0,0,73,73,0
1_1561471,noop_airport_city3-2,1561471,1,1,1,2,0
0_3973469,at_truck10_city10-1,3973469,0,0,4,4,0
1_6118830,noop_at_truck10_city10-1,6118830,1,2,4,6,0
1_7404958,load-truck_package2_truck10_city10-1,7404958,1,7,8,15,0
0_500169,at_plane2_city3-2,500169,0,0,12,12,0
1_5547571,noop_at_plane2_city3-2,5547571,1,10,103,113,0
0_2402321,in-city_city6-1_city6,2402321,0,0,3,3,0
1_7612973,noop_in-city_city6-1_city6,7612973,1,1,1,2,0
0_5263322,location_city6-1,5263322,0,0,3,3,0
1_2970256,noop_location_city6-1,2970256,1,1,1,2,0
0_5263323,location_city6-2,5263323,0,0,3,3,0
1_2970257,noop_location_city6-2,2970257,1,1,1,2,0
0_6195675,in-city_city5-1_city5,6195675,0,0,3,3,0
1_3405350,noop_in-city_city5-1_city5,3405350,1,1,1,2,0
1_2656144,drive-truck_truck5_city5-1_city5-2_city5,2656144,1,8,5,13,0
0_178725,in-city_city6-2_city6,178725,0,0,3,3,0
1_5389377,noop_in-city_city6-2_city6,5389377,1,1,1,2,0
0_5370576,at_truck5_city5-1,5370576,0,0,2,2,0
1_2417001,noop_at_truck5_city5-1,2417001,1,2,4,6,0
0_454376,airport_city6-2,454376,0,0,73,73,0
1_1758079,noop_airport_city6-2,1758079,1,1,1,2,0
0_5001178,location_city2-1,5001178,0,0,3,3,0
1_2708112,noop_location_city2-1,2708112,1,1,1,2,0
0_552079,at_truck2_city2-1,552079,0,0,2,2,0
1_5599481,noop_at_truck2_city2-1,5599481,1,2,5,7,0
0_3972079,in-city_city5-2_city5,3972079,0,0,3,3,0
1_1181754,noop_in-city_city5-2_city5,1181754,1,1,1,2,0
0_5001179,location_city2-2,5001179,0,0,8,8,0
1_2708113,noop_location_city2-2,2708113,1,1,1,2,0
0_5459930,location_city9-1,5459930,0,0,3,3,0
1_3166864,noop_location_city9-1,3166864,1,1,1,2,0
0_2661380,truck_truck1,2661380,0,0,4,4,0
1_62686,noop_truck_truck1,62686,1,1,1,2,0
1_85171,drive-truck_truck1_city1-1_city1-2_city1,85171,1,8,6,14,0
0_5459931,location_city9-2,5459931,0,0,3,3,0
1_3166865,noop_location_city9-2,3166865,1,1,1,2,0
0_2661381,truck_truck2,2661381,0,0,4,4,0
1_62687,noop_truck_truck2,62687,1,1,1,2,0
0_4490132,at_plane1_city6-2,4490132,0,0,10,10,0
1_1536557,noop_at_plane1_city6-2,1536557,1,10,104,114,0
0_518082,in-city_city10-1_city10,518082,0,0,3,3,0
1_4109194,noop_in-city_city10-1_city10,4109194,1,1,1,2,0
0_192232,airport_city2-2,192232,0,0,73,73,0
1_1495935,noop_airport_city2-2,1495935,1,1,1,2,0
0_2661382,truck_truck3,2661382,0,0,4,4,0
1_62688,noop_truck_truck3,62688,1,1,1,2,0
0_1573783,in-city_city2-1_city2,1573783,0,0,3,3,0
1_6784435,noop_in-city_city2-1_city2,6784435,1,1,1,2,0
0_7765433,in-city_city4-2_city4,7765433,0,0,3,3,0
1_4975108,noop_in-city_city4-2_city4,4975108,1,1,1,2,0
0_2661383,truck_truck4,2661383,0,0,3,3,0
1_62689,noop_truck_truck4,62689,1,1,1,2,0
0_1230283,truck_truck10,1230283,0,0,5,5,0
1_45710,noop_truck_truck10,45710,1,1,1,2,0
0_650984,airport_city9-2,650984,0,0,73,73,0
1_1954687,noop_airport_city9-2,1954687,1,1,1,2,0
0_2661384,truck_truck5,2661384,0,0,3,3,0
1_62690,noop_truck_truck5,62690,1,1,1,2,0
0_7160435,at_package2_city10-1,7160435,0,0,2,2,0
1_4305438,noop_at_package2_city10-1,4305438,1,2,4,6,0
0_4969935,at_plane3_city7-2,4969935,0,0,12,12,0
1_2016360,noop_at_plane3_city7-2,2016360,1,10,103,113,0
0_2661385,truck_truck6,2661385,0,0,3,3,0
1_62691,noop_truck_truck6,62691,1,1,1,2,0
0_914436,at_plane4_city3-2,914436,0,0,12,12,0
1_5961838,noop_at_plane4_city3-2,5961838,1,10,103,113,0
0_5197786,location_city5-1,5197786,0,0,3,3,0
1_2904720,noop_location_city5-1,2904720,1,1,1,2,0
0_2661386,truck_truck7,2661386,0,0,4,4,0
1_62692,noop_truck_truck7,62692,1,1,1,2,0
0_4825237,at_truck3_city3-1,4825237,0,0,2,2,0
1_1871662,noop_at_truck3_city3-1,1871662,1,2,5,7,0
0_5367137,in-city_city1-1_city1,5367137,0,0,3,3,0
1_2576812,noop_in-city_city1-1_city1,2576812,1,1,1,2,0
0_5197787,location_city5-2,5197787,0,0,3,3,0
1_2904721,noop_location_city5-2,2904721,1,1,1,2,0
0_2661387,truck_truck8,2661387,0,0,3,3,0
1_62693,noop_truck_truck8,62693,1,1,1,2,0
1_6584618,drive-truck_truck8_city8-1_city8-2_city8,6584618,1,8,5,13,0
0_2661388,truck_truck9,2661388,0,0,3,3,0
1_62694,noop_truck_truck9,62694,1,1,1,2,0
0_4435789,obj_package1,4435789,0,0,6,6,0
1_1837095,noop_obj_package1,1837095,1,1,1,2,0
0_2816590,in-city_city8-1_city8,2816590,0,0,3,3,0
1_26265,noop_in-city_city8-1_city8,26265,1,1,1,2,0
0_388840,airport_city5-2,388840,0,0,73,73,0
1_1692543,noop_airport_city5-2,1692543,1,1,1,2,0
0_4435790,obj_package2,4435790,0,0,3,3,0
1_1837096,noop_obj_package2,1837096,1,1,1,2,0
0_3143541,in-city_city1-2_city1,3143541,0,0,3,3,0
1_353216,noop_in-city_city1-2_city1,353216,1,1,1,2,0
0_4435791,obj_package3,4435791,0,0,8,8,0
1_1837097,noop_obj_package3,1837097,1,1,1,2,0
0_4935642,location_city1-1,4935642,0,0,3,3,0
1_2642576,noop_location_city1-1,2642576,1,1,1,2,0
0_6497292,city_city1,6497292,0,0,3,3,0
1_4005493,noop_city_city1,4005493,1,1,1,2,0
0_4435792,obj_package4,4435792,0,0,7,7,0
1_1837098,noop_obj_package4,1837098,1,1,1,2,0
0_4935643,location_city1-2,4935643,0,0,8,8,0
1_2642577,noop_location_city1-2,2642577,1,1,1,2,0
0_6497293,city_city2,6497293,0,0,3,3,0
1_4005494,noop_city_city2,4005494,1,1,1,2,0
0_4435793,obj_package5,4435793,0,0,6,6,0
1_1837099,noop_obj_package5,1837099,1,1,1,2,0
0_6609944,in-city_city7-1_city7,6609944,0,0,3,3,0
1_3819619,noop_in-city_city7-1_city7,3819619,1,1,1,2,0
0_592994,in-city_city8-2_city8,592994,0,0,3,3,0
1_5803646,noop_in-city_city8-2_city8,5803646,1,1,1,2,0
0_5394394,location_city8-1,5394394,0,0,3,3,0
1_3101328,noop_location_city8-1,3101328,1,1,1,2,0
0_6497294,city_city3,6497294,0,0,3,3,0
1_4005495,noop_city_city3,4005495,1,1,1,2,0
0_5394395,location_city8-2,5394395,0,0,3,3,0
1_3101329,noop_location_city8-2,3101329,1,1,1,2,0
0_6497295,city_city4,6497295,0,0,3,3,0
1_4005496,noop_city_city4,4005496,1,1,1,2,0
0_2188096,at_truck8_city8-1,2188096,0,0,2,2,0
1_7235498,noop_at_truck8_city8-1,7235498,1,2,4,6,0
0_126696,airport_city1-2,126696,0,0,73,73,0
1_1430399,noop_airport_city1-2,1430399,1,1,1,2,0
0_625646,airport_city10-2,625646,0,0,73,73,0
1_6333557,noop_airport_city10-2,6333557,1,1,1,2,0
0_7566596,location_city10-1,7566596,0,0,5,5,0
1_4613021,noop_location_city10-1,4613021,1,1,1,2,0
0_6497296,city_city5,6497296,0,0,3,3,0
1_4005497,noop_city_city5,4005497,1,1,1,2,0
0_7566597,location_city10-2,7566597,0,0,3,3,0
1_4613022,noop_location_city10-2,4613022,1,1,1,2,0
0_6497297,city_city6,6497297,0,0,3,3,0
1_4005498,noop_city_city6,4005498,1,1,1,2,0
0_4279898,at_truck1_city1-1,4279898,0,0,2,2,0
1_1326323,noop_at_truck1_city1-1,1326323,1,2,5,7,0
0_4386348,in-city_city7-2_city7,4386348,0,0,3,3,0
1_1596023,noop_in-city_city7-2_city7,1596023,1,1,1,2,0
0_585448,airport_city8-2,585448,0,0,73,73,0
1_1889151,noop_airport_city8-2,1889151,1,1,1,2,0
0_6497298,city_city7,6497298,0,0,3,3,0
1_4005499,noop_city_city7,4005499,1,1,1,2,0
0_3772549,at_package4_city7-2,3772549,0,0,6,6,0
1_5917910,noop_at_package4_city7-2,5917910,1,2,8,10,0
0_6497299,city_city8,6497299,0,0,3,3,0
1_4005500,noop_city_city8,4005500,1,1,1,2,0
0_4005500,noop_city_city8,4005500,0,0,1,1,0
1_6497299,city_city8,6497299,1,1,3,4,0
0_3405350,noop_in-city_city5-1_city5,3405350,0,0,1,1,0
1_6195675,in-city_city5-1_city5,6195675,1,1,3,4,0
0_1281200,noop_city_city10,1281200,0,0,1,1,0
1_7104561,city_city10,7104561,1,1,3,4,0
0_6883250,fly-airplane_plane1_city6-2_city4-2,6883250,0,0,10,10,0
1_4359060,at_plane1_city4-2,4359060,1,1,19,20,0
1_4490132,at_plane1_city6-2,4490132,1,9,19,28,0
0_1889151,noop_airport_city8-2,1889151,0,0,1,1,0
1_585448,airport_city8-2,585448,1,1,73,74,0
0_2417001,noop_at_truck5_city5-1,2417001,0,0,2,2,0
1_5370576,at_truck5_city5-1,5370576,1,2,2,4,0
0_4005501,noop_city_city9,4005501,0,0,1,1,0
1_6497300,city_city9,6497300,1,1,3,4,0
0_2629551,fly-airplane_plane2_city3-2_city10-2,2629551,0,0,11,11,0
1_6673463,at_plane2_city10-2,6673463,1,1,21,22,0
1_500169,at_plane2_city3-2,500169,1,9,21,30,0
0_7889752,load-airplane_package4_plane3_city7-2,7889752,0,0,11,11,0
1_2133321,in_package4_plane3,2133321,1,1,20,21,0
1_3772549,at_package4_city7-2,3772549,1,1,7,8,0
0_1181754,noop_in-city_city5-2_city5,1181754,0,0,1,1,0
1_3972079,in-city_city5-2_city5,3972079,1,1,3,4,0
0_7198704,noop_in-city_city4-1_city4,7198704,0,0,1,1,0
1_1988052,in-city_city4-1_city4,1988052,1,1,3,4,0
0_3092355,fly-airplane_plane4_city3-2_city7-2,3092355,0,0,11,11,0
1_1176580,at_plane4_city7-2,1176580,1,1,23,24,0
1_914436,at_plane4_city3-2,914436,1,9,21,30,0
0_2970256,noop_location_city6-1,2970256,0,0,1,1,0
1_5263322,location_city6-1,5263322,1,1,3,4,0
0_6333557,noop_airport_city10-2,6333557,0,0,1,1,0
1_625646,airport_city10-2,625646,1,1,73,74,0
0_1536557,noop_at_plane1_city6-2,1536557,0,0,10,10,0
0_2970257,noop_location_city6-2,2970257,0,0,1,1,0
1_5263323,location_city6-2,5263323,1,1,6,7,0
0_1627007,noop_airport_city4-2,1627007,0,0,1,1,0
1_323304,airport_city4-2,323304,1,1,73,74,0
0_4975108,noop_in-city_city4-2_city4,4975108,0,0,1,1,0
1_7765433,in-city_city4-2_city4,7765433,1,1,3,4,0
0_7079858,fly-airplane_plane1_city6-2_city7-2,7079858,0,0,11,11,0
1_4555668,at_plane1_city7-2,4555668,1,1,21,22,0
0_7404958,load-truck_package2_truck10_city10-1,7404958,0,0,3,3,0
1_1676676,in_package2_truck10,1676676,1,1,4,5,0
1_7160435,at_package2_city10-1,7160435,1,1,3,4,0
0_6690159,noop_at_truck6_city6-1,6690159,0,0,2,2,0
1_1642757,at_truck6_city6-1,1642757,1,2,2,4,0
0_5956609,fly-airplane_plane3_city7-2_city3-2,5956609,0,0,11,11,0
1_4707791,at_plane3_city3-2,4707791,1,1,23,24,0
1_4969935,at_plane3_city7-2,4969935,1,9,21,30,0
0_6416259,load-airplane_package3_plane2_city3-2,6416259,0,0,12,12,0
1_3304529,in_package3_plane2,3304529,1,1,21,22,0
1_7303760,at_package3_city3-2,7303760,1,2,8,10,0
0_5917910,noop_at_package4_city7-2,5917910,0,0,2,2,0
0_2016360,noop_at_plane3_city7-2,2016360,0,0,10,10,0
0_45710,noop_truck_truck10,45710,0,0,1,1,0
1_1230283,truck_truck10,1230283,1,1,6,7,0
0_931011,fly-airplane_plane2_city3-2_city6-2,931011,0,0,12,12,0
1_696777,at_plane2_city6-2,696777,1,1,21,22,0
0_2576812,noop_in-city_city1-1_city1,2576812,0,0,1,1,0
1_5367137,in-city_city1-1_city1,5367137,1,1,3,4,0
0_1871662,noop_at_truck3_city3-1,1871662,0,0,2,2,0
1_4825237,at_truck3_city3-1,4825237,1,2,2,4,0
0_2708112,noop_location_city2-1,2708112,0,0,1,1,0
1_5001178,location_city2-1,5001178,1,1,3,4,0
0_2708113,noop_location_city2-2,2708113,0,0,1,1,0
1_5001179,location_city2-2,5001179,1,1,16,17,0
0_5018863,noop_airplane_plane1,5018863,0,0,1,1,0
1_3715160,airplane_plane1,3715160,1,1,99,100,0
0_3166864,noop_location_city9-1,3166864,0,0,1,1,0
1_5459930,location_city9-1,5459930,1,1,3,4,0
0_5018864,noop_airplane_plane2,5018864,0,0,1,1,0
1_3715161,airplane_plane2,3715161,1,1,108,109,0
0_6817714,fly-airplane_plane1_city6-2_city3-2,6817714,0,0,11,11,0
1_4293524,at_plane1_city3-2,4293524,1,1,21,22,0
0_7656764,drive-truck_truck10_city10-1_city10-2_city10,7656764,0,0,3,3,0
1_3973470,at_truck10_city10-2,3973470,1,1,3,4,0
1_3973469,at_truck10_city10-1,3973469,1,1,4,5,0
0_26265,noop_in-city_city8-1_city8,26265,0,0,1,1,0
1_2816590,in-city_city8-1_city8,2816590,1,1,3,4,0
0_3166865,noop_location_city9-2,3166865,0,0,1,1,0
1_5459931,location_city9-2,5459931,1,1,6,7,0
0_5018865,noop_airplane_plane3,5018865,0,0,1,1,0
1_3715162,airplane_plane3,3715162,1,1,108,109,0
0_1823615,noop_airport_city7-2,1823615,0,0,1,1,0
1_519912,airport_city7-2,519912,1,1,73,74,0
0_353216,noop_in-city_city1-2_city1,353216,0,0,1,1,0
1_3143541,in-city_city1-2_city1,3143541,1,1,3,4,0
0_5018866,noop_airplane_plane4,5018866,0,0,1,1,0
1_3715163,airplane_plane4,3715163,1,1,108,109,0
0_668867,fly-airplane_plane2_city3-2_city2-2,668867,0,0,12,12,0
1_434633,at_plane2_city2-2,434633,1,1,23,24,0
0_6153217,fly-airplane_plane3_city7-2_city6-2,6153217,0,0,12,12,0
1_4904399,at_plane3_city6-2,4904399,1,1,21,22,0
0_5227117,drive-truck_truck9_city9-1_city9-2_city9,5227117,0,0,2,2,0
1_6461255,at_truck9_city9-2,6461255,1,1,2,3,0
1_6461254,at_truck9_city9-1,6461254,1,1,2,3,0
0_6584618,drive-truck_truck8_city8-1_city8-2_city8,6584618,0,0,2,2,0
1_2188097,at_truck8_city8-2,2188097,1,1,2,3,0
1_2188096,at_truck8_city8-1,2188096,1,1,2,3,0
0_3819619,noop_in-city_city7-1_city7,3819619,0,0,1,1,0
1_6609944,in-city_city7-1_city7,6609944,1,1,3,4,0
0_1127619,fly-airplane_plane2_city3-2_city9-2,1127619,0,0,12,12,0
1_893385,at_plane2_city9-2,893385,1,1,21,22,0
0_3026819,fly-airplane_plane4_city3-2_city6-2,3026819,0,0,12,12,0
1_1111044,at_plane4_city6-2,1111044,1,1,21,22,0
0_7942119,drive-truck_truck7_city7-1_city7-2_city7,7942119,0,0,2,2,0
1_5915916,at_truck7_city7-2,5915916,1,1,4,5,0
1_5915915,at_truck7_city7-1,5915915,1,1,2,3,0
0_2904720,noop_location_city5-1,2904720,0,0,1,1,0
1_5197786,location_city5-1,5197786,1,1,3,4,0
0_6144820,noop_at_truck4_city4-1,6144820,0,0,2,2,0
1_1097418,at_truck4_city4-1,1097418,1,2,2,4,0
0_4613021,noop_location_city10-1,4613021,0,0,1,1,0
1_7566596,location_city10-1,7566596,1,1,5,6,0
0_2904721,noop_location_city5-2,2904721,0,0,1,1,0
1_5197787,location_city5-2,5197787,1,1,6,7,0
0_5547571,noop_at_plane2_city3-2,5547571,0,0,10,10,0
0_1561471,noop_airport_city3-2,1561471,0,0,1,1,0
1_257768,airport_city3-2,257768,1,1,73,74,0
0_85171,drive-truck_truck1_city1-1_city1-2_city1,85171,0,0,2,2,0
1_4279899,at_truck1_city1-2,4279899,1,1,4,5,0
1_4279898,at_truck1_city1-1,4279898,1,1,2,3,0
0_4613022,noop_location_city10-2,4613022,0,0,1,1,0
1_7566597,location_city10-2,7566597,1,1,7,8,0
0_1596023,noop_in-city_city7-2_city7,1596023,0,0,1,1,0
1_4386348,in-city_city7-2_city7,4386348,1,1,3,4,0
0_1326323,noop_at_truck1_city1-1,1326323,0,0,2,2,0
0_7612973,noop_in-city_city6-1_city6,7612973,0,0,1,1,0
1_2402321,in-city_city6-1_city6,2402321,1,1,3,4,0
0_5891073,fly-airplane_plane3_city7-2_city2-2,5891073,0,0,12,12,0
1_4642255,at_plane3_city2-2,4642255,1,1,22,23,0
0_865475,fly-airplane_plane2_city3-2_city5-2,865475,0,0,12,12,0
1_631241,at_plane2_city5-2,631241,1,1,21,22,0
0_6349825,fly-airplane_plane3_city7-2_city9-2,6349825,0,0,12,12,0
1_5101007,at_plane3_city9-2,5101007,1,1,21,22,0
0_2764675,fly-airplane_plane4_city3-2_city2-2,2764675,0,0,12,12,0
1_848900,at_plane4_city2-2,848900,1,1,13,14,0
0_2642576,noop_location_city1-1,2642576,0,0,1,1,0
1_4935642,location_city1-1,4935642,1,1,3,4,0
0_6830526,load-airplane_package3_plane4_city3-2,6830526,0,0,13,13,0
1_3304531,in_package3_plane4,3304531,1,1,22,23,0
0_2642577,noop_location_city1-2,2642577,0,0,1,1,0
1_4935643,location_city1-2,4935643,1,1,16,17,0
0_5389377,noop_in-city_city6-2_city6,5389377,0,0,1,1,0
1_178725,in-city_city6-2_city6,178725,1,1,3,4,0
0_3223427,fly-airplane_plane4_city3-2_city9-2,3223427,0,0,12,12,0
1_1307652,at_plane4_city9-2,1307652,1,1,20,21,0
0_3101328,noop_location_city8-1,3101328,0,0,1,1,0
1_5394394,location_city8-1,5394394,1,1,3,4,0
0_6752178,fly-airplane_plane1_city6-2_city2-2,6752178,0,0,11,11,0
1_4227988,at_plane1_city2-2,4227988,1,1,21,22,0
0_3351128,fly-airplane_plane3_city7-2_city10-2,3351128,0,0,12,12,0
1_3692800,at_plane3_city10-2,3692800,1,1,11,12,0
0_3101329,noop_location_city8-2,3101329,0,0,1,1,0
1_5394395,location_city8-2,5394395,1,1,6,7,0
0_1758079,noop_airport_city6-2,1758079,0,0,1,1,0
1_454376,airport_city6-2,454376,1,1,73,74,0
0_3507679,noop_at_truck9_city9-1,3507679,0,0,2,2,0
0_7767629,fly-airplane_plane1_city6-2_city10-2,7767629,0,0,11,11,0
1_1653149,at_plane1_city10-2,1653149,1,1,19,20,0
0_6118830,noop_at_truck10_city10-1,6118830,0,0,2,2,0
0_7210930,fly-airplane_plane1_city6-2_city9-2,7210930,0,0,11,11,0
1_4686740,at_plane1_city9-2,4686740,1,1,19,20,0
0_5599481,noop_at_truck2_city2-1,5599481,0,0,2,2,0
1_552079,at_truck2_city2-1,552079,1,2,2,4,0
0_2991081,noop_in-city_city3-1_city3,2991081,0,0,1,1,0
1_5781406,in-city_city3-1_city3,5781406,1,1,3,4,0
0_603331,fly-airplane_plane2_city3-2_city1-2,603331,0,0,12,12,0
1_369097,at_plane2_city1-2,369097,1,1,23,24,0
0_6087681,fly-airplane_plane3_city7-2_city5-2,6087681,0,0,12,12,0
1_4838863,at_plane3_city5-2,4838863,1,1,21,22,0
0_1062083,fly-airplane_plane2_city3-2_city8-2,1062083,0,0,12,12,0
1_827849,at_plane2_city8-2,827849,1,1,21,22,0
0_2961283,fly-airplane_plane4_city3-2_city5-2,2961283,0,0,12,12,0
1_1045508,at_plane4_city5-2,1045508,1,1,21,22,0
0_2839184,noop_location_city4-1,2839184,0,0,1,1,0
1_5132250,location_city4-1,5132250,1,1,3,4,0
0_6784435,noop_in-city_city2-1_city2,6784435,0,0,1,1,0
1_1573783,in-city_city2-1_city2,1573783,1,1,3,4,0
0_1495935,noop_airport_city2-2,1495935,0,0,1,1,0
1_192232,airport_city2-2,192232,1,1,73,74,0
0_767485,noop_in-city_city3-2_city3,767485,0,0,1,1,0
1_3557810,in-city_city3-2_city3,3557810,1,1,3,4,0
0_2839185,noop_location_city4-2,2839185,0,0,1,1,0
1_5132251,location_city4-2,5132251,1,1,6,7,0
0_2937985,noop_in-city_city10-2_city10,2937985,0,0,1,1,0
1_7347850,in-city_city10-2_city10,7347850,1,1,3,4,0
0_62686,noop_truck_truck1,62686,0,0,1,1,0
1_2661380,truck_truck1,2661380,1,1,5,6,0
0_6948786,fly-airplane_plane1_city6-2_city5-2,6948786,0,0,11,11,0
1_4424596,at_plane1_city5-2,4424596,1,1,19,20,0
0_1954687,noop_airport_city9-2,1954687,0,0,1,1,0
1_650984,airport_city9-2,650984,1,1,73,74,0
0_62687,noop_truck_truck2,62687,0,0,1,1,0
1_2661381,truck_truck2,2661381,1,1,5,6,0
0_5825537,fly-airplane_plane3_city7-2_city1-2,5825537,0,0,12,12,0
1_4576719,at_plane3_city1-2,4576719,1,1,23,24,0
0_5961838,noop_at_plane4_city3-2,5961838,0,0,10,10,0
0_4305438,noop_at_package2_city10-1,4305438,0,0,2,2,0
0_62688,noop_truck_truck3,62688,0,0,1,1,0
1_2661382,truck_truck3,2661382,1,1,5,6,0
0_4233888,noop_in-city_city9-1_city9,4233888,0,0,1,1,0
1_7024213,in-city_city9-1_city9,7024213,1,1,3,4,0
0_62689,noop_truck_truck4,62689,0,0,1,1,0
1_2661383,truck_truck4,2661383,1,1,3,4,0
0_4560839,noop_in-city_city2-2_city2,4560839,0,0,1,1,0
1_7351164,in-city_city2-2_city2,7351164,1,1,3,4,0
0_1731339,noop_at_package5_city1-2,1731339,0,0,1,1,0
1_7586955,at_package5_city1-2,7586955,1,1,6,7,0
0_799939,fly-airplane_plane2_city3-2_city4-2,799939,0,0,12,12,0
1_565705,at_plane2_city4-2,565705,1,1,11,12,0
0_6284289,fly-airplane_plane3_city7-2_city8-2,6284289,0,0,12,12,0
1_5035471,at_plane3_city8-2,5035471,1,1,21,22,0
0_2699139,fly-airplane_plane4_city3-2_city1-2,2699139,0,0,12,12,0
1_783364,at_plane4_city1-2,783364,1,1,23,24,0
0_62690,noop_truck_truck5,62690,0,0,1,1,0
1_2661384,truck_truck5,2661384,1,1,3,4,0
0_2962340,noop_at_truck7_city7-1,2962340,0,0,2,2,0
0_3090940,fly-airplane_plane4_city3-2_city10-2,3090940,0,0,12,12,0
1_712137,at_plane4_city10-2,712137,1,1,21,22,0
0_62691,noop_truck_truck6,62691,0,0,1,1,0
1_2661385,truck_truck6,2661385,1,1,3,4,0
0_968341,noop_at_package1_city2-2,968341,0,0,1,1,0
1_6823957,at_package1_city2-2,6823957,1,1,6,7,0
0_3157891,fly-airplane_plane4_city3-2_city8-2,3157891,0,0,12,12,0
1_1242116,at_plane4_city8-2,1242116,1,1,21,22,0
0_62692,noop_truck_truck7,62692,0,0,1,1,0
1_2661386,truck_truck7,2661386,1,1,5,6,0
0_2010292,noop_in-city_city9-2_city9,2010292,0,0,1,1,0
1_4800617,in-city_city9-2_city9,4800617,1,1,3,4,0
0_3035792,noop_location_city7-1,3035792,0,0,1,1,0
1_5328858,location_city7-1,5328858,1,1,3,4,0
0_6686642,fly-airplane_plane1_city6-2_city1-2,6686642,0,0,11,11,0
1_4162452,at_plane1_city1-2,4162452,1,1,12,13,0
0_4005493,noop_city_city1,4005493,0,0,1,1,0
1_6497292,city_city1,6497292,1,1,3,4,0
0_1692543,noop_airport_city5-2,1692543,0,0,1,1,0
1_388840,airport_city5-2,388840,1,1,73,74,0
0_62693,noop_truck_truck8,62693,0,0,1,1,0
1_2661387,truck_truck8,2661387,1,1,3,4,0
0_3035793,noop_location_city7-2,3035793,0,0,1,1,0
1_5328859,location_city7-2,5328859,1,1,15,16,0
0_1298643,drive-truck_truck6_city6-1_city6-2_city6,1298643,0,0,3,3,0
1_1642758,at_truck6_city6-2,1642758,1,1,2,3,0
0_4005494,noop_city_city2,4005494,0,0,1,1,0
1_6497293,city_city2,6497293,1,1,3,4,0
0_62694,noop_truck_truck9,62694,0,0,1,1,0
1_2661388,truck_truck9,2661388,1,1,3,4,0
0_4109194,noop_in-city_city10-1_city10,4109194,0,0,1,1,0
1_518082,in-city_city10-1_city10,518082,1,1,3,4,0
0_1448144,noop_at_package3_city3-2,1448144,0,0,3,3,0
0_7145394,fly-airplane_plane1_city6-2_city8-2,7145394,0,0,11,11,0
1_4621204,at_plane1_city8-2,4621204,1,1,18,19,0
0_2656144,drive-truck_truck5_city5-1_city5-2_city5,2656144,0,0,3,3,0
1_5370577,at_truck5_city5-2,5370577,1,1,2,3,0
0_4005495,noop_city_city3,4005495,0,0,1,1,0
1_6497294,city_city3,6497294,1,1,3,4,0
0_1837095,noop_obj_package1,1837095,0,0,1,1,0
1_4435789,obj_package1,4435789,1,1,11,12,0
0_6022145,fly-airplane_plane3_city7-2_city4-2,6022145,0,0,12,12,0
1_4773327,at_plane3_city4-2,4773327,1,1,21,22,0
0_4013645,drive-truck_truck4_city4-1_city4-2_city4,4013645,0,0,3,3,0
1_1097419,at_truck4_city4-2,1097419,1,1,2,3,0
0_4005496,noop_city_city4,4005496,0,0,1,1,0
1_6497295,city_city4,6497295,1,1,3,4,0
0_5803646,noop_in-city_city8-2_city8,5803646,0,0,1,1,0
1_592994,in-city_city8-2_city8,592994,1,1,3,4,0
0_1837096,noop_obj_package2,1837096,0,0,1,1,0
1_4435790,obj_package2,4435790,1,1,4,5,0
0_5371146,drive-truck_truck3_city3-1_city3-2_city3,5371146,0,0,3,3,0
1_4825238,at_truck3_city3-2,4825238,1,1,4,5,0
0_4005497,noop_city_city5,4005497,0,0,1,1,0
1_6497296,city_city5,6497296,1,1,3,4,0
0_1837097,noop_obj_package3,1837097,0,0,1,1,0
1_4435791,obj_package3,4435791,1,1,29,30,0
0_996547,fly-airplane_plane2_city3-2_city7-2,996547,0,0,12,12,0
1_762313,at_plane2_city7-2,762313,1,1,22,23,0
0_2895747,fly-airplane_plane4_city3-2_city4-2,2895747,0,0,12,12,0
1_979972,at_plane4_city4-2,979972,1,1,21,22,0
0_6728647,drive-truck_truck2_city2-1_city2-2_city2,6728647,0,0,3,3,0
1_552080,at_truck2_city2-2,552080,1,1,4,5,0
0_4005498,noop_city_city6,4005498,0,0,1,1,0
1_6497297,city_city6,6497297,1,1,3,4,0
0_7235498,noop_at_truck8_city8-1,7235498,0,0,2,2,0
0_1837098,noop_obj_package4,1837098,0,0,1,1,0
1_4435792,obj_package4,4435792,1,1,20,21,0
0_2773648,noop_location_city3-1,2773648,0,0,1,1,0
1_5066714,location_city3-1,5066714,1,1,3,4,0
0_4005499,noop_city_city7,4005499,0,0,1,1,0
1_6497298,city_city7,6497298,1,1,3,4,0
0_1430399,noop_airport_city1-2,1430399,0,0,1,1,0
1_126696,airport_city1-2,126696,1,1,73,74,0
0_1837099,noop_obj_package5,1837099,0,0,1,1,0
1_4435793,obj_package5,4435793,1,1,11,12,0
0_2773649,noop_location_city3-2,2773649,0,0,1,1,0
1_5066715,location_city3-2,5066715,1,1,14,15,0
2_7670415,noop_at_plane3_city10-2,7670415,2,106,119,225,0
2_4181684,fly-airplane_plane3_city10-2_city4-2,4181684,2,109,121,230,0
2_4378292,fly-airplane_plane3_city10-2_city7-2,4378292,2,109,121,230,0
2_4116148,fly-airplane_plane3_city10-2_city3-2,4116148,2,109,121,230,0
2_4312756,fly-airplane_plane3_city10-2_city6-2,4312756,2,109,121,230,0
2_4050612,fly-airplane_plane3_city10-2_city2-2,4050612,2,109,121,230,0
2_4509364,fly-airplane_plane3_city10-2_city9-2,4509364,2,109,121,230,0
2_4247220,fly-airplane_plane3_city10-2_city5-2,4247220,2,109,121,230,0
2_3985076,fly-airplane_plane3_city10-2_city1-2,3985076,2,109,121,230,0
2_4443828,fly-airplane_plane3_city10-2_city8-2,4443828,2,109,121,230,0
2_4904399,at_plane3_city6-2,4904399,2,28,28,56,0
2_4707791,at_plane3_city3-2,4707791,2,28,27,55,0
2_4969935,at_plane3_city7-2,4969935,2,27,28,55,0
2_4773327,at_plane3_city4-2,4773327,2,28,28,56,0
2_2133321,in_package4_plane3,2133321,2,12,19,31,0
2_5035471,at_plane3_city8-2,5035471,2,28,28,56,0
2_4576719,at_plane3_city1-2,4576719,2,28,28,56,0
2_4838863,at_plane3_city5-2,4838863,2,28,28,56,0
2_5101007,at_plane3_city9-2,5101007,2,28,28,56,0
2_4642255,at_plane3_city2-2,4642255,2,28,27,55,0
2_5896302,noop_at_plane4_city2-2,5896302,2,105,116,221,0
2_5852660,fly-airplane_plane4_city2-2_city4-2,5852660,2,109,120,229,0
2_6049268,fly-airplane_plane4_city2-2_city7-2,6049268,2,109,120,229,0
2_5787124,fly-airplane_plane4_city2-2_city3-2,5787124,2,109,120,229,0
2_5983732,fly-airplane_plane4_city2-2_city6-2,5983732,2,109,120,229,0
2_6180340,fly-airplane_plane4_city2-2_city9-2,6180340,2,109,120,229,0
2_5918196,fly-airplane_plane4_city2-2_city5-2,5918196,2,109,120,229,0
2_7968830,fly-airplane_plane4_city2-2_city10-2,7968830,2,109,120,229,0
2_5656052,fly-airplane_plane4_city2-2_city1-2,5656052,2,109,120,229,0
2_6114804,fly-airplane_plane4_city2-2_city8-2,6114804,2,109,120,229,0
2_4756559,load-airplane_package1_plane4_city2-2,4756559,2,114,132,246,0
2_1111044,at_plane4_city6-2,1111044,2,28,28,56,0
2_712137,at_plane4_city10-2,712137,2,28,29,57,0
2_914436,at_plane4_city3-2,914436,2,27,28,55,0
2_3304531,in_package3_plane4,3304531,2,13,19,32,0
2_1176580,at_plane4_city7-2,1176580,2,28,27,55,0
2_979972,at_plane4_city4-2,979972,2,28,28,56,0
2_1242116,at_plane4_city8-2,1242116,2,28,28,56,0
2_783364,at_plane4_city1-2,783364,2,28,28,56,0
2_1045508,at_plane4_city5-2,1045508,2,28,28,56,0
2_1307652,at_plane4_city9-2,1307652,2,28,26,54,0
2_4005501,noop_city_city9,4005501,2,1,1,2,0
2_5227117,drive-truck_truck9_city9-1_city9-2_city9,5227117,2,10,5,15,0
2_2469652,drive-truck_truck9_city9-2_city9-1_city9,2469652,2,10,5,15,0
2_2839184,noop_location_city4-1,2839184,2,1,1,2,0
2_4013645,drive-truck_truck4_city4-1_city4-2_city4,4013645,2,10,5,15,0
2_1256180,drive-truck_truck4_city4-2_city4-1_city4,1256180,2,10,5,15,0
2_2937985,noop_in-city_city10-2_city10,2937985,2,1,1,2,0
2_7656764,drive-truck_truck10_city10-1_city10-2_city10,7656764,2,12,8,20,0
2_1874900,drive-truck_truck10_city10-2_city10-1_city10,1874900,2,13,8,21,0
2_2839185,noop_location_city4-2,2839185,2,1,1,2,0
2_1208877,noop_at_plane1_city1-2,1208877,2,103,109,212,0
2_5665861,fly-airplane_plane1_city1-2_city4-2,5665861,2,107,112,219,0
2_5862469,fly-airplane_plane1_city1-2_city7-2,5862469,2,107,112,219,0
2_5600325,fly-airplane_plane1_city1-2_city3-2,5600325,2,107,112,219,0
2_5796933,fly-airplane_plane1_city1-2_city6-2,5796933,2,107,112,219,0
2_5534789,fly-airplane_plane1_city1-2_city2-2,5534789,2,107,112,219,0
2_5993541,fly-airplane_plane1_city1-2_city9-2,5993541,2,107,112,219,0
2_5731397,fly-airplane_plane1_city1-2_city5-2,5731397,2,107,112,219,0
2_153171,fly-airplane_plane1_city1-2_city10-2,153171,2,107,112,219,0
2_5928005,fly-airplane_plane1_city1-2_city8-2,5928005,2,107,112,219,0
2_4085996,load-airplane_package5_plane1_city1-2,4085996,2,112,125,237,0
2_1653149,at_plane1_city10-2,1653149,2,27,30,57,0
2_4424596,at_plane1_city5-2,4424596,2,27,29,56,0
2_4686740,at_plane1_city9-2,4686740,2,27,29,56,0
2_4227988,at_plane1_city2-2,4227988,2,27,29,56,0
2_4490132,at_plane1_city6-2,4490132,2,27,29,56,0
2_4293524,at_plane1_city3-2,4293524,2,27,28,55,0
2_4555668,at_plane1_city7-2,4555668,2,27,28,55,0
2_4359060,at_plane1_city4-2,4359060,2,27,29,56,0
2_4621204,at_plane1_city8-2,4621204,2,27,27,54,0
2_6355054,noop_at_plane4_city9-2,6355054,2,106,119,225,0
2_1156223,fly-airplane_plane4_city9-2_city4-2,1156223,2,109,121,230,0
2_1352831,fly-airplane_plane4_city9-2_city7-2,1352831,2,109,121,230,0
2_1090687,fly-airplane_plane4_city9-2_city3-2,1090687,2,109,121,230,0
2_1287295,fly-airplane_plane4_city9-2_city6-2,1287295,2,109,121,230,0
2_1025151,fly-airplane_plane4_city9-2_city2-2,1025151,2,109,121,230,0
2_1221759,fly-airplane_plane4_city9-2_city5-2,1221759,2,109,121,230,0
2_5827508,fly-airplane_plane4_city9-2_city10-2,5827508,2,109,121,230,0
2_959615,fly-airplane_plane4_city9-2_city1-2,959615,2,109,121,230,0
2_1418367,fly-airplane_plane4_city9-2_city8-2,1418367,2,109,121,230,0
2_848900,at_plane4_city2-2,848900,2,28,17,45,0
2_7198704,noop_in-city_city4-1_city4,7198704,2,1,1,2,0
2_1667629,noop_at_plane1_city8-2,1667629,2,104,112,216,0
2_969424,fly-airplane_plane1_city8-2_city4-2,969424,2,107,113,220,0
2_1166032,fly-airplane_plane1_city8-2_city7-2,1166032,2,107,113,220,0
2_903888,fly-airplane_plane1_city8-2_city3-2,903888,2,107,113,220,0
2_1100496,fly-airplane_plane1_city8-2_city6-2,1100496,2,107,113,220,0
2_838352,fly-airplane_plane1_city8-2_city2-2,838352,2,107,113,220,0
2_1297104,fly-airplane_plane1_city8-2_city9-2,1297104,2,107,113,220,0
2_1034960,fly-airplane_plane1_city8-2_city5-2,1034960,2,107,113,220,0
2_6012826,fly-airplane_plane1_city8-2_city10-2,6012826,2,107,113,220,0
2_772816,fly-airplane_plane1_city8-2_city1-2,772816,2,107,113,220,0
2_4162452,at_plane1_city1-2,4162452,2,27,17,44,0
2_1627007,noop_airport_city4-2,1627007,2,1,1,2,0
2_4992707,fly-airplane_plane1_city4-2_city7-2,4992707,2,107,113,220,0
2_4730563,fly-airplane_plane1_city4-2_city3-2,4730563,2,107,113,220,0
2_4927171,fly-airplane_plane1_city4-2_city6-2,4927171,2,107,113,220,0
2_4665027,fly-airplane_plane1_city4-2_city2-2,4665027,2,107,113,220,0
2_5123779,fly-airplane_plane1_city4-2_city9-2,5123779,2,107,113,220,0
2_4861635,fly-airplane_plane1_city4-2_city5-2,4861635,2,107,113,220,0
2_1521455,fly-airplane_plane1_city4-2_city10-2,1521455,2,107,113,220,0
2_4599491,fly-airplane_plane1_city4-2_city1-2,4599491,2,107,113,220,0
2_5058243,fly-airplane_plane1_city4-2_city8-2,5058243,2,107,113,220,0
2_3926337,fly-airplane_plane1_city7-2_city4-2,3926337,2,107,112,219,0
2_7753012,fly-airplane_plane1_city3-2_city4-2,7753012,2,107,112,219,0
2_6883250,fly-airplane_plane1_city6-2_city4-2,6883250,2,107,113,220,0
2_2708948,fly-airplane_plane1_city2-2_city4-2,2708948,2,107,112,219,0
2_6013488,fly-airplane_plane1_city9-2_city4-2,6013488,2,107,113,220,0
2_1839186,fly-airplane_plane1_city5-2_city4-2,1839186,2,107,113,220,0
2_3720295,fly-airplane_plane1_city10-2_city4-2,3720295,2,107,113,220,0
2_6040611,fly-airplane_plane2_city4-2_city7-2,6040611,2,109,121,230,0
2_5778467,fly-airplane_plane2_city4-2_city3-2,5778467,2,109,121,230,0
2_5975075,fly-airplane_plane2_city4-2_city6-2,5975075,2,109,121,230,0
2_5712931,fly-airplane_plane2_city4-2_city2-2,5712931,2,109,121,230,0
2_6171683,fly-airplane_plane2_city4-2_city9-2,6171683,2,109,121,230,0
2_5909539,fly-airplane_plane2_city4-2_city5-2,5909539,2,109,121,230,0
2_5752638,fly-airplane_plane2_city4-2_city10-2,5752638,2,109,121,230,0
2_5647395,fly-airplane_plane2_city4-2_city1-2,5647395,2,109,121,230,0
2_6106147,fly-airplane_plane2_city4-2_city8-2,6106147,2,109,121,230,0
2_4974241,fly-airplane_plane2_city7-2_city4-2,4974241,2,109,120,229,0
2_799939,fly-airplane_plane2_city3-2_city4-2,799939,2,108,121,229,0
2_7931154,fly-airplane_plane2_city6-2_city4-2,7931154,2,109,121,230,0
2_3756852,fly-airplane_plane2_city2-2_city4-2,3756852,2,109,120,229,0
2_7061392,fly-airplane_plane2_city9-2_city4-2,7061392,2,109,121,230,0
2_2887090,fly-airplane_plane2_city5-2_city4-2,2887090,2,109,121,230,0
2_7951478,fly-airplane_plane2_city10-2_city4-2,7951478,2,109,121,230,0
2_6713765,fly-airplane_plane2_city1-2_city4-2,6713765,2,109,120,229,0
2_2017328,fly-airplane_plane2_city8-2_city4-2,2017328,2,109,121,230,0
2_7088515,fly-airplane_plane3_city4-2_city7-2,7088515,2,109,121,230,0
2_6826371,fly-airplane_plane3_city4-2_city3-2,6826371,2,109,121,230,0
2_7022979,fly-airplane_plane3_city4-2_city6-2,7022979,2,109,121,230,0
2_6760835,fly-airplane_plane3_city4-2_city2-2,6760835,2,109,121,230,0
2_7219587,fly-airplane_plane3_city4-2_city9-2,7219587,2,109,121,230,0
2_6957443,fly-airplane_plane3_city4-2_city5-2,6957443,2,109,121,230,0
2_1982844,fly-airplane_plane3_city4-2_city10-2,1982844,2,109,121,230,0
2_6695299,fly-airplane_plane3_city4-2_city1-2,6695299,2,109,121,230,0
2_7154051,fly-airplane_plane3_city4-2_city8-2,7154051,2,109,121,230,0
2_6022145,fly-airplane_plane3_city7-2_city4-2,6022145,2,108,121,229,0
2_1847843,fly-airplane_plane3_city3-2_city4-2,1847843,2,109,120,229,0
2_978081,fly-airplane_plane3_city6-2_city4-2,978081,2,109,121,230,0
2_4804756,fly-airplane_plane3_city2-2_city4-2,4804756,2,109,120,229,0
2_108319,fly-airplane_plane3_city9-2_city4-2,108319,2,109,121,230,0
2_3934994,fly-airplane_plane3_city5-2_city4-2,3934994,2,109,121,230,0
2_7761669,fly-airplane_plane3_city1-2_city4-2,7761669,2,109,120,229,0
2_3065232,fly-airplane_plane3_city8-2_city4-2,3065232,2,109,121,230,0
2_135442,fly-airplane_plane4_city4-2_city7-2,135442,2,109,121,230,0
2_7874275,fly-airplane_plane4_city4-2_city3-2,7874275,2,109,121,230,0
2_69906,fly-airplane_plane4_city4-2_city6-2,69906,2,109,121,230,0
2_7808739,fly-airplane_plane4_city4-2_city2-2,7808739,2,109,121,230,0
2_266514,fly-airplane_plane4_city4-2_city9-2,266514,2,109,121,230,0
2_4370,fly-airplane_plane4_city4-2_city5-2,4370,2,109,121,230,0
2_6214027,fly-airplane_plane4_city4-2_city10-2,6214027,2,109,121,230,0
2_7743203,fly-airplane_plane4_city4-2_city1-2,7743203,2,109,121,230,0
2_200978,fly-airplane_plane4_city4-2_city8-2,200978,2,109,121,230,0
2_7070049,fly-airplane_plane4_city7-2_city4-2,7070049,2,109,120,229,0
2_2895747,fly-airplane_plane4_city3-2_city4-2,2895747,2,108,121,229,0
2_2025985,fly-airplane_plane4_city6-2_city4-2,2025985,2,109,121,230,0
2_4982898,fly-airplane_plane4_city5-2_city4-2,4982898,2,109,121,230,0
2_411890,fly-airplane_plane4_city10-2_city4-2,411890,2,109,121,230,0
2_808596,fly-airplane_plane4_city1-2_city4-2,808596,2,109,120,229,0
2_4113136,fly-airplane_plane4_city8-2_city4-2,4113136,2,109,121,230,0
2_3507679,noop_at_truck9_city9-1,3507679,2,4,4,8,0
2_6461255,at_truck9_city9-2,6461255,2,3,4,7,0
2_5613107,noop_at_plane2_city4-2,5613107,2,106,119,225,0
2_827849,at_plane2_city8-2,827849,2,28,28,56,0
2_369097,at_plane2_city1-2,369097,2,28,28,56,0
2_631241,at_plane2_city5-2,631241,2,28,28,56,0
2_893385,at_plane2_city9-2,893385,2,28,28,56,0
2_434633,at_plane2_city2-2,434633,2,28,28,56,0
2_3304529,in_package3_plane2,3304529,2,13,19,32,0
2_696777,at_plane2_city6-2,696777,2,28,28,56,0
2_500169,at_plane2_city3-2,500169,2,27,28,55,0
2_6673463,at_plane2_city10-2,6673463,2,28,29,57,0
2_762313,at_plane2_city7-2,762313,2,28,27,55,0
2_1688680,noop_at_plane3_city2-2,1688680,2,105,116,221,0
2_5001364,fly-airplane_plane3_city2-2_city7-2,5001364,2,109,120,229,0
2_4739220,fly-airplane_plane3_city2-2_city3-2,4739220,2,109,120,229,0
2_4935828,fly-airplane_plane3_city2-2_city6-2,4935828,2,109,120,229,0
2_5132436,fly-airplane_plane3_city2-2_city9-2,5132436,2,109,120,229,0
2_4870292,fly-airplane_plane3_city2-2_city5-2,4870292,2,109,120,229,0
2_3737647,fly-airplane_plane3_city2-2_city10-2,3737647,2,109,120,229,0
2_4608148,fly-airplane_plane3_city2-2_city1-2,4608148,2,109,120,229,0
2_5066900,fly-airplane_plane3_city2-2_city8-2,5066900,2,109,120,229,0
2_548937,load-airplane_package1_plane3_city2-2,548937,2,114,132,246,0
2_3692800,at_plane3_city10-2,3692800,2,28,17,45,0
2_3507680,noop_at_truck9_city9-2,3507680,2,4,4,8,0
2_6461254,at_truck9_city9-1,6461254,2,3,2,5,0
2_1731339,noop_at_package5_city1-2,1731339,2,6,16,22,0
2_292641,load-airplane_package5_plane2_city1-2,292641,2,114,132,246,0
2_4500263,load-airplane_package5_plane3_city1-2,4500263,2,114,132,246,0
2_706908,load-airplane_package5_plane4_city1-2,706908,2,114,132,246,0
2_4934766,load-truck_package5_truck1_city1-2,4934766,2,13,20,33,0
2_2991081,noop_in-city_city3-1_city3,2991081,2,1,1,2,0
2_5371146,drive-truck_truck3_city3-1_city3-2_city3,5371146,2,11,8,19,0
2_2613681,drive-truck_truck3_city3-2_city3-1_city3,2613681,2,11,7,18,0
2_2147432,noop_at_plane3_city9-2,2147432,2,106,119,225,0
2_304927,fly-airplane_plane3_city9-2_city7-2,304927,2,109,121,230,0
2_42783,fly-airplane_plane3_city9-2_city3-2,42783,2,109,121,230,0
2_239391,fly-airplane_plane3_city9-2_city6-2,239391,2,109,121,230,0
2_7978224,fly-airplane_plane3_city9-2_city2-2,7978224,2,109,121,230,0
2_173855,fly-airplane_plane3_city9-2_city5-2,173855,2,109,121,230,0
2_1596325,fly-airplane_plane3_city9-2_city10-2,1596325,2,109,121,230,0
2_7912688,fly-airplane_plane3_city9-2_city1-2,7912688,2,109,121,230,0
2_370463,fly-airplane_plane3_city9-2_city8-2,370463,2,109,121,230,0
2_6690159,noop_at_truck6_city6-1,6690159,2,4,4,8,0
2_1298643,drive-truck_truck6_city6-1_city6-2_city6,1298643,2,10,5,15,0
2_1642758,at_truck6_city6-2,1642758,2,3,4,7,0
2_968341,noop_at_package1_city2-2,968341,2,6,16,22,0
2_134670,load-airplane_package1_plane1_city2-2,134670,2,112,125,237,0
2_4342292,load-airplane_package1_plane2_city2-2,4342292,2,114,132,246,0
2_5191062,load-truck_package1_truck2_city2-2,5191062,2,13,20,33,0
2_6092910,noop_at_plane4_city5-2,6092910,2,106,119,225,0
2_5179506,fly-airplane_plane4_city5-2_city7-2,5179506,2,109,121,230,0
2_4917362,fly-airplane_plane4_city5-2_city3-2,4917362,2,109,121,230,0
2_5113970,fly-airplane_plane4_city5-2_city6-2,5113970,2,109,121,230,0
2_4851826,fly-airplane_plane4_city5-2_city2-2,4851826,2,109,121,230,0
2_5310578,fly-airplane_plane4_city5-2_city9-2,5310578,2,109,121,230,0
2_1336137,fly-airplane_plane4_city5-2_city10-2,1336137,2,109,121,230,0
2_4786290,fly-airplane_plane4_city5-2_city1-2,4786290,2,109,121,230,0
2_5245042,fly-airplane_plane4_city5-2_city8-2,5245042,2,109,121,230,0
2_6690160,noop_at_truck6_city6-2,6690160,2,4,4,8,0
2_6542155,drive-truck_truck6_city6-2_city6-1_city6,6542155,2,10,5,15,0
2_1642757,at_truck6_city6-1,1642757,2,3,2,5,0
2_3035792,noop_location_city7-1,3035792,2,1,1,2,0
2_7942119,drive-truck_truck7_city7-1_city7-2_city7,7942119,2,11,8,19,0
2_5184654,drive-truck_truck7_city7-2_city7-1_city7,5184654,2,11,7,18,0
2_3035793,noop_location_city7-2,3035793,2,1,1,2,0
2_4876640,unload-airplane_package4_plane3_city7-2,4876640,2,114,134,248,0
2_7475485,load-airplane_package4_plane1_city7-2,7475485,2,114,134,248,0
2_3682130,load-airplane_package4_plane2_city7-2,3682130,2,116,141,257,0
2_7889752,load-airplane_package4_plane3_city7-2,7889752,2,114,134,248,0
2_4096397,load-airplane_package4_plane4_city7-2,4096397,2,116,141,257,0
2_1566079,load-truck_package4_truck7_city7-2,1566079,2,15,29,44,0
2_1405485,noop_at_plane1_city4-2,1405485,2,104,112,216,0
2_5018863,noop_airplane_plane1,5018863,2,1,1,2,0
2_3860801,fly-airplane_plane1_city7-2_city3-2,3860801,2,107,112,219,0
2_4057409,fly-airplane_plane1_city7-2_city6-2,4057409,2,107,112,219,0
2_3795265,fly-airplane_plane1_city7-2_city2-2,3795265,2,107,112,219,0
2_4254017,fly-airplane_plane1_city7-2_city9-2,4254017,2,107,112,219,0
2_3991873,fly-airplane_plane1_city7-2_city5-2,3991873,2,107,112,219,0
2_2889739,fly-airplane_plane1_city7-2_city10-2,2889739,2,107,112,219,0
2_3729729,fly-airplane_plane1_city7-2_city1-2,3729729,2,107,112,219,0
2_4188481,fly-airplane_plane1_city7-2_city8-2,4188481,2,107,112,219,0
2_7949620,fly-airplane_plane1_city3-2_city7-2,7949620,2,107,112,219,0
2_7884084,fly-airplane_plane1_city3-2_city6-2,7884084,2,107,112,219,0
2_7621940,fly-airplane_plane1_city3-2_city2-2,7621940,2,107,112,219,0
2_79715,fly-airplane_plane1_city3-2_city9-2,79715,2,107,112,219,0
2_7818548,fly-airplane_plane1_city3-2_city5-2,7818548,2,107,112,219,0
2_6399345,fly-airplane_plane1_city3-2_city10-2,6399345,2,107,112,219,0
2_7556404,fly-airplane_plane1_city3-2_city1-2,7556404,2,107,112,219,0
2_14179,fly-airplane_plane1_city3-2_city8-2,14179,2,107,112,219,0
2_7079858,fly-airplane_plane1_city6-2_city7-2,7079858,2,107,113,220,0
2_6817714,fly-airplane_plane1_city6-2_city3-2,6817714,2,107,113,220,0
2_6752178,fly-airplane_plane1_city6-2_city2-2,6752178,2,107,113,220,0
2_7210930,fly-airplane_plane1_city6-2_city9-2,7210930,2,107,113,220,0
2_6948786,fly-airplane_plane1_city6-2_city5-2,6948786,2,107,113,220,0
2_7767629,fly-airplane_plane1_city6-2_city10-2,7767629,2,107,113,220,0
2_6686642,fly-airplane_plane1_city6-2_city1-2,6686642,2,107,113,220,0
2_7145394,fly-airplane_plane1_city6-2_city8-2,7145394,2,107,113,220,0
2_2905556,fly-airplane_plane1_city2-2_city7-2,2905556,2,107,112,219,0
2_2643412,fly-airplane_plane1_city2-2_city3-2,2643412,2,107,112,219,0
2_2840020,fly-airplane_plane1_city2-2_city6-2,2840020,2,107,112,219,0
2_3036628,fly-airplane_plane1_city2-2_city9-2,3036628,2,107,112,219,0
2_2774484,fly-airplane_plane1_city2-2_city5-2,2774484,2,107,112,219,0
2_3276258,fly-airplane_plane1_city2-2_city10-2,3276258,2,107,112,219,0
2_2512340,fly-airplane_plane1_city2-2_city1-2,2512340,2,107,112,219,0
2_2971092,fly-airplane_plane1_city2-2_city8-2,2971092,2,107,112,219,0
2_6210096,fly-airplane_plane1_city9-2_city7-2,6210096,2,107,113,220,0
2_5947952,fly-airplane_plane1_city9-2_city3-2,5947952,2,107,113,220,0
2_6144560,fly-airplane_plane1_city9-2_city6-2,6144560,2,107,113,220,0
2_5882416,fly-airplane_plane1_city9-2_city2-2,5882416,2,107,113,220,0
2_6079024,fly-airplane_plane1_city9-2_city5-2,6079024,2,107,113,220,0
2_1134936,fly-airplane_plane1_city9-2_city10-2,1134936,2,107,113,220,0
2_5816880,fly-airplane_plane1_city9-2_city1-2,5816880,2,107,113,220,0
2_6275632,fly-airplane_plane1_city9-2_city8-2,6275632,2,107,113,220,0
2_2035794,fly-airplane_plane1_city5-2_city7-2,2035794,2,107,113,220,0
2_1773650,fly-airplane_plane1_city5-2_city3-2,1773650,2,107,113,220,0
2_1970258,fly-airplane_plane1_city5-2_city6-2,1970258,2,107,113,220,0
2_1708114,fly-airplane_plane1_city5-2_city2-2,1708114,2,107,113,220,0
2_2166866,fly-airplane_plane1_city5-2_city9-2,2166866,2,107,113,220,0
2_4644542,fly-airplane_plane1_city5-2_city10-2,4644542,2,107,113,220,0
2_1642578,fly-airplane_plane1_city5-2_city1-2,1642578,2,107,113,220,0
2_2101330,fly-airplane_plane1_city5-2_city8-2,2101330,2,107,113,220,0
2_3916903,fly-airplane_plane1_city10-2_city7-2,3916903,2,107,113,220,0
2_3654759,fly-airplane_plane1_city10-2_city3-2,3654759,2,107,113,220,0
2_3851367,fly-airplane_plane1_city10-2_city6-2,3851367,2,107,113,220,0
2_3589223,fly-airplane_plane1_city10-2_city2-2,3589223,2,107,113,220,0
2_4047975,fly-airplane_plane1_city10-2_city9-2,4047975,2,107,113,220,0
2_3785831,fly-airplane_plane1_city10-2_city5-2,3785831,2,107,113,220,0
2_3523687,fly-airplane_plane1_city10-2_city1-2,3523687,2,107,113,220,0
2_3982439,fly-airplane_plane1_city10-2_city8-2,3982439,2,107,113,220,0
2_2208637,load-airplane_package3_plane1_city3-2,2208637,2,116,143,259,0
2_767485,noop_in-city_city3-2_city3,767485,2,1,1,2,0
2_1448144,noop_at_package3_city3-2,1448144,2,10,34,44,0
2_6416259,load-airplane_package3_plane2_city3-2,6416259,2,116,143,259,0
2_2622904,load-airplane_package3_plane3_city3-2,2622904,2,118,150,268,0
2_6830526,load-airplane_package3_plane4_city3-2,6830526,2,116,143,259,0
2_3471674,load-truck_package3_truck3_city3-2,3471674,2,17,38,55,0
2_1281200,noop_city_city10,1281200,2,1,1,2,0
2_5018864,noop_airplane_plane2,5018864,2,1,1,2,0
2_4908705,fly-airplane_plane2_city7-2_city3-2,4908705,2,109,120,229,0
2_5105313,fly-airplane_plane2_city7-2_city6-2,5105313,2,109,120,229,0
2_4843169,fly-airplane_plane2_city7-2_city2-2,4843169,2,109,120,229,0
2_5301921,fly-airplane_plane2_city7-2_city9-2,5301921,2,109,120,229,0
2_5039777,fly-airplane_plane2_city7-2_city5-2,5039777,2,109,120,229,0
2_7120922,fly-airplane_plane2_city7-2_city10-2,7120922,2,109,120,229,0
2_4777633,fly-airplane_plane2_city7-2_city1-2,4777633,2,109,120,229,0
2_5236385,fly-airplane_plane2_city7-2_city8-2,5236385,2,109,120,229,0
2_996547,fly-airplane_plane2_city3-2_city7-2,996547,2,108,121,229,0
2_931011,fly-airplane_plane2_city3-2_city6-2,931011,2,108,121,229,0
2_668867,fly-airplane_plane2_city3-2_city2-2,668867,2,108,121,229,0
2_1127619,fly-airplane_plane2_city3-2_city9-2,1127619,2,108,121,229,0
2_865475,fly-airplane_plane2_city3-2_city5-2,865475,2,108,121,229,0
2_2629551,fly-airplane_plane2_city3-2_city10-2,2629551,2,108,121,229,0
2_603331,fly-airplane_plane2_city3-2_city1-2,603331,2,108,121,229,0
2_1062083,fly-airplane_plane2_city3-2_city8-2,1062083,2,108,121,229,0
2_126785,fly-airplane_plane2_city6-2_city7-2,126785,2,109,121,230,0
2_7865618,fly-airplane_plane2_city6-2_city3-2,7865618,2,109,121,230,0
2_7800082,fly-airplane_plane2_city6-2_city2-2,7800082,2,109,121,230,0
2_257857,fly-airplane_plane2_city6-2_city9-2,257857,2,109,121,230,0
2_7996690,fly-airplane_plane2_city6-2_city5-2,7996690,2,109,121,230,0
2_3997835,fly-airplane_plane2_city6-2_city10-2,3997835,2,109,121,230,0
2_7734546,fly-airplane_plane2_city6-2_city1-2,7734546,2,109,121,230,0
2_192321,fly-airplane_plane2_city6-2_city8-2,192321,2,109,121,230,0
2_3953460,fly-airplane_plane2_city2-2_city7-2,3953460,2,109,120,229,0
2_3691316,fly-airplane_plane2_city2-2_city3-2,3691316,2,109,120,229,0
2_3887924,fly-airplane_plane2_city2-2_city6-2,3887924,2,109,120,229,0
2_4084532,fly-airplane_plane2_city2-2_city9-2,4084532,2,109,120,229,0
2_3822388,fly-airplane_plane2_city2-2_city5-2,3822388,2,109,120,229,0
2_7507441,fly-airplane_plane2_city2-2_city10-2,7507441,2,109,120,229,0
2_3560244,fly-airplane_plane2_city2-2_city1-2,3560244,2,109,120,229,0
2_4018996,fly-airplane_plane2_city2-2_city8-2,4018996,2,109,120,229,0
2_7258000,fly-airplane_plane2_city9-2_city7-2,7258000,2,109,121,230,0
2_6995856,fly-airplane_plane2_city9-2_city3-2,6995856,2,109,121,230,0
2_7192464,fly-airplane_plane2_city9-2_city6-2,7192464,2,109,121,230,0
2_6930320,fly-airplane_plane2_city9-2_city2-2,6930320,2,109,121,230,0
2_7126928,fly-airplane_plane2_city9-2_city5-2,7126928,2,109,121,230,0
2_5366119,fly-airplane_plane2_city9-2_city10-2,5366119,2,109,121,230,0
2_6864784,fly-airplane_plane2_city9-2_city1-2,6864784,2,109,121,230,0
2_7323536,fly-airplane_plane2_city9-2_city8-2,7323536,2,109,121,230,0
2_3083698,fly-airplane_plane2_city5-2_city7-2,3083698,2,109,121,230,0
2_2821554,fly-airplane_plane2_city5-2_city3-2,2821554,2,109,121,230,0
2_3018162,fly-airplane_plane2_city5-2_city6-2,3018162,2,109,121,230,0
2_2756018,fly-airplane_plane2_city5-2_city2-2,2756018,2,109,121,230,0
2_3214770,fly-airplane_plane2_city5-2_city9-2,3214770,2,109,121,230,0
2_874748,fly-airplane_plane2_city5-2_city10-2,874748,2,109,121,230,0
2_2690482,fly-airplane_plane2_city5-2_city1-2,2690482,2,109,121,230,0
2_3149234,fly-airplane_plane2_city5-2_city8-2,3149234,2,109,121,230,0
2_147109,fly-airplane_plane2_city10-2_city7-2,147109,2,109,121,230,0
2_7885942,fly-airplane_plane2_city10-2_city3-2,7885942,2,109,121,230,0
2_81573,fly-airplane_plane2_city10-2_city6-2,81573,2,109,121,230,0
2_7820406,fly-airplane_plane2_city10-2_city2-2,7820406,2,109,121,230,0
2_278181,fly-airplane_plane2_city10-2_city9-2,278181,2,109,121,230,0
2_16037,fly-airplane_plane2_city10-2_city5-2,16037,2,109,121,230,0
2_7754870,fly-airplane_plane2_city10-2_city1-2,7754870,2,109,121,230,0
2_212645,fly-airplane_plane2_city10-2_city8-2,212645,2,109,121,230,0
2_6910373,fly-airplane_plane2_city1-2_city7-2,6910373,2,109,120,229,0
2_6648229,fly-airplane_plane2_city1-2_city3-2,6648229,2,109,120,229,0
2_6844837,fly-airplane_plane2_city1-2_city6-2,6844837,2,109,120,229,0
2_6582693,fly-airplane_plane2_city1-2_city2-2,6582693,2,109,120,229,0
2_7041445,fly-airplane_plane2_city1-2_city9-2,7041445,2,109,120,229,0
2_6779301,fly-airplane_plane2_city1-2_city5-2,6779301,2,109,120,229,0
2_4384354,fly-airplane_plane2_city1-2_city10-2,4384354,2,109,120,229,0
2_6975909,fly-airplane_plane2_city1-2_city8-2,6975909,2,109,120,229,0
2_2213936,fly-airplane_plane2_city8-2_city7-2,2213936,2,109,121,230,0
2_1951792,fly-airplane_plane2_city8-2_city3-2,1951792,2,109,121,230,0
2_2148400,fly-airplane_plane2_city8-2_city6-2,2148400,2,109,121,230,0
2_1886256,fly-airplane_plane2_city8-2_city2-2,1886256,2,109,121,230,0
2_2345008,fly-airplane_plane2_city8-2_city9-2,2345008,2,109,121,230,0
2_2082864,fly-airplane_plane2_city8-2_city5-2,2082864,2,109,121,230,0
2_2243032,fly-airplane_plane2_city8-2_city10-2,2243032,2,109,121,230,0
2_1820720,fly-airplane_plane2_city8-2_city1-2,1820720,2,109,121,230,0
2_3403147,unload-airplane_package3_plane2_city3-2,3403147,2,116,143,259,0
2_5018865,noop_airplane_plane3,5018865,2,1,1,2,0
2_5956609,fly-airplane_plane3_city7-2_city3-2,5956609,2,108,121,229,0
2_6153217,fly-airplane_plane3_city7-2_city6-2,6153217,2,108,121,229,0
2_5891073,fly-airplane_plane3_city7-2_city2-2,5891073,2,108,121,229,0
2_6349825,fly-airplane_plane3_city7-2_city9-2,6349825,2,108,121,229,0
2_6087681,fly-airplane_plane3_city7-2_city5-2,6087681,2,108,121,229,0
2_3351128,fly-airplane_plane3_city7-2_city10-2,3351128,2,108,121,229,0
2_5825537,fly-airplane_plane3_city7-2_city1-2,5825537,2,108,121,229,0
2_6284289,fly-airplane_plane3_city7-2_city8-2,6284289,2,108,121,229,0
2_2044451,fly-airplane_plane3_city3-2_city7-2,2044451,2,109,120,229,0
2_1978915,fly-airplane_plane3_city3-2_city6-2,1978915,2,109,120,229,0
2_1716771,fly-airplane_plane3_city3-2_city2-2,1716771,2,109,120,229,0
2_2175523,fly-airplane_plane3_city3-2_city9-2,2175523,2,109,120,229,0
2_1913379,fly-airplane_plane3_city3-2_city5-2,1913379,2,109,120,229,0
2_6860734,fly-airplane_plane3_city3-2_city10-2,6860734,2,109,120,229,0
2_1651235,fly-airplane_plane3_city3-2_city1-2,1651235,2,109,120,229,0
2_2109987,fly-airplane_plane3_city3-2_city8-2,2109987,2,109,120,229,0
2_1174689,fly-airplane_plane3_city6-2_city7-2,1174689,2,109,121,230,0
2_912545,fly-airplane_plane3_city6-2_city3-2,912545,2,109,121,230,0
2_847009,fly-airplane_plane3_city6-2_city2-2,847009,2,109,121,230,0
2_1305761,fly-airplane_plane3_city6-2_city9-2,1305761,2,109,121,230,0
2_1043617,fly-airplane_plane3_city6-2_city5-2,1043617,2,109,121,230,0
2_228041,fly-airplane_plane3_city6-2_city10-2,228041,2,109,121,230,0
2_781473,fly-airplane_plane3_city6-2_city1-2,781473,2,109,121,230,0
2_1240225,fly-airplane_plane3_city6-2_city8-2,1240225,2,109,121,230,0
2_4131602,fly-airplane_plane3_city5-2_city7-2,4131602,2,109,121,230,0
2_3869458,fly-airplane_plane3_city5-2_city3-2,3869458,2,109,121,230,0
2_4066066,fly-airplane_plane3_city5-2_city6-2,4066066,2,109,121,230,0
2_3803922,fly-airplane_plane3_city5-2_city2-2,3803922,2,109,121,230,0
2_4262674,fly-airplane_plane3_city5-2_city9-2,4262674,2,109,121,230,0
2_5105931,fly-airplane_plane3_city5-2_city10-2,5105931,2,109,121,230,0
2_3738386,fly-airplane_plane3_city5-2_city1-2,3738386,2,109,121,230,0
2_4197138,fly-airplane_plane3_city5-2_city8-2,4197138,2,109,121,230,0
2_7958277,fly-airplane_plane3_city1-2_city7-2,7958277,2,109,120,229,0
2_7696133,fly-airplane_plane3_city1-2_city3-2,7696133,2,109,120,229,0
2_7892741,fly-airplane_plane3_city1-2_city6-2,7892741,2,109,120,229,0
2_7630597,fly-airplane_plane3_city1-2_city2-2,7630597,2,109,120,229,0
2_88372,fly-airplane_plane3_city1-2_city9-2,88372,2,109,120,229,0
2_7827205,fly-airplane_plane3_city1-2_city5-2,7827205,2,109,120,229,0
2_614560,fly-airplane_plane3_city1-2_city10-2,614560,2,109,120,229,0
2_22836,fly-airplane_plane3_city1-2_city8-2,22836,2,109,120,229,0
2_3261840,fly-airplane_plane3_city8-2_city7-2,3261840,2,109,121,230,0
2_2999696,fly-airplane_plane3_city8-2_city3-2,2999696,2,109,121,230,0
2_3196304,fly-airplane_plane3_city8-2_city6-2,3196304,2,109,121,230,0
2_2934160,fly-airplane_plane3_city8-2_city2-2,2934160,2,109,121,230,0
2_3392912,fly-airplane_plane3_city8-2_city9-2,3392912,2,109,121,230,0
2_3130768,fly-airplane_plane3_city8-2_city5-2,3130768,2,109,121,230,0
2_6474215,fly-airplane_plane3_city8-2_city10-2,6474215,2,109,121,230,0
2_2868624,fly-airplane_plane3_city8-2_city1-2,2868624,2,109,121,230,0
2_1823615,noop_airport_city7-2,1823615,2,1,1,2,0
2_7004513,fly-airplane_plane4_city7-2_city3-2,7004513,2,109,120,229,0
2_7201121,fly-airplane_plane4_city7-2_city6-2,7201121,2,109,120,229,0
2_6938977,fly-airplane_plane4_city7-2_city2-2,6938977,2,109,120,229,0
2_7397729,fly-airplane_plane4_city7-2_city9-2,7397729,2,109,120,229,0
2_7135585,fly-airplane_plane4_city7-2_city5-2,7135585,2,109,120,229,0
2_7582311,fly-airplane_plane4_city7-2_city10-2,7582311,2,109,120,229,0
2_6873441,fly-airplane_plane4_city7-2_city1-2,6873441,2,109,120,229,0
2_7332193,fly-airplane_plane4_city7-2_city8-2,7332193,2,109,120,229,0
2_3092355,fly-airplane_plane4_city3-2_city7-2,3092355,2,108,121,229,0
2_2222593,fly-airplane_plane4_city6-2_city7-2,2222593,2,109,121,230,0
2_608498,fly-airplane_plane4_city10-2_city7-2,608498,2,109,121,230,0
2_1005204,fly-airplane_plane4_city1-2_city7-2,1005204,2,109,120,229,0
2_4309744,fly-airplane_plane4_city8-2_city7-2,4309744,2,109,121,230,0
2_5809715,noop_at_plane2_city7-2,5809715,2,105,116,221,0
2_565705,at_plane2_city4-2,565705,2,28,17,45,0
2_2650101,noop_at_plane2_city10-2,2650101,2,106,119,225,0
2_1885288,noop_at_plane3_city5-2,1885288,2,106,119,225,0
2_5018866,noop_airplane_plane4,5018866,2,1,1,2,0
2_3026819,fly-airplane_plane4_city3-2_city6-2,3026819,2,108,121,229,0
2_2764675,fly-airplane_plane4_city3-2_city2-2,2764675,2,108,121,229,0
2_3223427,fly-airplane_plane4_city3-2_city9-2,3223427,2,108,121,229,0
2_2961283,fly-airplane_plane4_city3-2_city5-2,2961283,2,108,121,229,0
2_3090940,fly-airplane_plane4_city3-2_city10-2,3090940,2,108,121,229,0
2_2699139,fly-airplane_plane4_city3-2_city1-2,2699139,2,108,121,229,0
2_3157891,fly-airplane_plane4_city3-2_city8-2,3157891,2,108,121,229,0
2_1960449,fly-airplane_plane4_city6-2_city3-2,1960449,2,109,121,230,0
2_1894913,fly-airplane_plane4_city6-2_city2-2,1894913,2,109,121,230,0
2_2353665,fly-airplane_plane4_city6-2_city9-2,2353665,2,109,121,230,0
2_2091521,fly-airplane_plane4_city6-2_city5-2,2091521,2,109,121,230,0
2_4459224,fly-airplane_plane4_city6-2_city10-2,4459224,2,109,121,230,0
2_1829377,fly-airplane_plane4_city6-2_city1-2,1829377,2,109,121,230,0
2_2288129,fly-airplane_plane4_city6-2_city8-2,2288129,2,109,121,230,0
2_346354,fly-airplane_plane4_city10-2_city3-2,346354,2,109,121,230,0
2_542962,fly-airplane_plane4_city10-2_city6-2,542962,2,109,121,230,0
2_280818,fly-airplane_plane4_city10-2_city2-2,280818,2,109,121,230,0
2_739570,fly-airplane_plane4_city10-2_city9-2,739570,2,109,121,230,0
2_477426,fly-airplane_plane4_city10-2_city5-2,477426,2,109,121,230,0
2_215282,fly-airplane_plane4_city10-2_city1-2,215282,2,109,121,230,0
2_674034,fly-airplane_plane4_city10-2_city8-2,674034,2,109,121,230,0
2_743060,fly-airplane_plane4_city1-2_city3-2,743060,2,109,120,229,0
2_939668,fly-airplane_plane4_city1-2_city6-2,939668,2,109,120,229,0
2_677524,fly-airplane_plane4_city1-2_city2-2,677524,2,109,120,229,0
2_1136276,fly-airplane_plane4_city1-2_city9-2,1136276,2,109,120,229,0
2_874132,fly-airplane_plane4_city1-2_city5-2,874132,2,109,120,229,0
2_4845743,fly-airplane_plane4_city1-2_city10-2,4845743,2,109,120,229,0
2_1070740,fly-airplane_plane4_city1-2_city8-2,1070740,2,109,120,229,0
2_4047600,fly-airplane_plane4_city8-2_city3-2,4047600,2,109,121,230,0
2_4244208,fly-airplane_plane4_city8-2_city6-2,4244208,2,109,121,230,0
2_3982064,fly-airplane_plane4_city8-2_city2-2,3982064,2,109,121,230,0
2_4440816,fly-airplane_plane4_city8-2_city9-2,4440816,2,109,121,230,0
2_4178672,fly-airplane_plane4_city8-2_city5-2,4178672,2,109,121,230,0
2_2704421,fly-airplane_plane4_city8-2_city10-2,2704421,2,109,121,230,0
2_3916528,fly-airplane_plane4_city8-2_city1-2,3916528,2,109,121,230,0
2_3817414,unload-airplane_package3_plane4_city3-2,3817414,2,116,143,259,0
2_4233888,noop_in-city_city9-1_city9,4233888,2,1,1,2,0
2_5830766,noop_at_plane4_city1-2,5830766,2,105,116,221,0
2_2773648,noop_location_city3-1,2773648,2,1,1,2,0
2_4560839,noop_in-city_city2-2_city2,4560839,2,1,1,2,0
2_6728647,drive-truck_truck2_city2-1_city2-2_city2,6728647,2,11,8,19,0
2_3971182,drive-truck_truck2_city2-2_city2-1_city2,3971182,2,11,7,18,0
2_2773649,noop_location_city3-2,2773649,2,1,1,2,0
2_2962340,noop_at_truck7_city7-1,2962340,2,5,7,12,0
2_5915916,at_truck7_city7-2,5915916,2,3,5,8,0
2_6289518,noop_at_plane4_city8-2,6289518,2,106,119,225,0
2_2962341,noop_at_truck7_city7-2,2962341,2,4,4,8,0
2_5915915,at_truck7_city7-1,5915915,2,3,3,6,0
2_2010292,noop_in-city_city9-2_city9,2010292,2,1,1,2,0
2_1602093,noop_at_plane1_city7-2,1602093,2,103,109,212,0
2_1561471,noop_airport_city3-2,1561471,2,1,1,2,0
2_6144820,noop_at_truck4_city4-1,6144820,2,4,4,8,0
2_1097419,at_truck4_city4-2,1097419,2,3,4,7,0
2_1623144,noop_at_plane3_city1-2,1623144,2,105,116,221,0
2_6144821,noop_at_truck4_city4-2,6144821,2,4,4,8,0
2_1097418,at_truck4_city4-1,1097418,2,3,2,5,0
2_5547571,noop_at_plane2_city3-2,5547571,2,103,118,221,0
2_6118830,noop_at_truck10_city10-1,6118830,2,4,5,9,0
2_3142669,unload-truck_package2_truck10_city10-1,3142669,2,11,9,20,0
2_7404958,load-truck_package2_truck10_city10-1,7404958,2,11,9,20,0
2_3973470,at_truck10_city10-2,3973470,2,4,6,10,0
2_6118831,noop_at_truck10_city10-2,6118831,2,7,6,13,0
2_1676676,in_package2_truck10,1676676,2,4,3,7,0
2_3973469,at_truck10_city10-1,3973469,2,3,4,7,0
2_2081896,noop_at_plane3_city8-2,2081896,2,106,119,225,0
2_6110936,noop_in_package4_plane3,6110936,2,101,31,132,0
2_3772549,at_package4_city7-2,3772549,2,7,11,18,0
2_7612973,noop_in-city_city6-1_city6,7612973,2,1,1,2,0
2_6027374,noop_at_plane4_city4-2,6027374,2,106,119,225,0
2_2970256,noop_location_city6-1,2970256,2,1,1,2,0
2_2970257,noop_location_city6-2,2970257,2,1,1,2,0
2_1339949,noop_at_plane1_city3-2,1339949,2,103,109,212,0
2_5389377,noop_in-city_city6-2_city6,5389377,2,1,1,2,0
2_3405350,noop_in-city_city5-1_city5,3405350,2,1,1,2,0
2_2656144,drive-truck_truck5_city5-1_city5-2_city5,2656144,2,10,5,15,0
2_7899656,drive-truck_truck5_city5-2_city5-1_city5,7899656,2,10,5,15,0
2_3822037,noop_in_package2_truck10,3822037,2,6,5,11,0
2_7160435,at_package2_city10-1,7160435,2,3,2,5,0
2_1758079,noop_airport_city6-2,1758079,2,1,1,2,0
2_2417001,noop_at_truck5_city5-1,2417001,2,4,4,8,0
2_5370577,at_truck5_city5-2,5370577,2,3,4,7,0
2_5744179,noop_at_plane2_city6-2,5744179,2,106,119,225,0
2_1819752,noop_at_plane3_city4-2,1819752,2,106,119,225,0
2_2417002,noop_at_truck5_city5-2,2417002,2,4,4,8,0
2_5370576,at_truck5_city5-1,5370576,2,3,2,5,0
2_2708112,noop_location_city2-1,2708112,2,1,1,2,0
2_7282144,noop_in_package3_plane2,7282144,2,103,40,143,0
2_7303760,at_package3_city3-2,7303760,2,9,8,17,0
2_2708113,noop_location_city2-2,2708113,2,1,1,2,0
2_1181754,noop_in-city_city5-2_city5,1181754,2,1,1,2,0
2_5599481,noop_at_truck2_city2-1,5599481,2,5,7,12,0
2_552080,at_truck2_city2-2,552080,2,3,6,9,0
2_6223982,noop_at_plane4_city7-2,6223982,2,105,116,221,0
2_5599482,noop_at_truck2_city2-2,5599482,2,4,4,8,0
2_552079,at_truck2_city2-1,552079,2,3,4,7,0
2_62686,noop_truck_truck1,62686,2,1,1,2,0
2_85171,drive-truck_truck1_city1-1_city1-2_city1,85171,2,11,8,19,0
2_5328683,drive-truck_truck1_city1-2_city1-1_city1,5328683,2,11,7,18,0
2_3166864,noop_location_city9-1,3166864,2,1,1,2,0
2_7282146,noop_in_package3_plane4,7282146,2,103,40,143,0
2_62687,noop_truck_truck2,62687,2,1,1,2,0
2_3166865,noop_location_city9-2,3166865,2,1,1,2,0
2_62688,noop_truck_truck3,62688,2,1,1,2,0
2_1495935,noop_airport_city2-2,1495935,2,1,1,2,0
2_4109194,noop_in-city_city10-1_city10,4109194,2,1,1,2,0
2_1536557,noop_at_plane1_city6-2,1536557,2,104,112,216,0
2_5482035,noop_at_plane2_city2-2,5482035,2,105,116,221,0
2_45710,noop_truck_truck10,45710,2,1,1,2,0
2_62689,noop_truck_truck4,62689,2,1,1,2,0
2_4975108,noop_in-city_city4-2_city4,4975108,2,1,1,2,0
2_6784435,noop_in-city_city2-1_city2,6784435,2,1,1,2,0
2_62690,noop_truck_truck5,62690,2,1,1,2,0
2_1954687,noop_airport_city9-2,1954687,2,1,1,2,0
2_5940787,noop_at_plane2_city9-2,5940787,2,106,119,225,0
2_62691,noop_truck_truck6,62691,2,1,1,2,0
2_2016360,noop_at_plane3_city7-2,2016360,2,103,118,221,0
2_4305438,noop_at_package2_city10-1,4305438,2,4,5,9,0
2_62692,noop_truck_truck7,62692,2,1,1,2,0
2_2904720,noop_location_city5-1,2904720,2,1,1,2,0
2_5961838,noop_at_plane4_city3-2,5961838,2,103,118,221,0
2_4689752,noop_at_plane4_city10-2,4689752,2,106,119,225,0
2_62693,noop_truck_truck8,62693,2,1,1,2,0
2_6584618,drive-truck_truck8_city8-1_city8-2_city8,6584618,2,10,5,15,0
2_3827153,drive-truck_truck8_city8-2_city8-1_city8,3827153,2,10,5,15,0
2_2904721,noop_location_city5-2,2904721,2,1,1,2,0
2_2576812,noop_in-city_city1-1_city1,2576812,2,1,1,2,0
2_1871662,noop_at_truck3_city3-1,1871662,2,5,7,12,0
2_4825238,at_truck3_city3-2,4825238,2,3,5,8,0
2_1274413,noop_at_plane1_city2-2,1274413,2,103,109,212,0
2_1871663,noop_at_truck3_city3-2,1871663,2,4,4,8,0
2_4825237,at_truck3_city3-1,4825237,2,3,4,7,0
2_62694,noop_truck_truck9,62694,2,1,1,2,0
2_1837095,noop_obj_package1,1837095,2,1,1,2,0
2_1733165,noop_at_plane1_city9-2,1733165,2,104,112,216,0
2_1837096,noop_obj_package2,1837096,2,1,1,2,0
2_1692543,noop_airport_city5-2,1692543,2,1,1,2,0
2_26265,noop_in-city_city8-1_city8,26265,2,1,1,2,0
2_5678643,noop_at_plane2_city5-2,5678643,2,106,119,225,0
2_1754216,noop_at_plane3_city3-2,1754216,2,105,116,221,0
2_1837097,noop_obj_package3,1837097,2,1,1,2,0
2_353216,noop_in-city_city1-2_city1,353216,2,1,1,2,0
2_1837098,noop_obj_package4,1837098,2,1,1,2,0
2_4005493,noop_city_city1,4005493,2,1,1,2,0
2_2642576,noop_location_city1-1,2642576,2,1,1,2,0
2_1837099,noop_obj_package5,1837099,2,1,1,2,0
2_4005494,noop_city_city2,4005494,2,1,1,2,0
2_2642577,noop_location_city1-2,2642577,2,1,1,2,0
2_6158446,noop_at_plane4_city6-2,6158446,2,106,119,225,0
2_4005495,noop_city_city3,4005495,2,1,1,2,0
2_3101328,noop_location_city8-1,3101328,2,1,1,2,0
2_5803646,noop_in-city_city8-2_city8,5803646,2,1,1,2,0
2_3819619,noop_in-city_city7-1_city7,3819619,2,1,1,2,0
2_4005496,noop_city_city4,4005496,2,1,1,2,0
2_3101329,noop_location_city8-2,3101329,2,1,1,2,0
2_1471021,noop_at_plane1_city5-2,1471021,2,104,112,216,0
2_4005497,noop_city_city5,4005497,2,1,1,2,0
2_4613021,noop_location_city10-1,4613021,2,1,1,2,0
2_6333557,noop_airport_city10-2,6333557,2,1,1,2,0
2_1430399,noop_airport_city1-2,1430399,2,1,1,2,0
2_7235498,noop_at_truck8_city8-1,7235498,2,4,4,8,0
2_2188097,at_truck8_city8-2,2188097,2,3,4,7,0
2_5416499,noop_at_plane2_city1-2,5416499,2,105,116,221,0
2_7235499,noop_at_truck8_city8-2,7235499,2,4,4,8,0
2_2188096,at_truck8_city8-1,2188096,2,3,2,5,0
2_4005498,noop_city_city6,4005498,2,1,1,2,0
2_4613022,noop_location_city10-2,4613022,2,1,1,2,0
2_4005499,noop_city_city7,4005499,2,1,1,2,0
2_1889151,noop_airport_city8-2,1889151,2,1,1,2,0
2_1596023,noop_in-city_city7-2_city7,1596023,2,1,1,2,0
2_1326323,noop_at_truck1_city1-1,1326323,2,5,7,12,0
2_4279899,at_truck1_city1-2,4279899,2,3,7,10,0
2_5630764,noop_at_plane1_city10-2,5630764,2,104,112,216,0
2_5875251,noop_at_plane2_city8-2,5875251,2,106,119,225,0
2_1950824,noop_at_plane3_city6-2,1950824,2,106,119,225,0
2_1326324,noop_at_truck1_city1-2,1326324,2,4,4,8,0
2_4279898,at_truck1_city1-1,4279898,2,3,4,7,0
2_4005500,noop_city_city8,4005500,2,1,1,2,0
2_5917910,noop_at_package4_city7-2,5917910,2,8,25,33,0
2_6497299,city_city8,6497299,2,1,3,4,0
2_6195675,in-city_city5-1_city5,6195675,2,1,3,4,0
2_7104561,city_city10,7104561,2,1,3,4,0
1_1773650,fly-airplane_plane1_city5-2_city3-2,1773650,1,3,105,108,0
0_4424596,at_plane1_city5-2,4424596,0,0,9,9,0
1_7258000,fly-airplane_plane2_city9-2_city7-2,7258000,1,3,107,110,0
0_893385,at_plane2_city9-2,893385,0,0,9,9,0
1_2148400,fly-airplane_plane2_city8-2_city6-2,2148400,1,3,107,110,0
0_827849,at_plane2_city8-2,827849,0,0,9,9,0
1_5066900,fly-airplane_plane3_city2-2_city8-2,5066900,1,3,107,110,0
0_4642255,at_plane3_city2-2,4642255,0,0,10,10,0
1_4047600,fly-airplane_plane4_city8-2_city3-2,4047600,1,3,107,110,0
0_1242116,at_plane4_city8-2,1242116,0,0,9,9,0
1_1874900,drive-truck_truck10_city10-2_city10-1_city10,1874900,1,6,8,14,0
0_3973470,at_truck10_city10-2,3973470,0,0,1,1,0
1_5875251,noop_at_plane2_city8-2,5875251,1,1,106,107,0
2_585448,airport_city8-2,585448,2,1,73,74,0
1_2650101,noop_at_plane2_city10-2,2650101,1,0,106,106,0
0_6673463,at_plane2_city10-2,6673463,0,0,9,9,0
2_6497300,city_city9,6497300,2,1,3,4,0
1_3860801,fly-airplane_plane1_city7-2_city3-2,3860801,1,3,105,108,0
0_4555668,at_plane1_city7-2,4555668,0,0,10,10,0
1_6779301,fly-airplane_plane2_city1-2_city5-2,6779301,1,3,107,110,0
0_369097,at_plane2_city1-2,369097,0,0,10,10,0
1_7154051,fly-airplane_plane3_city4-2_city8-2,7154051,1,3,107,110,0
0_4773327,at_plane3_city4-2,4773327,0,0,9,9,0
1_2044451,fly-airplane_plane3_city3-2_city7-2,2044451,1,3,107,110,0
0_4707791,at_plane3_city3-2,4707791,0,0,10,10,0
1_1025151,fly-airplane_plane4_city9-2_city2-2,1025151,1,3,107,110,0
0_1307652,at_plane4_city9-2,1307652,0,0,9,9,0
1_4689752,noop_at_plane4_city10-2,4689752,1,0,106,106,0
0_712137,at_plane4_city10-2,712137,0,0,9,9,0
1_2417002,noop_at_truck5_city5-2,2417002,1,0,4,4,0
0_5370577,at_truck5_city5-2,5370577,0,0,1,1,0
1_1819752,noop_at_plane3_city4-2,1819752,1,1,106,107,0
1_5896302,noop_at_plane4_city2-2,5896302,1,0,105,105,0
0_848900,at_plane4_city2-2,848900,0,0,10,10,0
1_5947952,fly-airplane_plane1_city9-2_city3-2,5947952,1,3,105,108,0
0_4686740,at_plane1_city9-2,4686740,0,0,9,9,0
1_838352,fly-airplane_plane1_city8-2_city2-2,838352,1,3,105,108,0
0_4621204,at_plane1_city8-2,4621204,0,0,9,9,0
1_3756852,fly-airplane_plane2_city2-2_city4-2,3756852,1,3,107,110,0
0_434633,at_plane2_city2-2,434633,0,0,10,10,0
1_4131602,fly-airplane_plane3_city5-2_city7-2,4131602,1,3,107,110,0
0_4838863,at_plane3_city5-2,4838863,0,0,9,9,0
1_5656052,fly-airplane_plane4_city2-2_city1-2,5656052,1,4,107,111,0
1_2469652,drive-truck_truck9_city9-2_city9-1_city9,2469652,1,6,5,11,0
0_6461255,at_truck9_city9-2,6461255,0,0,1,1,0
1_3916903,fly-airplane_plane1_city10-2_city7-2,3916903,1,3,105,108,0
0_1653149,at_plane1_city10-2,1653149,0,0,9,9,0
1_7743203,fly-airplane_plane4_city4-2_city1-2,7743203,1,3,107,110,0
0_979972,at_plane4_city4-2,979972,0,0,9,9,0
1_3827153,drive-truck_truck8_city8-2_city8-1_city8,3827153,1,6,5,11,0
0_2188097,at_truck8_city8-2,2188097,0,0,1,1,0
2_3972079,in-city_city5-2_city5,3972079,2,1,3,4,0
2_1988052,in-city_city4-1_city4,1988052,2,1,3,4,0
1_6355054,noop_at_plane4_city9-2,6355054,1,1,106,107,0
1_7556404,fly-airplane_plane1_city3-2_city1-2,7556404,1,3,105,108,0
0_4293524,at_plane1_city3-2,4293524,0,0,10,10,0
1_1297104,fly-airplane_plane1_city8-2_city9-2,1297104,1,4,105,109,0
1_7931154,fly-airplane_plane2_city6-2_city4-2,7931154,1,3,107,110,0
0_696777,at_plane2_city6-2,696777,0,0,9,9,0
1_2821554,fly-airplane_plane2_city5-2_city3-2,2821554,1,3,107,110,0
0_631241,at_plane2_city5-2,631241,0,0,9,9,0
1_4384354,fly-airplane_plane2_city1-2_city10-2,4384354,1,4,107,111,0
1_3196304,fly-airplane_plane3_city8-2_city6-2,3196304,1,3,107,110,0
0_5035471,at_plane3_city8-2,5035471,0,0,9,9,0
1_6114804,fly-airplane_plane4_city2-2_city8-2,6114804,1,4,107,111,0
1_346354,fly-airplane_plane4_city10-2_city3-2,346354,1,4,107,111,0
1_1005204,fly-airplane_plane4_city1-2_city7-2,1005204,1,3,107,110,0
0_783364,at_plane4_city1-2,783364,0,0,10,10,0
1_5184654,drive-truck_truck7_city7-2_city7-1_city7,5184654,1,6,6,12,0
0_5915916,at_truck7_city7-2,5915916,0,0,2,2,0
1_2622904,load-airplane_package3_plane3_city3-2,2622904,1,5,115,120,0
2_3304530,in_package3_plane3,3304530,2,1,28,29,0
1_1521455,fly-airplane_plane1_city4-2_city10-2,1521455,1,3,105,108,0
0_4359060,at_plane1_city4-2,4359060,0,0,9,9,0
1_5928005,fly-airplane_plane1_city1-2_city8-2,5928005,1,3,105,108,0
0_4162452,at_plane1_city1-2,4162452,0,0,10,10,0
1_4908705,fly-airplane_plane2_city7-2_city3-2,4908705,1,3,107,110,0
0_762313,at_plane2_city7-2,762313,0,0,10,10,0
1_173855,fly-airplane_plane3_city9-2_city5-2,173855,1,3,107,110,0
0_5101007,at_plane3_city9-2,5101007,0,0,9,9,0
1_7827205,fly-airplane_plane3_city1-2_city5-2,7827205,1,3,107,110,0
0_4576719,at_plane3_city1-2,4576719,0,0,10,10,0
1_6542155,drive-truck_truck6_city6-2_city6-1_city6,6542155,1,6,5,11,0
0_1642758,at_truck6_city6-2,1642758,0,0,1,1,0
2_5263322,location_city6-1,5263322,2,1,3,4,0
1_2905556,fly-airplane_plane1_city2-2_city7-2,2905556,1,3,105,108,0
0_4227988,at_plane1_city2-2,4227988,0,0,10,10,0
1_6995856,fly-airplane_plane2_city9-2_city3-2,6995856,1,4,107,111,0
1_7820406,fly-airplane_plane2_city10-2_city2-2,7820406,1,4,107,111,0
1_1886256,fly-airplane_plane2_city8-2_city2-2,1886256,1,4,107,111,0
1_4804756,fly-airplane_plane3_city2-2_city4-2,4804756,1,4,107,111,0
1_4312756,fly-airplane_plane3_city10-2_city6-2,4312756,1,3,107,110,0
0_3692800,at_plane3_city10-2,3692800,0,0,9,9,0
1_69906,fly-airplane_plane4_city4-2_city6-2,69906,1,4,107,111,0
1_5179506,fly-airplane_plane4_city5-2_city7-2,5179506,1,3,107,110,0
0_1045508,at_plane4_city5-2,1045508,0,0,9,9,0
1_7899656,drive-truck_truck5_city5-2_city5-1_city5,7899656,1,7,5,12,0
2_625646,airport_city10-2,625646,2,1,73,74,0
2_5263323,location_city6-2,5263323,2,1,29,30,0
1_5613107,noop_at_plane2_city4-2,5613107,1,0,106,106,0
0_565705,at_plane2_city4-2,565705,0,0,9,9,0
2_323304,airport_city4-2,323304,2,1,73,74,0
1_4992707,fly-airplane_plane1_city4-2_city7-2,4992707,1,4,105,109,0
1_257857,fly-airplane_plane2_city6-2_city9-2,257857,1,4,107,111,0
2_7765433,in-city_city4-2_city4,7765433,2,1,3,4,0
1_3276258,fly-airplane_plane1_city2-2_city10-2,3276258,1,4,105,109,0
1_1970258,fly-airplane_plane1_city5-2_city6-2,1970258,1,4,105,109,0
1_2345008,fly-airplane_plane2_city8-2_city9-2,2345008,1,4,107,111,0
1_3869458,fly-airplane_plane3_city5-2_city3-2,3869458,1,4,107,111,0
1_5827508,fly-airplane_plane4_city9-2_city10-2,5827508,1,4,107,111,0
1_4244208,fly-airplane_plane4_city8-2_city6-2,4244208,1,4,107,111,0
1_706908,load-airplane_package5_plane4_city1-2,706908,1,5,110,115,0
2_962113,in_package5_plane4,962113,2,1,28,29,0
2_7586955,at_package5_city1-2,7586955,2,5,9,14,0
1_4057409,fly-airplane_plane1_city7-2_city6-2,4057409,1,4,105,109,0
1_3654759,fly-airplane_plane1_city10-2_city3-2,3654759,1,4,105,109,0
1_147109,fly-airplane_plane2_city10-2_city7-2,147109,1,4,107,111,0
1_6975909,fly-airplane_plane2_city1-2_city8-2,6975909,1,4,107,111,0
1_847009,fly-airplane_plane3_city6-2_city2-2,847009,1,3,107,110,0
0_4904399,at_plane3_city6-2,4904399,0,0,9,9,0
1_1221759,fly-airplane_plane4_city9-2_city5-2,1221759,1,4,107,111,0
1_4756559,load-airplane_package1_plane4_city2-2,4756559,1,5,110,115,0
2_5646949,in_package1_plane4,5646949,2,1,28,29,0
2_6823957,at_package1_city2-2,6823957,2,5,10,15,0
2_1230283,truck_truck10,1230283,2,1,9,10,0
1_6690160,noop_at_truck6_city6-2,6690160,1,1,4,5,0
1_6092910,noop_at_plane4_city5-2,6092910,1,1,106,107,0
1_6144560,fly-airplane_plane1_city9-2_city6-2,6144560,1,4,105,109,0
1_1034960,fly-airplane_plane1_city8-2_city5-2,1034960,1,4,105,109,0
1_3953460,fly-airplane_plane2_city2-2_city7-2,3953460,1,4,107,111,0
1_614560,fly-airplane_plane3_city1-2_city10-2,614560,1,4,107,111,0
1_2934160,fly-airplane_plane3_city8-2_city2-2,2934160,1,4,107,111,0
1_5852660,fly-airplane_plane4_city2-2_city4-2,5852660,1,4,107,111,0
1_743060,fly-airplane_plane4_city1-2_city3-2,743060,1,4,107,111,0
1_5665861,fly-airplane_plane1_city1-2_city4-2,5665861,1,4,105,109,0
1_6040611,fly-airplane_plane2_city4-2_city7-2,6040611,1,4,107,111,0
1_1305761,fly-airplane_plane3_city6-2_city9-2,1305761,1,4,107,111,0
1_7582311,fly-airplane_plane4_city7-2_city10-2,7582311,1,3,107,110,0
0_1176580,at_plane4_city7-2,1176580,0,0,10,10,0
2_5367137,in-city_city1-1_city1,5367137,2,1,3,4,0
2_5001178,location_city2-1,5001178,2,1,4,5,0
1_7753012,fly-airplane_plane1_city3-2_city4-2,7753012,1,4,105,109,0
1_2643412,fly-airplane_plane1_city2-2_city3-2,2643412,1,4,105,109,0
1_3018162,fly-airplane_plane2_city5-2_city6-2,3018162,1,4,107,111,0
1_4050612,fly-airplane_plane3_city10-2_city2-2,4050612,1,4,107,111,0
1_3392912,fly-airplane_plane3_city8-2_city9-2,3392912,1,4,107,111,0
1_4917362,fly-airplane_plane4_city5-2_city3-2,4917362,1,4,107,111,0
1_542962,fly-airplane_plane4_city10-2_city6-2,542962,1,4,107,111,0
1_5191062,load-truck_package1_truck2_city2-2,5191062,1,4,10,14,0
0_552080,at_truck2_city2-2,552080,0,0,2,2,0
2_552683,in_package1_truck2,552683,2,1,8,9,0
1_1871663,noop_at_truck3_city3-2,1871663,1,0,4,4,0
0_4825238,at_truck3_city3-2,4825238,0,0,2,2,0
1_1274413,noop_at_plane1_city2-2,1274413,1,1,103,104,0
2_5001179,location_city2-2,5001179,2,1,35,36,0
2_3715160,airplane_plane1,3715160,2,1,154,155,0
1_4730563,fly-airplane_plane1_city4-2_city3-2,4730563,1,4,105,109,0
1_5105313,fly-airplane_plane2_city7-2_city6-2,5105313,1,4,107,111,0
1_370463,fly-airplane_plane3_city9-2_city8-2,370463,1,4,107,111,0
1_7004513,fly-airplane_plane4_city7-2_city3-2,7004513,1,4,107,111,0
1_1894913,fly-airplane_plane4_city6-2_city2-2,1894913,1,3,107,110,0
0_1111044,at_plane4_city6-2,1111044,0,0,9,9,0
1_4500263,load-airplane_package5_plane3_city1-2,4500263,1,5,111,116,0
2_962112,in_package5_plane3,962112,2,1,27,28,0
1_5630764,noop_at_plane1_city10-2,5630764,1,1,104,105,0
2_5459930,location_city9-1,5459930,2,1,3,4,0
2_3715161,airplane_plane2,3715161,2,1,154,155,0
1_1708114,fly-airplane_plane1_city5-2_city2-2,1708114,1,4,105,109,0
1_7192464,fly-airplane_plane2_city9-2_city6-2,7192464,1,4,107,111,0
1_2082864,fly-airplane_plane2_city8-2_city5-2,2082864,1,4,107,111,0
1_5001364,fly-airplane_plane3_city2-2_city7-2,5001364,1,4,107,111,0
1_4509364,fly-airplane_plane3_city10-2_city9-2,4509364,1,4,107,111,0
1_266514,fly-airplane_plane4_city4-2_city9-2,266514,1,4,107,111,0
1_3982064,fly-airplane_plane4_city8-2_city2-2,3982064,1,4,107,111,0
1_3817414,unload-airplane_package3_plane4_city3-2,3817414,1,4,113,117,0
0_3304531,in_package3_plane4,3304531,0,0,1,1,0
2_2816590,in-city_city8-1_city8,2816590,2,1,3,4,0
1_1733165,noop_at_plane1_city9-2,1733165,1,1,104,105,0
2_5459931,location_city9-2,5459931,2,1,29,30,0
1_5809715,noop_at_plane2_city7-2,5809715,1,1,105,106,0
2_519912,airport_city7-2,519912,2,1,73,74,0
2_3715162,airplane_plane3,3715162,2,1,154,155,0
1_7670415,noop_at_plane3_city10-2,7670415,1,1,106,107,0
1_3795265,fly-airplane_plane1_city7-2_city2-2,3795265,1,4,105,109,0
1_79715,fly-airplane_plane1_city3-2_city9-2,79715,1,4,105,109,0
1_6713765,fly-airplane_plane2_city1-2_city4-2,6713765,1,4,107,111,0
1_7088515,fly-airplane_plane3_city4-2_city7-2,7088515,1,4,107,111,0
1_1978915,fly-airplane_plane3_city3-2_city6-2,1978915,1,4,107,111,0
1_6474215,fly-airplane_plane3_city8-2_city10-2,6474215,1,4,107,111,0
1_2353665,fly-airplane_plane4_city6-2_city9-2,2353665,1,4,107,111,0
1_959615,fly-airplane_plane4_city9-2_city1-2,959615,1,4,107,111,0
2_3143541,in-city_city1-2_city1,3143541,2,1,3,4,0
1_1754216,noop_at_plane3_city3-2,1754216,1,1,105,106,0
1_5830766,noop_at_plane4_city1-2,5830766,1,1,105,106,0
2_3715163,airplane_plane4,3715163,2,1,154,155,0
1_5882416,fly-airplane_plane1_city9-2_city2-2,5882416,1,4,105,109,0
1_2166866,fly-airplane_plane1_city5-2_city9-2,2166866,1,4,105,109,0
1_772816,fly-airplane_plane1_city8-2_city1-2,772816,1,4,105,109,0
1_3691316,fly-airplane_plane2_city2-2_city3-2,3691316,1,4,107,111,0
1_4066066,fly-airplane_plane3_city5-2_city6-2,4066066,1,4,107,111,0
1_4440816,fly-airplane_plane4_city8-2_city9-2,4440816,1,4,107,111,0
1_4934766,load-truck_package5_truck1_city1-2,4934766,1,4,10,14,0
0_4279899,at_truck1_city1-2,4279899,0,0,2,2,0
2_3868823,in_package5_truck1,3868823,2,1,8,9,0
1_4254017,fly-airplane_plane1_city7-2_city9-2,4254017,1,4,105,109,0
1_3851367,fly-airplane_plane1_city10-2_city6-2,3851367,1,4,105,109,0
1_5778467,fly-airplane_plane2_city4-2_city3-2,5778467,1,4,107,111,0
1_1043617,fly-airplane_plane3_city6-2_city5-2,1043617,1,4,107,111,0
1_1418367,fly-airplane_plane4_city9-2_city8-2,1418367,1,4,107,111,0
1_6289518,noop_at_plane4_city8-2,6289518,1,1,106,107,0
1_7865618,fly-airplane_plane2_city6-2_city3-2,7865618,1,4,107,111,0
1_2756018,fly-airplane_plane2_city5-2_city2-2,2756018,1,4,107,111,0
1_3130768,fly-airplane_plane3_city8-2_city5-2,3130768,1,4,107,111,0
1_6049268,fly-airplane_plane4_city2-2_city7-2,6049268,1,4,107,111,0
1_280818,fly-airplane_plane4_city10-2_city2-2,280818,1,4,107,111,0
1_939668,fly-airplane_plane4_city1-2_city6-2,939668,1,4,107,111,0
2_6609944,in-city_city7-1_city7,6609944,2,1,3,4,0
1_5862469,fly-airplane_plane1_city1-2_city7-2,5862469,1,4,105,109,0
1_4843169,fly-airplane_plane2_city7-2_city2-2,4843169,1,4,107,111,0
1_5366119,fly-airplane_plane2_city9-2_city10-2,5366119,1,4,107,111,0
1_108319,fly-airplane_plane3_city9-2_city4-2,108319,1,4,107,111,0
1_7761669,fly-airplane_plane3_city1-2_city4-2,7761669,1,4,107,111,0
1_3142669,unload-truck_package2_truck10_city10-1,3142669,1,4,8,12,0
0_1676676,in_package2_truck10,1676676,0,0,1,1,0
2_5197786,location_city5-1,5197786,2,1,3,4,0
1_7949620,fly-airplane_plane1_city3-2_city7-2,7949620,1,4,105,109,0
1_2840020,fly-airplane_plane1_city2-2_city6-2,2840020,1,4,105,109,0
1_6930320,fly-airplane_plane2_city9-2_city2-2,6930320,1,4,107,111,0
1_3214770,fly-airplane_plane2_city5-2_city9-2,3214770,1,4,107,111,0
1_7754870,fly-airplane_plane2_city10-2_city1-2,7754870,1,4,107,111,0
1_1820720,fly-airplane_plane2_city8-2_city1-2,1820720,1,4,107,111,0
1_4739220,fly-airplane_plane3_city2-2_city3-2,4739220,1,4,107,111,0
1_4247220,fly-airplane_plane3_city10-2_city5-2,4247220,1,4,107,111,0
1_4370,fly-airplane_plane4_city4-2_city5-2,4370,1,4,107,111,0
1_5113970,fly-airplane_plane4_city5-2_city6-2,5113970,1,4,107,111,0
1_739570,fly-airplane_plane4_city10-2_city9-2,739570,1,4,107,111,0
1_134670,load-airplane_package1_plane1_city2-2,134670,1,5,109,114,0
2_5646946,in_package1_plane1,5646946,2,1,28,29,0
2_7566596,location_city10-1,7566596,2,1,5,6,0
1_1471021,noop_at_plane1_city5-2,1471021,1,1,104,105,0
2_5197787,location_city5-2,5197787,2,1,29,30,0
1_6144821,noop_at_truck4_city4-2,6144821,1,0,4,4,0
0_1097419,at_truck4_city4-2,1097419,0,0,1,1,0
2_257768,airport_city3-2,257768,2,1,73,74,0
1_4927171,fly-airplane_plane1_city4-2_city6-2,4927171,1,4,105,109,0
1_153171,fly-airplane_plane1_city1-2_city10-2,153171,1,4,105,109,0
1_5301921,fly-airplane_plane2_city7-2_city9-2,5301921,1,4,107,111,0
1_192321,fly-airplane_plane2_city6-2_city8-2,192321,1,4,107,111,0
1_6826371,fly-airplane_plane3_city4-2_city3-2,6826371,1,4,107,111,0
1_1716771,fly-airplane_plane3_city3-2_city2-2,1716771,1,4,107,111,0
1_7201121,fly-airplane_plane4_city7-2_city6-2,7201121,1,4,107,111,0
1_2091521,fly-airplane_plane4_city6-2_city5-2,2091521,1,4,107,111,0
1_2704421,fly-airplane_plane4_city8-2_city10-2,2704421,1,4,107,111,0
2_7566597,location_city10-2,7566597,2,1,35,36,0
1_7120922,fly-airplane_plane2_city7-2_city10-2,7120922,1,4,107,111,0
1_3803922,fly-airplane_plane3_city5-2_city2-2,3803922,1,4,107,111,0
1_88372,fly-airplane_plane3_city1-2_city9-2,88372,1,4,107,111,0
1_4178672,fly-airplane_plane4_city8-2_city5-2,4178672,1,4,107,111,0
2_4386348,in-city_city7-2_city7,4386348,2,1,3,4,0
2_2402321,in-city_city6-1_city6,2402321,2,1,3,4,0
1_3991873,fly-airplane_plane1_city7-2_city5-2,3991873,1,4,105,109,0
1_3589223,fly-airplane_plane1_city10-2_city2-2,3589223,1,4,105,109,0
1_81573,fly-airplane_plane2_city10-2_city6-2,81573,1,4,107,111,0
1_6910373,fly-airplane_plane2_city1-2_city7-2,6910373,1,4,107,111,0
1_2175523,fly-airplane_plane3_city3-2_city9-2,2175523,1,4,107,111,0
1_781473,fly-airplane_plane3_city6-2_city1-2,781473,1,4,107,111,0
1_1156223,fly-airplane_plane4_city9-2_city4-2,1156223,1,4,107,111,0
1_1326324,noop_at_truck1_city1-2,1326324,1,1,4,5,0
1_1950824,noop_at_plane3_city6-2,1950824,1,1,106,107,0
1_6027374,noop_at_plane4_city4-2,6027374,1,1,106,107,0
1_6079024,fly-airplane_plane1_city9-2_city5-2,6079024,1,4,105,109,0
1_969424,fly-airplane_plane1_city8-2_city4-2,969424,1,4,105,109,0
1_3887924,fly-airplane_plane2_city2-2_city6-2,3887924,1,4,107,111,0
1_7978224,fly-airplane_plane3_city9-2_city2-2,7978224,1,4,107,111,0
1_4262674,fly-airplane_plane3_city5-2_city9-2,4262674,1,4,107,111,0
1_2868624,fly-airplane_plane3_city8-2_city1-2,2868624,1,4,107,111,0
1_4459224,fly-airplane_plane4_city6-2_city10-2,4459224,1,4,107,111,0
1_5787124,fly-airplane_plane4_city2-2_city3-2,5787124,1,4,107,111,0
1_677524,fly-airplane_plane4_city1-2_city2-2,677524,1,4,107,111,0
1_3471674,load-truck_package3_truck3_city3-2,3471674,1,5,14,19,0
2_6211243,in_package3_truck3,6211243,2,1,9,10,0
1_4047975,fly-airplane_plane1_city10-2_city9-2,4047975,1,4,105,109,0
1_5600325,fly-airplane_plane1_city1-2_city3-2,5600325,1,4,105,109,0
1_5975075,fly-airplane_plane2_city4-2_city6-2,5975075,1,4,107,111,0
1_1240225,fly-airplane_plane3_city6-2_city8-2,1240225,1,4,107,111,0
1_1596325,fly-airplane_plane3_city9-2_city10-2,1596325,1,4,107,111,0
1_7874275,fly-airplane_plane4_city4-2_city3-2,7874275,1,4,107,111,0
2_4935642,location_city1-1,4935642,2,1,4,5,0
1_6012826,fly-airplane_plane1_city8-2_city10-2,6012826,1,4,105,109,0
1_3985076,fly-airplane_plane3_city10-2_city1-2,3985076,1,4,107,111,0
1_4851826,fly-airplane_plane4_city5-2_city2-2,4851826,1,4,107,111,0
1_477426,fly-airplane_plane4_city10-2_city5-2,477426,1,4,107,111,0
1_1136276,fly-airplane_plane4_city1-2_city9-2,1136276,1,4,107,111,0
2_4935643,location_city1-2,4935643,2,1,35,36,0
2_178725,in-city_city6-2_city6,178725,2,1,3,4,0
1_1208877,noop_at_plane1_city1-2,1208877,1,1,103,104,0
1_4665027,fly-airplane_plane1_city4-2_city2-2,4665027,1,4,105,109,0
1_5039777,fly-airplane_plane2_city7-2_city5-2,5039777,1,4,107,111,0
1_304927,fly-airplane_plane3_city9-2_city7-2,304927,1,4,107,111,0
1_7958277,fly-airplane_plane3_city1-2_city7-2,7958277,1,4,107,111,0
1_6214027,fly-airplane_plane4_city4-2_city10-2,6214027,1,4,107,111,0
1_6938977,fly-airplane_plane4_city7-2_city2-2,6938977,1,4,107,111,0
1_1829377,fly-airplane_plane4_city6-2_city1-2,1829377,1,4,107,111,0
2_5394394,location_city8-1,5394394,2,1,3,4,0
1_3036628,fly-airplane_plane1_city2-2_city9-2,3036628,1,4,105,109,0
1_1642578,fly-airplane_plane1_city5-2_city1-2,1642578,1,4,105,109,0
1_7126928,fly-airplane_plane2_city9-2_city5-2,7126928,1,4,107,111,0
1_7951478,fly-airplane_plane2_city10-2_city4-2,7951478,1,4,107,111,0
1_2017328,fly-airplane_plane2_city8-2_city4-2,2017328,1,4,107,111,0
1_4935828,fly-airplane_plane3_city2-2_city6-2,4935828,1,4,107,111,0
1_4443828,fly-airplane_plane3_city10-2_city8-2,4443828,1,4,107,111,0
1_200978,fly-airplane_plane4_city4-2_city8-2,200978,1,4,107,111,0
1_5310578,fly-airplane_plane4_city5-2_city9-2,5310578,1,4,107,111,0
1_3916528,fly-airplane_plane4_city8-2_city1-2,3916528,1,4,107,111,0
2_5394395,location_city8-2,5394395,2,1,29,30,0
1_5744179,noop_at_plane2_city6-2,5744179,1,1,106,107,0
2_454376,airport_city6-2,454376,2,1,73,74,0
1_1667629,noop_at_plane1_city8-2,1667629,1,1,104,105,0
1_5123779,fly-airplane_plane1_city4-2_city9-2,5123779,1,4,105,109,0
1_3729729,fly-airplane_plane1_city7-2_city1-2,3729729,1,4,105,109,0
1_14179,fly-airplane_plane1_city3-2_city8-2,14179,1,4,105,109,0
1_6648229,fly-airplane_plane2_city1-2_city3-2,6648229,1,4,107,111,0
1_7022979,fly-airplane_plane3_city4-2_city6-2,7022979,1,4,107,111,0
1_1913379,fly-airplane_plane3_city3-2_city5-2,1913379,1,4,107,111,0
1_7397729,fly-airplane_plane4_city7-2_city9-2,7397729,1,4,107,111,0
1_2288129,fly-airplane_plane4_city6-2_city8-2,2288129,1,4,107,111,0
1_1566079,load-truck_package4_truck7_city7-2,1566079,1,5,12,17,0
2_5040038,in_package4_truck7,5040038,2,1,9,10,0
1_3507680,noop_at_truck9_city9-2,3507680,1,1,4,5,0
1_1688680,noop_at_plane3_city2-2,1688680,1,1,105,106,0
1_5816880,fly-airplane_plane1_city9-2_city1-2,5816880,1,4,105,109,0
1_2101330,fly-airplane_plane1_city5-2_city8-2,2101330,1,4,105,109,0
1_7968830,fly-airplane_plane4_city2-2_city10-2,7968830,1,4,107,111,0
1_1256180,drive-truck_truck4_city4-2_city4-1_city4,1256180,1,7,5,12,0
1_3682130,load-airplane_package4_plane2_city7-2,3682130,1,5,113,118,0
2_2133320,in_package4_plane2,2133320,2,1,28,29,0
1_6118831,noop_at_truck10_city10-2,6118831,1,1,7,8,0
2_5781406,in-city_city3-1_city3,5781406,2,1,3,4,0
1_4188481,fly-airplane_plane1_city7-2_city8-2,4188481,1,4,105,109,0
1_3785831,fly-airplane_plane1_city10-2_city5-2,3785831,1,4,105,109,0
1_5712931,fly-airplane_plane2_city4-2_city2-2,5712931,1,4,107,111,0
1_278181,fly-airplane_plane2_city10-2_city9-2,278181,1,4,107,111,0
1_978081,fly-airplane_plane3_city6-2_city4-2,978081,1,4,107,111,0
1_5105931,fly-airplane_plane3_city5-2_city10-2,5105931,1,4,107,111,0
1_1352831,fly-airplane_plane4_city9-2_city7-2,1352831,1,4,107,111,0
1_2613681,drive-truck_truck3_city3-2_city3-1_city3,2613681,1,7,6,13,0
1_5599482,noop_at_truck2_city2-2,5599482,1,1,4,5,0
1_6223982,noop_at_plane4_city7-2,6223982,1,1,105,106,0
1_2147432,noop_at_plane3_city9-2,2147432,1,1,106,107,0
1_6275632,fly-airplane_plane1_city9-2_city8-2,6275632,1,4,105,109,0
1_1166032,fly-airplane_plane1_city8-2_city7-2,1166032,1,4,105,109,0
1_7800082,fly-airplane_plane2_city6-2_city2-2,7800082,1,4,107,111,0
1_4084532,fly-airplane_plane2_city2-2_city9-2,4084532,1,4,107,111,0
1_2690482,fly-airplane_plane2_city5-2_city1-2,2690482,1,4,107,111,0
1_2243032,fly-airplane_plane2_city8-2_city10-2,2243032,1,4,107,111,0
1_3065232,fly-airplane_plane3_city8-2_city4-2,3065232,1,4,107,111,0
1_5983732,fly-airplane_plane4_city2-2_city6-2,5983732,1,4,107,111,0
1_215282,fly-airplane_plane4_city10-2_city1-2,215282,1,4,107,111,0
1_874132,fly-airplane_plane4_city1-2_city5-2,874132,1,4,107,111,0
1_3971182,drive-truck_truck2_city2-2_city2-1_city2,3971182,1,7,6,13,0
1_5796933,fly-airplane_plane1_city1-2_city6-2,5796933,1,4,105,109,0
1_6171683,fly-airplane_plane2_city4-2_city9-2,6171683,1,4,107,111,0
1_4777633,fly-airplane_plane2_city7-2_city1-2,4777633,1,4,107,111,0
1_42783,fly-airplane_plane3_city9-2_city3-2,42783,1,4,107,111,0
1_7696133,fly-airplane_plane3_city1-2_city3-2,7696133,1,4,107,111,0
1_5328683,drive-truck_truck1_city1-2_city1-1_city1,5328683,1,7,6,13,0
2_5132250,location_city4-1,5132250,2,1,3,4,0
1_7884084,fly-airplane_plane1_city3-2_city6-2,7884084,1,4,105,109,0
1_2774484,fly-airplane_plane1_city2-2_city5-2,2774484,1,4,105,109,0
1_6864784,fly-airplane_plane2_city9-2_city1-2,6864784,1,4,107,111,0
1_3149234,fly-airplane_plane2_city5-2_city8-2,3149234,1,4,107,111,0
1_6860734,fly-airplane_plane3_city3-2_city10-2,6860734,1,4,107,111,0
1_4181684,fly-airplane_plane3_city10-2_city4-2,4181684,1,4,107,111,0
1_674034,fly-airplane_plane4_city10-2_city8-2,674034,1,4,107,111,0
2_1573783,in-city_city2-1_city2,1573783,2,1,3,4,0
1_5482035,noop_at_plane2_city2-2,5482035,1,1,105,106,0
2_192232,airport_city2-2,192232,2,1,73,74,0
2_3557810,in-city_city3-2_city3,3557810,2,1,3,4,0
1_1405485,noop_at_plane1_city4-2,1405485,1,1,104,105,0
2_5132251,location_city4-2,5132251,2,1,29,30,0
2_7347850,in-city_city10-2_city10,7347850,2,1,3,4,0
1_4861635,fly-airplane_plane1_city4-2_city5-2,4861635,1,4,105,109,0
1_5236385,fly-airplane_plane2_city7-2_city8-2,5236385,1,4,107,111,0
1_126785,fly-airplane_plane2_city6-2_city7-2,126785,1,4,107,111,0
1_3997835,fly-airplane_plane2_city6-2_city10-2,3997835,1,4,107,111,0
1_6760835,fly-airplane_plane3_city4-2_city2-2,6760835,1,4,107,111,0
1_1651235,fly-airplane_plane3_city3-2_city1-2,1651235,1,4,107,111,0
1_7135585,fly-airplane_plane4_city7-2_city5-2,7135585,1,4,107,111,0
1_2025985,fly-airplane_plane4_city6-2_city4-2,2025985,1,4,107,111,0
1_7475485,load-airplane_package4_plane1_city7-2,7475485,1,5,111,116,0
2_2133319,in_package4_plane1,2133319,2,1,27,28,0
2_2661380,truck_truck1,2661380,2,1,8,9,0
1_6110936,noop_in_package4_plane3,6110936,1,0,101,101,0
0_2133321,in_package4_plane3,2133321,0,0,1,1,0
1_1134936,fly-airplane_plane1_city9-2_city10-2,1134936,1,4,105,109,0
1_1839186,fly-airplane_plane1_city5-2_city4-2,1839186,1,4,105,109,0
1_7323536,fly-airplane_plane2_city9-2_city8-2,7323536,1,4,107,111,0
1_2213936,fly-airplane_plane2_city8-2_city7-2,2213936,1,4,107,111,0
1_5132436,fly-airplane_plane3_city2-2_city9-2,5132436,1,4,107,111,0
1_3738386,fly-airplane_plane3_city5-2_city1-2,3738386,1,4,107,111,0
1_22836,fly-airplane_plane3_city1-2_city8-2,22836,1,4,107,111,0
1_4113136,fly-airplane_plane4_city8-2_city4-2,4113136,1,4,107,111,0
1_5940787,noop_at_plane2_city9-2,5940787,1,1,106,107,0
2_650984,airport_city9-2,650984,2,1,73,74,0
2_2661381,truck_truck2,2661381,2,1,8,9,0
1_3822037,noop_in_package2_truck10,3822037,1,1,6,7,0
1_3926337,fly-airplane_plane1_city7-2_city4-2,3926337,1,4,105,109,0
1_3523687,fly-airplane_plane1_city10-2_city1-2,3523687,1,4,105,109,0
1_16037,fly-airplane_plane2_city10-2_city5-2,16037,1,4,107,111,0
1_6844837,fly-airplane_plane2_city1-2_city6-2,6844837,1,4,107,111,0
1_7219587,fly-airplane_plane3_city4-2_city9-2,7219587,1,4,107,111,0
1_2109987,fly-airplane_plane3_city3-2_city8-2,2109987,1,4,107,111,0
1_1090687,fly-airplane_plane4_city9-2_city3-2,1090687,1,4,107,111,0
1_1336137,fly-airplane_plane4_city5-2_city10-2,1336137,1,4,107,111,0
1_548937,load-airplane_package1_plane3_city2-2,548937,1,5,111,116,0
2_5646948,in_package1_plane3,5646948,2,1,28,29,0
1_2208637,load-airplane_package3_plane1_city3-2,2208637,1,5,113,118,0
2_3304528,in_package3_plane1,3304528,2,1,27,28,0
2_2661382,truck_truck3,2661382,2,1,7,8,0
2_7024213,in-city_city9-1_city9,7024213,2,1,3,4,0
1_1885288,noop_at_plane3_city5-2,1885288,1,1,106,107,0
1_6013488,fly-airplane_plane1_city9-2_city4-2,6013488,1,4,105,109,0
1_903888,fly-airplane_plane1_city8-2_city3-2,903888,1,4,105,109,0
1_5752638,fly-airplane_plane2_city4-2_city10-2,5752638,1,4,107,111,0
1_3822388,fly-airplane_plane2_city2-2_city5-2,3822388,1,4,107,111,0
1_7912688,fly-airplane_plane3_city9-2_city1-2,7912688,1,4,107,111,0
1_4197138,fly-airplane_plane3_city5-2_city8-2,4197138,1,4,107,111,0
2_2661383,truck_truck4,2661383,2,1,5,6,0
2_7351164,in-city_city2-2_city2,7351164,2,1,3,4,0
1_2889739,fly-airplane_plane1_city7-2_city10-2,2889739,1,4,105,109,0
1_3982439,fly-airplane_plane1_city10-2_city8-2,3982439,1,4,105,109,0
1_5534789,fly-airplane_plane1_city1-2_city2-2,5534789,1,4,105,109,0
1_5909539,fly-airplane_plane2_city4-2_city5-2,5909539,1,4,107,111,0
1_1174689,fly-airplane_plane3_city6-2_city7-2,1174689,1,4,107,111,0
1_7808739,fly-airplane_plane4_city4-2_city2-2,7808739,1,4,107,111,0
2_2661384,truck_truck5,2661384,2,1,5,6,0
1_7621940,fly-airplane_plane1_city3-2_city2-2,7621940,1,4,105,109,0
1_2512340,fly-airplane_plane1_city2-2_city1-2,2512340,1,4,105,109,0
1_7996690,fly-airplane_plane2_city6-2_city5-2,7996690,1,4,107,111,0
1_2887090,fly-airplane_plane2_city5-2_city4-2,2887090,1,4,107,111,0
1_3261840,fly-airplane_plane3_city8-2_city7-2,3261840,1,4,107,111,0
1_6180340,fly-airplane_plane4_city2-2_city9-2,6180340,1,4,107,111,0
1_4786290,fly-airplane_plane4_city5-2_city1-2,4786290,1,4,107,111,0
1_411890,fly-airplane_plane4_city10-2_city4-2,411890,1,4,107,111,0
1_1070740,fly-airplane_plane4_city1-2_city8-2,1070740,1,4,107,111,0
1_4876640,unload-airplane_package4_plane3_city7-2,4876640,1,5,111,116,0
2_2661385,truck_truck6,2661385,2,1,5,6,0
1_2962341,noop_at_truck7_city7-2,2962341,1,1,4,5,0
1_4599491,fly-airplane_plane1_city4-2_city1-2,4599491,1,4,105,109,0
1_5993541,fly-airplane_plane1_city1-2_city9-2,5993541,1,4,105,109,0
1_4974241,fly-airplane_plane2_city7-2_city4-2,4974241,1,4,107,111,0
1_7507441,fly-airplane_plane2_city2-2_city10-2,7507441,1,4,107,111,0
1_228041,fly-airplane_plane3_city6-2_city10-2,228041,1,4,107,111,0
1_239391,fly-airplane_plane3_city9-2_city6-2,239391,1,4,107,111,0
1_7892741,fly-airplane_plane3_city1-2_city6-2,7892741,1,4,107,111,0
1_6873441,fly-airplane_plane4_city7-2_city1-2,6873441,1,4,107,111,0
1_292641,load-airplane_package5_plane2_city1-2,292641,1,5,111,116,0
2_962111,in_package5_plane2,962111,2,1,27,28,0
2_2661386,truck_truck7,2661386,2,1,7,8,0
2_4800617,in-city_city9-2_city9,4800617,2,1,3,4,0
2_5328858,location_city7-1,5328858,2,1,4,5,0
1_2971092,fly-airplane_plane1_city2-2_city8-2,2971092,1,4,105,109,0
1_4644542,fly-airplane_plane1_city5-2_city10-2,4644542,1,4,105,109,0
1_7061392,fly-airplane_plane2_city9-2_city4-2,7061392,1,4,107,111,0
1_7885942,fly-airplane_plane2_city10-2_city3-2,7885942,1,4,107,111,0
1_1951792,fly-airplane_plane2_city8-2_city3-2,1951792,1,4,107,111,0
1_4870292,fly-airplane_plane3_city2-2_city5-2,4870292,1,4,107,111,0
1_4378292,fly-airplane_plane3_city10-2_city7-2,4378292,1,4,107,111,0
1_135442,fly-airplane_plane4_city4-2_city7-2,135442,1,4,107,111,0
1_5245042,fly-airplane_plane4_city5-2_city8-2,5245042,1,4,107,111,0
1_4342292,load-airplane_package1_plane2_city2-2,4342292,1,5,111,116,0
2_5646947,in_package1_plane2,5646947,2,1,28,29,0
2_6497292,city_city1,6497292,2,1,3,4,0
1_5678643,noop_at_plane2_city5-2,5678643,1,1,106,107,0
2_388840,airport_city5-2,388840,2,1,73,74,0
2_2661387,truck_truck8,2661387,2,1,5,6,0
1_1602093,noop_at_plane1_city7-2,1602093,1,1,103,104,0
2_5328859,location_city7-2,5328859,2,1,30,31,0
1_5058243,fly-airplane_plane1_city4-2_city8-2,5058243,1,4,105,109,0
1_6582693,fly-airplane_plane2_city1-2_city2-2,6582693,1,4,107,111,0
1_6957443,fly-airplane_plane3_city4-2_city5-2,6957443,1,4,107,111,0
1_1847843,fly-airplane_plane3_city3-2_city4-2,1847843,1,4,107,111,0
1_7332193,fly-airplane_plane4_city7-2_city8-2,7332193,1,4,107,111,0
1_2222593,fly-airplane_plane4_city6-2_city7-2,2222593,1,4,107,111,0
1_4845743,fly-airplane_plane4_city1-2_city10-2,4845743,1,4,107,111,0
2_6497293,city_city2,6497293,2,1,3,4,0
2_2661388,truck_truck9,2661388,2,1,5,6,0
2_518082,in-city_city10-1_city10,518082,2,1,3,4,0
1_7282144,noop_in_package3_plane2,7282144,1,0,103,103,0
0_3304529,in_package3_plane2,3304529,0,0,1,1,0
1_1623144,noop_at_plane3_city1-2,1623144,1,1,105,106,0
1_2035794,fly-airplane_plane1_city5-2_city7-2,2035794,1,4,105,109,0
1_3560244,fly-airplane_plane2_city2-2_city1-2,3560244,1,4,107,111,0
1_1982844,fly-airplane_plane3_city4-2_city10-2,1982844,1,4,107,111,0
1_3934994,fly-airplane_plane3_city5-2_city4-2,3934994,1,4,107,111,0
1_4309744,fly-airplane_plane4_city8-2_city7-2,4309744,1,4,107,111,0
2_6497294,city_city3,6497294,2,1,3,4,0
2_4435789,obj_package1,4435789,2,1,48,49,0
1_6399345,fly-airplane_plane1_city3-2_city10-2,6399345,1,4,105,109,0
1_3720295,fly-airplane_plane1_city10-2_city4-2,3720295,1,4,105,109,0
1_5647395,fly-airplane_plane2_city4-2_city1-2,5647395,1,4,107,111,0
1_212645,fly-airplane_plane2_city10-2_city8-2,212645,1,4,107,111,0
1_7041445,fly-airplane_plane2_city1-2_city9-2,7041445,1,4,107,111,0
1_912545,fly-airplane_plane3_city6-2_city3-2,912545,1,4,107,111,0
1_1287295,fly-airplane_plane4_city9-2_city6-2,1287295,1,4,107,111,0
2_6497295,city_city4,6497295,2,1,3,4,0
2_592994,in-city_city8-2_city8,592994,2,1,3,4,0
1_6158446,noop_at_plane4_city6-2,6158446,1,1,106,107,0
2_4435790,obj_package2,4435790,2,1,9,10,0
1_7282146,noop_in_package3_plane4,7282146,1,1,103,104,0
1_2081896,noop_at_plane3_city8-2,2081896,1,1,106,107,0
1_6210096,fly-airplane_plane1_city9-2_city7-2,6210096,1,4,105,109,0
1_1100496,fly-airplane_plane1_city8-2_city6-2,1100496,1,4,105,109,0
1_7734546,fly-airplane_plane2_city6-2_city1-2,7734546,1,4,107,111,0
1_4018996,fly-airplane_plane2_city2-2_city8-2,4018996,1,4,107,111,0
1_2999696,fly-airplane_plane3_city8-2_city3-2,2999696,1,4,107,111,0
1_5918196,fly-airplane_plane4_city2-2_city5-2,5918196,1,4,107,111,0
1_808596,fly-airplane_plane4_city1-2_city4-2,808596,1,4,107,111,0
1_4085996,load-airplane_package5_plane1_city1-2,4085996,1,5,109,114,0
2_962110,in_package5_plane1,962110,2,1,27,28,0
2_6497296,city_city5,6497296,2,1,3,4,0
2_4435791,obj_package3,4435791,2,1,93,94,0
1_5731397,fly-airplane_plane1_city1-2_city5-2,5731397,1,4,105,109,0
1_6106147,fly-airplane_plane2_city4-2_city8-2,6106147,1,4,107,111,0
1_3737647,fly-airplane_plane3_city2-2_city10-2,3737647,1,4,107,111,0
1_7630597,fly-airplane_plane3_city1-2_city2-2,7630597,1,4,107,111,0
1_3403147,unload-airplane_package3_plane2_city3-2,3403147,1,5,113,118,0
1_4096397,load-airplane_package4_plane4_city7-2,4096397,1,5,113,118,0
2_2133322,in_package4_plane4,2133322,2,1,28,29,0
2_6497297,city_city6,6497297,2,1,3,4,0
2_4435792,obj_package4,4435792,2,1,93,94,0
2_5066714,location_city3-1,5066714,2,1,4,5,0
1_7818548,fly-airplane_plane1_city3-2_city5-2,7818548,1,4,105,109,0
1_2708948,fly-airplane_plane1_city2-2_city4-2,2708948,1,4,105,109,0
1_3083698,fly-airplane_plane2_city5-2_city7-2,3083698,1,4,107,111,0
1_874748,fly-airplane_plane2_city5-2_city10-2,874748,1,4,107,111,0
1_4608148,fly-airplane_plane3_city2-2_city1-2,4608148,1,4,107,111,0
1_4116148,fly-airplane_plane3_city10-2_city3-2,4116148,1,4,107,111,0
1_4982898,fly-airplane_plane4_city5-2_city4-2,4982898,1,4,107,111,0
1_608498,fly-airplane_plane4_city10-2_city7-2,608498,1,4,107,111,0
2_6497298,city_city7,6497298,2,1,3,4,0
1_7235499,noop_at_truck8_city8-2,7235499,1,1,4,5,0
1_5416499,noop_at_plane2_city1-2,5416499,1,1,105,106,0
2_126696,airport_city1-2,126696,2,1,73,74,0
2_4435793,obj_package5,4435793,2,1,48,49,0
1_1339949,noop_at_plane1_city3-2,1339949,1,1,103,104,0
2_5066715,location_city3-2,5066715,2,1,30,31,0
1_6695299,fly-airplane_plane3_city4-2_city1-2,6695299,1,4,107,111,0
1_7070049,fly-airplane_plane4_city7-2_city4-2,7070049,1,4,107,111,0
1_1960449,fly-airplane_plane4_city6-2_city3-2,1960449,1,4,107,111,0
3_2937985,noop_in-city_city10-2_city10,2937985,3,1,1,2,0
3_7656764,drive-truck_truck10_city10-1_city10-2_city10,7656764,3,13,16,29,0
3_1874900,drive-truck_truck10_city10-2_city10-1_city10,1874900,3,13,11,24,0
3_2839184,noop_location_city4-1,2839184,3,1,1,2,0
3_4013645,drive-truck_truck4_city4-1_city4-2_city4,4013645,3,10,7,17,0
3_1256180,drive-truck_truck4_city4-2_city4-1_city4,1256180,3,10,7,17,0
3_4005501,noop_city_city9,4005501,3,1,1,2,0
3_5227117,drive-truck_truck9_city9-1_city9-2_city9,5227117,3,10,7,17,0
3_2469652,drive-truck_truck9_city9-2_city9-1_city9,2469652,3,10,7,17,0
3_5896302,noop_at_plane4_city2-2,5896302,3,116,156,272,0
3_5852660,fly-airplane_plane4_city2-2_city4-2,5852660,3,122,164,286,0
3_6049268,fly-airplane_plane4_city2-2_city7-2,6049268,3,122,164,286,0
3_5787124,fly-airplane_plane4_city2-2_city3-2,5787124,3,122,164,286,0
3_5983732,fly-airplane_plane4_city2-2_city6-2,5983732,3,122,164,286,0
3_6180340,fly-airplane_plane4_city2-2_city9-2,6180340,3,122,164,286,0
3_5918196,fly-airplane_plane4_city2-2_city5-2,5918196,3,122,164,286,0
3_5656052,fly-airplane_plane4_city2-2_city1-2,5656052,3,122,164,286,0
3_7968830,fly-airplane_plane4_city2-2_city10-2,7968830,3,122,164,286,0
3_6114804,fly-airplane_plane4_city2-2_city8-2,6114804,3,122,164,286,0
3_1743447,unload-airplane_package1_plane4_city2-2,1743447,3,137,204,341,0
3_3751878,unload-airplane_package3_plane4_city2-2,3751878,3,145,245,390,0
3_4756559,load-airplane_package1_plane4_city2-2,4756559,3,135,200,335,0
3_2133322,in_package4_plane4,2133322,3,19,27,46,0
3_962113,in_package5_plane4,962113,3,19,18,37,0
3_1307652,at_plane4_city9-2,1307652,3,30,26,56,0
3_1045508,at_plane4_city5-2,1045508,3,30,27,57,0
3_783364,at_plane4_city1-2,783364,3,29,27,56,0
3_1242116,at_plane4_city8-2,1242116,3,30,27,57,0
3_979972,at_plane4_city4-2,979972,3,30,27,57,0
3_1176580,at_plane4_city7-2,1176580,3,29,27,56,0
3_914436,at_plane4_city3-2,914436,3,30,27,57,0
3_712137,at_plane4_city10-2,712137,3,30,29,59,0
3_1111044,at_plane4_city6-2,1111044,3,30,27,57,0
3_7670415,noop_at_plane3_city10-2,7670415,3,119,196,315,0
3_4181684,fly-airplane_plane3_city10-2_city4-2,4181684,3,123,204,327,0
3_4378292,fly-airplane_plane3_city10-2_city7-2,4378292,3,123,204,327,0
3_4116148,fly-airplane_plane3_city10-2_city3-2,4116148,3,123,204,327,0
3_4312756,fly-airplane_plane3_city10-2_city6-2,4312756,3,123,204,327,0
3_4050612,fly-airplane_plane3_city10-2_city2-2,4050612,3,123,204,327,0
3_4509364,fly-airplane_plane3_city10-2_city9-2,4509364,3,123,204,327,0
3_4247220,fly-airplane_plane3_city10-2_city5-2,4247220,3,123,204,327,0
3_3985076,fly-airplane_plane3_city10-2_city1-2,3985076,3,123,204,327,0
3_4443828,fly-airplane_plane3_city10-2_city8-2,4443828,3,123,204,327,0
3_3812211,unload-airplane_package4_plane3_city10-2,3812211,3,137,245,382,0
3_5646948,in_package1_plane3,5646948,3,19,26,45,0
3_3304530,in_package3_plane3,3304530,3,19,35,54,0
3_962112,in_package5_plane3,962112,3,19,26,45,0
3_4642255,at_plane3_city2-2,4642255,3,29,35,64,0
3_5101007,at_plane3_city9-2,5101007,3,30,35,65,0
3_4838863,at_plane3_city5-2,4838863,3,30,35,65,0
3_4576719,at_plane3_city1-2,4576719,3,29,35,64,0
3_5035471,at_plane3_city8-2,5035471,3,30,35,65,0
3_4773327,at_plane3_city4-2,4773327,3,30,35,65,0
3_4969935,at_plane3_city7-2,4969935,3,30,36,66,0
3_4707791,at_plane3_city3-2,4707791,3,29,35,64,0
3_4904399,at_plane3_city6-2,4904399,3,30,35,65,0
3_2839185,noop_location_city4-2,2839185,3,1,1,2,0
3_3468683,unload-airplane_package3_plane2_city4-2,3468683,3,146,246,392,0
3_3882950,unload-airplane_package3_plane4_city4-2,3882950,3,146,246,392,0
3_4680032,unload-airplane_package4_plane3_city4-2,4680032,3,137,246,383,0
3_7198704,noop_in-city_city4-1_city4,7198704,3,1,1,2,0
3_6355054,noop_at_plane4_city9-2,6355054,3,119,157,276,0
3_1156223,fly-airplane_plane4_city9-2_city4-2,1156223,3,123,164,287,0
3_1352831,fly-airplane_plane4_city9-2_city7-2,1352831,3,123,164,287,0
3_1090687,fly-airplane_plane4_city9-2_city3-2,1090687,3,123,164,287,0
3_1287295,fly-airplane_plane4_city9-2_city6-2,1287295,3,123,164,287,0
3_1025151,fly-airplane_plane4_city9-2_city2-2,1025151,3,123,164,287,0
3_1221759,fly-airplane_plane4_city9-2_city5-2,1221759,3,123,164,287,0
3_959615,fly-airplane_plane4_city9-2_city1-2,959615,3,123,164,287,0
3_5827508,fly-airplane_plane4_city9-2_city10-2,5827508,3,123,164,287,0
3_1418367,fly-airplane_plane4_city9-2_city8-2,1418367,3,123,164,287,0
3_4210630,unload-airplane_package3_plane4_city9-2,4210630,3,146,246,392,0
3_5646949,in_package1_plane4,5646949,3,19,18,37,0
3_848900,at_plane4_city2-2,848900,3,29,18,47,0
3_1208877,noop_at_plane1_city1-2,1208877,3,109,156,265,0
3_5665861,fly-airplane_plane1_city1-2_city4-2,5665861,3,114,164,278,0
3_5862469,fly-airplane_plane1_city1-2_city7-2,5862469,3,114,164,278,0
3_5600325,fly-airplane_plane1_city1-2_city3-2,5600325,3,114,164,278,0
3_5796933,fly-airplane_plane1_city1-2_city6-2,5796933,3,114,164,278,0
3_5534789,fly-airplane_plane1_city1-2_city2-2,5534789,3,114,164,278,0
3_5993541,fly-airplane_plane1_city1-2_city9-2,5993541,3,114,164,278,0
3_5731397,fly-airplane_plane1_city1-2_city5-2,5731397,3,114,164,278,0
3_153171,fly-airplane_plane1_city1-2_city10-2,153171,3,114,164,278,0
3_5928005,fly-airplane_plane1_city1-2_city8-2,5928005,3,114,164,278,0
3_1072884,unload-airplane_package5_plane1_city1-2,1072884,3,128,206,334,0
3_4085996,load-airplane_package5_plane1_city1-2,4085996,3,128,200,328,0
3_5646946,in_package1_plane1,5646946,3,19,19,38,0
3_3304528,in_package3_plane1,3304528,3,19,28,47,0
3_2133319,in_package4_plane1,2133319,3,19,28,47,0
3_4621204,at_plane1_city8-2,4621204,3,31,26,57,0
3_4359060,at_plane1_city4-2,4359060,3,31,27,58,0
3_4555668,at_plane1_city7-2,4555668,3,30,27,57,0
3_4293524,at_plane1_city3-2,4293524,3,30,27,57,0
3_4490132,at_plane1_city6-2,4490132,3,31,27,58,0
3_4227988,at_plane1_city2-2,4227988,3,30,27,57,0
3_4686740,at_plane1_city9-2,4686740,3,31,27,58,0
3_4424596,at_plane1_city5-2,4424596,3,31,27,58,0
3_1653149,at_plane1_city10-2,1653149,3,31,29,60,0
3_3507679,noop_at_truck9_city9-1,3507679,3,4,6,10,0
3_6461255,at_truck9_city9-2,6461255,3,3,8,11,0
3_1627007,noop_airport_city4-2,1627007,3,1,1,2,0
3_4992707,fly-airplane_plane1_city4-2_city7-2,4992707,3,115,164,279,0
3_4730563,fly-airplane_plane1_city4-2_city3-2,4730563,3,115,164,279,0
3_4927171,fly-airplane_plane1_city4-2_city6-2,4927171,3,115,164,279,0
3_4665027,fly-airplane_plane1_city4-2_city2-2,4665027,3,115,164,279,0
3_5123779,fly-airplane_plane1_city4-2_city9-2,5123779,3,115,164,279,0
3_4861635,fly-airplane_plane1_city4-2_city5-2,4861635,3,115,164,279,0
3_4599491,fly-airplane_plane1_city4-2_city1-2,4599491,3,115,164,279,0
3_1521455,fly-airplane_plane1_city4-2_city10-2,1521455,3,115,164,279,0
3_5058243,fly-airplane_plane1_city4-2_city8-2,5058243,3,115,164,279,0
3_3926337,fly-airplane_plane1_city7-2_city4-2,3926337,3,114,164,278,0
3_7753012,fly-airplane_plane1_city3-2_city4-2,7753012,3,114,164,278,0
3_6883250,fly-airplane_plane1_city6-2_city4-2,6883250,3,115,164,279,0
3_2708948,fly-airplane_plane1_city2-2_city4-2,2708948,3,114,164,278,0
3_6013488,fly-airplane_plane1_city9-2_city4-2,6013488,3,115,164,279,0
3_1839186,fly-airplane_plane1_city5-2_city4-2,1839186,3,115,164,279,0
3_3720295,fly-airplane_plane1_city10-2_city4-2,3720295,3,115,164,279,0
3_969424,fly-airplane_plane1_city8-2_city4-2,969424,3,115,164,279,0
3_6040611,fly-airplane_plane2_city4-2_city7-2,6040611,3,123,164,287,0
3_5778467,fly-airplane_plane2_city4-2_city3-2,5778467,3,123,164,287,0
3_5975075,fly-airplane_plane2_city4-2_city6-2,5975075,3,123,164,287,0
3_5712931,fly-airplane_plane2_city4-2_city2-2,5712931,3,123,164,287,0
3_6171683,fly-airplane_plane2_city4-2_city9-2,6171683,3,123,164,287,0
3_5909539,fly-airplane_plane2_city4-2_city5-2,5909539,3,123,164,287,0
3_5647395,fly-airplane_plane2_city4-2_city1-2,5647395,3,123,164,287,0
3_5752638,fly-airplane_plane2_city4-2_city10-2,5752638,3,123,164,287,0
3_6106147,fly-airplane_plane2_city4-2_city8-2,6106147,3,123,164,287,0
3_4974241,fly-airplane_plane2_city7-2_city4-2,4974241,3,122,164,286,0
3_799939,fly-airplane_plane2_city3-2_city4-2,799939,3,123,164,287,0
3_7931154,fly-airplane_plane2_city6-2_city4-2,7931154,3,123,164,287,0
3_3756852,fly-airplane_plane2_city2-2_city4-2,3756852,3,122,164,286,0
3_7061392,fly-airplane_plane2_city9-2_city4-2,7061392,3,123,164,287,0
3_2887090,fly-airplane_plane2_city5-2_city4-2,2887090,3,123,164,287,0
3_6713765,fly-airplane_plane2_city1-2_city4-2,6713765,3,122,164,286,0
3_7951478,fly-airplane_plane2_city10-2_city4-2,7951478,3,123,164,287,0
3_2017328,fly-airplane_plane2_city8-2_city4-2,2017328,3,123,164,287,0
3_7088515,fly-airplane_plane3_city4-2_city7-2,7088515,3,123,204,327,0
3_6826371,fly-airplane_plane3_city4-2_city3-2,6826371,3,123,204,327,0
3_7022979,fly-airplane_plane3_city4-2_city6-2,7022979,3,123,204,327,0
3_6760835,fly-airplane_plane3_city4-2_city2-2,6760835,3,123,204,327,0
3_7219587,fly-airplane_plane3_city4-2_city9-2,7219587,3,123,204,327,0
3_6957443,fly-airplane_plane3_city4-2_city5-2,6957443,3,123,204,327,0
3_6695299,fly-airplane_plane3_city4-2_city1-2,6695299,3,123,204,327,0
3_1982844,fly-airplane_plane3_city4-2_city10-2,1982844,3,123,204,327,0
3_7154051,fly-airplane_plane3_city4-2_city8-2,7154051,3,123,204,327,0
3_6022145,fly-airplane_plane3_city7-2_city4-2,6022145,3,123,209,332,0
3_1847843,fly-airplane_plane3_city3-2_city4-2,1847843,3,122,204,326,0
3_978081,fly-airplane_plane3_city6-2_city4-2,978081,3,123,204,327,0
3_4804756,fly-airplane_plane3_city2-2_city4-2,4804756,3,122,204,326,0
3_108319,fly-airplane_plane3_city9-2_city4-2,108319,3,123,204,327,0
3_3934994,fly-airplane_plane3_city5-2_city4-2,3934994,3,123,204,327,0
3_7761669,fly-airplane_plane3_city1-2_city4-2,7761669,3,122,204,326,0
3_3065232,fly-airplane_plane3_city8-2_city4-2,3065232,3,123,204,327,0
3_135442,fly-airplane_plane4_city4-2_city7-2,135442,3,123,164,287,0
3_7874275,fly-airplane_plane4_city4-2_city3-2,7874275,3,123,164,287,0
3_69906,fly-airplane_plane4_city4-2_city6-2,69906,3,123,164,287,0
3_7808739,fly-airplane_plane4_city4-2_city2-2,7808739,3,123,164,287,0
3_266514,fly-airplane_plane4_city4-2_city9-2,266514,3,123,164,287,0
3_4370,fly-airplane_plane4_city4-2_city5-2,4370,3,123,164,287,0
3_7743203,fly-airplane_plane4_city4-2_city1-2,7743203,3,123,164,287,0
3_6214027,fly-airplane_plane4_city4-2_city10-2,6214027,3,123,164,287,0
3_200978,fly-airplane_plane4_city4-2_city8-2,200978,3,123,164,287,0
3_7070049,fly-airplane_plane4_city7-2_city4-2,7070049,3,122,164,286,0
3_2895747,fly-airplane_plane4_city3-2_city4-2,2895747,3,123,164,287,0
3_2025985,fly-airplane_plane4_city6-2_city4-2,2025985,3,123,164,287,0
3_4982898,fly-airplane_plane4_city5-2_city4-2,4982898,3,123,164,287,0
3_808596,fly-airplane_plane4_city1-2_city4-2,808596,3,122,164,286,0
3_411890,fly-airplane_plane4_city10-2_city4-2,411890,3,123,164,287,0
3_4113136,fly-airplane_plane4_city8-2_city4-2,4113136,3,123,164,287,0
3_1667629,noop_at_plane1_city8-2,1667629,3,112,157,269,0
3_1166032,fly-airplane_plane1_city8-2_city7-2,1166032,3,115,164,279,0
3_903888,fly-airplane_plane1_city8-2_city3-2,903888,3,115,164,279,0
3_1100496,fly-airplane_plane1_city8-2_city6-2,1100496,3,115,164,279,0
3_838352,fly-airplane_plane1_city8-2_city2-2,838352,3,115,164,279,0
3_1297104,fly-airplane_plane1_city8-2_city9-2,1297104,3,115,164,279,0
3_1034960,fly-airplane_plane1_city8-2_city5-2,1034960,3,115,164,279,0
3_772816,fly-airplane_plane1_city8-2_city1-2,772816,3,115,164,279,0
3_6012826,fly-airplane_plane1_city8-2_city10-2,6012826,3,115,164,279,0
3_962110,in_package5_plane1,962110,3,19,18,37,0
3_4162452,at_plane1_city1-2,4162452,3,30,18,48,0
3_1731339,noop_at_package5_city1-2,1731339,3,16,53,69,0
3_292641,load-airplane_package5_plane2_city1-2,292641,3,135,200,335,0
3_4500263,load-airplane_package5_plane3_city1-2,4500263,3,135,240,375,0
3_706908,load-airplane_package5_plane4_city1-2,706908,3,135,200,335,0
3_4934766,load-truck_package5_truck1_city1-2,4934766,3,23,57,80,0
3_3868823,in_package5_truck1,3868823,3,8,8,16,0
3_962111,in_package5_plane2,962111,3,19,18,37,0
3_3507680,noop_at_truck9_city9-2,3507680,3,4,4,8,0
3_6461254,at_truck9_city9-1,6461254,3,3,2,5,0
3_1688680,noop_at_plane3_city2-2,1688680,3,116,196,312,0
3_5001364,fly-airplane_plane3_city2-2_city7-2,5001364,3,122,204,326,0
3_4739220,fly-airplane_plane3_city2-2_city3-2,4739220,3,122,204,326,0
3_4935828,fly-airplane_plane3_city2-2_city6-2,4935828,3,122,204,326,0
3_5132436,fly-airplane_plane3_city2-2_city9-2,5132436,3,122,204,326,0
3_4870292,fly-airplane_plane3_city2-2_city5-2,4870292,3,122,204,326,0
3_4608148,fly-airplane_plane3_city2-2_city1-2,4608148,3,122,204,326,0
3_3737647,fly-airplane_plane3_city2-2_city10-2,3737647,3,122,204,326,0
3_5066900,fly-airplane_plane3_city2-2_city8-2,5066900,3,122,204,326,0
3_5536802,unload-airplane_package1_plane3_city2-2,5536802,3,137,244,381,0
3_4548960,unload-airplane_package4_plane3_city2-2,4548960,3,136,245,381,0
3_548937,load-airplane_package1_plane3_city2-2,548937,3,135,240,375,0
3_3692800,at_plane3_city10-2,3692800,3,30,20,50,0
3_5613107,noop_at_plane2_city4-2,5613107,3,119,157,276,0
3_5646947,in_package1_plane2,5646947,3,19,18,37,0
3_2133320,in_package4_plane2,2133320,3,19,27,46,0
3_762313,at_plane2_city7-2,762313,3,29,26,55,0
3_6673463,at_plane2_city10-2,6673463,3,30,29,59,0
3_500169,at_plane2_city3-2,500169,3,30,27,57,0
3_696777,at_plane2_city6-2,696777,3,30,27,57,0
3_434633,at_plane2_city2-2,434633,3,29,27,56,0
3_893385,at_plane2_city9-2,893385,3,30,27,57,0
3_631241,at_plane2_city5-2,631241,3,30,27,57,0
3_369097,at_plane2_city1-2,369097,3,29,27,56,0
3_827849,at_plane2_city8-2,827849,3,30,27,57,0
3_2991081,noop_in-city_city3-1_city3,2991081,3,1,1,2,0
3_5371146,drive-truck_truck3_city3-1_city3-2_city3,5371146,3,13,9,22,0
3_2613681,drive-truck_truck3_city3-2_city3-1_city3,2613681,3,12,9,21,0
3_968341,noop_at_package1_city2-2,968341,3,16,53,69,0
3_134670,load-airplane_package1_plane1_city2-2,134670,3,128,200,328,0
3_4342292,load-airplane_package1_plane2_city2-2,4342292,3,135,200,335,0
3_5191062,load-truck_package1_truck2_city2-2,5191062,3,23,57,80,0
3_552683,in_package1_truck2,552683,3,8,7,15,0
3_6690159,noop_at_truck6_city6-1,6690159,3,4,6,10,0
3_1298643,drive-truck_truck6_city6-1_city6-2_city6,1298643,3,10,7,17,0
3_1642758,at_truck6_city6-2,1642758,3,3,8,11,0
3_2147432,noop_at_plane3_city9-2,2147432,3,119,197,316,0
3_304927,fly-airplane_plane3_city9-2_city7-2,304927,3,123,204,327,0
3_42783,fly-airplane_plane3_city9-2_city3-2,42783,3,123,204,327,0
3_239391,fly-airplane_plane3_city9-2_city6-2,239391,3,123,204,327,0
3_7978224,fly-airplane_plane3_city9-2_city2-2,7978224,3,123,204,327,0
3_173855,fly-airplane_plane3_city9-2_city5-2,173855,3,123,204,327,0
3_7912688,fly-airplane_plane3_city9-2_city1-2,7912688,3,123,204,327,0
3_1596325,fly-airplane_plane3_city9-2_city10-2,1596325,3,123,204,327,0
3_370463,fly-airplane_plane3_city9-2_city8-2,370463,3,123,204,327,0
3_5007712,unload-airplane_package4_plane3_city9-2,5007712,3,137,246,383,0
3_3035792,noop_location_city7-1,3035792,3,1,1,2,0
3_7942119,drive-truck_truck7_city7-1_city7-2_city7,7942119,3,13,9,22,0
3_5184654,drive-truck_truck7_city7-2_city7-1_city7,5184654,3,12,9,21,0
3_6690160,noop_at_truck6_city6-2,6690160,3,4,4,8,0
3_6542155,drive-truck_truck6_city6-2_city6-1_city6,6542155,3,10,7,17,0
3_1642757,at_truck6_city6-1,1642757,3,3,2,5,0
3_6092910,noop_at_plane4_city5-2,6092910,3,119,157,276,0
3_5179506,fly-airplane_plane4_city5-2_city7-2,5179506,3,123,164,287,0
3_4917362,fly-airplane_plane4_city5-2_city3-2,4917362,3,123,164,287,0
3_5113970,fly-airplane_plane4_city5-2_city6-2,5113970,3,123,164,287,0
3_4851826,fly-airplane_plane4_city5-2_city2-2,4851826,3,123,164,287,0
3_5310578,fly-airplane_plane4_city5-2_city9-2,5310578,3,123,164,287,0
3_4786290,fly-airplane_plane4_city5-2_city1-2,4786290,3,123,164,287,0
3_1336137,fly-airplane_plane4_city5-2_city10-2,1336137,3,123,164,287,0
3_5245042,fly-airplane_plane4_city5-2_city8-2,5245042,3,123,164,287,0
3_3948486,unload-airplane_package3_plane4_city5-2,3948486,3,146,246,392,0
3_3035793,noop_location_city7-2,3035793,3,1,1,2,0
3_3665291,unload-airplane_package3_plane2_city7-2,3665291,3,145,246,391,0
3_4079558,unload-airplane_package3_plane4_city7-2,4079558,3,145,246,391,0
3_4462373,unload-airplane_package4_plane1_city7-2,4462373,3,137,252,389,0
3_669018,unload-airplane_package4_plane2_city7-2,669018,3,146,250,396,0
3_4876640,unload-airplane_package4_plane3_city7-2,4876640,3,137,246,383,0
3_1083285,unload-airplane_package4_plane4_city7-2,1083285,3,146,250,396,0
3_808231,unload-truck_package4_truck7_city7-2,808231,3,32,111,143,0
3_7475485,load-airplane_package4_plane1_city7-2,7475485,3,137,246,383,0
3_3682130,load-airplane_package4_plane2_city7-2,3682130,3,144,246,390,0
3_7889752,load-airplane_package4_plane3_city7-2,7889752,3,137,246,383,0
3_4096397,load-airplane_package4_plane4_city7-2,4096397,3,144,246,390,0
3_1566079,load-truck_package4_truck7_city7-2,1566079,3,32,111,143,0
3_4939725,noop_in_package5_plane1,4939725,3,115,86,201,0
3_7586955,at_package5_city1-2,7586955,3,15,7,22,0
3_1448144,noop_at_package3_city3-2,1448144,3,34,107,141,0
3_2208637,load-airplane_package3_plane1_city3-2,2208637,3,146,246,392,0
3_6416259,load-airplane_package3_plane2_city3-2,6416259,3,146,246,392,0
3_2622904,load-airplane_package3_plane3_city3-2,2622904,3,153,286,439,0
3_6830526,load-airplane_package3_plane4_city3-2,6830526,3,146,246,392,0
3_3471674,load-truck_package3_truck3_city3-2,3471674,3,41,111,152,0
3_6211243,in_package3_truck3,6211243,3,8,17,25,0
3_3304529,in_package3_plane2,3304529,3,19,25,44,0
3_3304531,in_package3_plane4,3304531,3,19,25,44,0
3_767485,noop_in-city_city3-2_city3,767485,3,1,1,2,0
3_5018863,noop_airplane_plane1,5018863,3,1,1,2,0
3_3860801,fly-airplane_plane1_city7-2_city3-2,3860801,3,114,164,278,0
3_4057409,fly-airplane_plane1_city7-2_city6-2,4057409,3,114,164,278,0
3_3795265,fly-airplane_plane1_city7-2_city2-2,3795265,3,114,164,278,0
3_4254017,fly-airplane_plane1_city7-2_city9-2,4254017,3,114,164,278,0
3_3991873,fly-airplane_plane1_city7-2_city5-2,3991873,3,114,164,278,0
3_3729729,fly-airplane_plane1_city7-2_city1-2,3729729,3,114,164,278,0
3_2889739,fly-airplane_plane1_city7-2_city10-2,2889739,3,114,164,278,0
3_4188481,fly-airplane_plane1_city7-2_city8-2,4188481,3,114,164,278,0
3_7949620,fly-airplane_plane1_city3-2_city7-2,7949620,3,114,164,278,0
3_7884084,fly-airplane_plane1_city3-2_city6-2,7884084,3,114,164,278,0
3_7621940,fly-airplane_plane1_city3-2_city2-2,7621940,3,114,164,278,0
3_79715,fly-airplane_plane1_city3-2_city9-2,79715,3,114,164,278,0
3_7818548,fly-airplane_plane1_city3-2_city5-2,7818548,3,114,164,278,0
3_7556404,fly-airplane_plane1_city3-2_city1-2,7556404,3,114,164,278,0
3_6399345,fly-airplane_plane1_city3-2_city10-2,6399345,3,114,164,278,0
3_14179,fly-airplane_plane1_city3-2_city8-2,14179,3,114,164,278,0
3_7079858,fly-airplane_plane1_city6-2_city7-2,7079858,3,115,164,279,0
3_6817714,fly-airplane_plane1_city6-2_city3-2,6817714,3,115,164,279,0
3_6752178,fly-airplane_plane1_city6-2_city2-2,6752178,3,115,164,279,0
3_7210930,fly-airplane_plane1_city6-2_city9-2,7210930,3,115,164,279,0
3_6948786,fly-airplane_plane1_city6-2_city5-2,6948786,3,115,164,279,0
3_6686642,fly-airplane_plane1_city6-2_city1-2,6686642,3,115,164,279,0
3_7767629,fly-airplane_plane1_city6-2_city10-2,7767629,3,115,164,279,0
3_7145394,fly-airplane_plane1_city6-2_city8-2,7145394,3,115,164,279,0
3_2905556,fly-airplane_plane1_city2-2_city7-2,2905556,3,114,164,278,0
3_2643412,fly-airplane_plane1_city2-2_city3-2,2643412,3,114,164,278,0
3_2840020,fly-airplane_plane1_city2-2_city6-2,2840020,3,114,164,278,0
3_3036628,fly-airplane_plane1_city2-2_city9-2,3036628,3,114,164,278,0
3_2774484,fly-airplane_plane1_city2-2_city5-2,2774484,3,114,164,278,0
3_2512340,fly-airplane_plane1_city2-2_city1-2,2512340,3,114,164,278,0
3_3276258,fly-airplane_plane1_city2-2_city10-2,3276258,3,114,164,278,0
3_2971092,fly-airplane_plane1_city2-2_city8-2,2971092,3,114,164,278,0
3_6210096,fly-airplane_plane1_city9-2_city7-2,6210096,3,115,164,279,0
3_5947952,fly-airplane_plane1_city9-2_city3-2,5947952,3,115,164,279,0
3_6144560,fly-airplane_plane1_city9-2_city6-2,6144560,3,115,164,279,0
3_5882416,fly-airplane_plane1_city9-2_city2-2,5882416,3,115,164,279,0
3_6079024,fly-airplane_plane1_city9-2_city5-2,6079024,3,115,164,279,0
3_5816880,fly-airplane_plane1_city9-2_city1-2,5816880,3,115,164,279,0
3_1134936,fly-airplane_plane1_city9-2_city10-2,1134936,3,115,164,279,0
3_6275632,fly-airplane_plane1_city9-2_city8-2,6275632,3,115,164,279,0
3_2035794,fly-airplane_plane1_city5-2_city7-2,2035794,3,115,164,279,0
3_1773650,fly-airplane_plane1_city5-2_city3-2,1773650,3,115,164,279,0
3_1970258,fly-airplane_plane1_city5-2_city6-2,1970258,3,115,164,279,0
3_1708114,fly-airplane_plane1_city5-2_city2-2,1708114,3,115,164,279,0
3_2166866,fly-airplane_plane1_city5-2_city9-2,2166866,3,115,164,279,0
3_1642578,fly-airplane_plane1_city5-2_city1-2,1642578,3,115,164,279,0
3_4644542,fly-airplane_plane1_city5-2_city10-2,4644542,3,115,164,279,0
3_2101330,fly-airplane_plane1_city5-2_city8-2,2101330,3,115,164,279,0
3_3916903,fly-airplane_plane1_city10-2_city7-2,3916903,3,115,164,279,0
3_3654759,fly-airplane_plane1_city10-2_city3-2,3654759,3,115,164,279,0
3_3851367,fly-airplane_plane1_city10-2_city6-2,3851367,3,115,164,279,0
3_3589223,fly-airplane_plane1_city10-2_city2-2,3589223,3,115,164,279,0
3_4047975,fly-airplane_plane1_city10-2_city9-2,4047975,3,115,164,279,0
3_3785831,fly-airplane_plane1_city10-2_city5-2,3785831,3,115,164,279,0
3_3523687,fly-airplane_plane1_city10-2_city1-2,3523687,3,115,164,279,0
3_3982439,fly-airplane_plane1_city10-2_city8-2,3982439,3,115,164,279,0
3_5122535,unload-airplane_package1_plane1_city2-2,5122535,3,128,206,334,0
3_7196502,unload-airplane_package3_plane1_city3-2,7196502,3,146,252,398,0
3_1405485,noop_at_plane1_city4-2,1405485,3,112,157,269,0
3_4939726,noop_in_package5_plane2,4939726,3,124,75,199,0
3_5280506,unload-airplane_package5_plane2_city1-2,5280506,3,137,204,341,0
3_565705,at_plane2_city4-2,565705,3,30,18,48,0
3_5018864,noop_airplane_plane2,5018864,3,1,1,2,0
3_4908705,fly-airplane_plane2_city7-2_city3-2,4908705,3,122,164,286,0
3_5105313,fly-airplane_plane2_city7-2_city6-2,5105313,3,122,164,286,0
3_4843169,fly-airplane_plane2_city7-2_city2-2,4843169,3,122,164,286,0
3_5301921,fly-airplane_plane2_city7-2_city9-2,5301921,3,122,164,286,0
3_5039777,fly-airplane_plane2_city7-2_city5-2,5039777,3,122,164,286,0
3_4777633,fly-airplane_plane2_city7-2_city1-2,4777633,3,122,164,286,0
3_7120922,fly-airplane_plane2_city7-2_city10-2,7120922,3,122,164,286,0
3_5236385,fly-airplane_plane2_city7-2_city8-2,5236385,3,122,164,286,0
3_996547,fly-airplane_plane2_city3-2_city7-2,996547,3,123,164,287,0
3_931011,fly-airplane_plane2_city3-2_city6-2,931011,3,123,164,287,0
3_668867,fly-airplane_plane2_city3-2_city2-2,668867,3,123,164,287,0
3_1127619,fly-airplane_plane2_city3-2_city9-2,1127619,3,123,164,287,0
3_865475,fly-airplane_plane2_city3-2_city5-2,865475,3,123,164,287,0
3_603331,fly-airplane_plane2_city3-2_city1-2,603331,3,123,164,287,0
3_2629551,fly-airplane_plane2_city3-2_city10-2,2629551,3,123,164,287,0
3_1062083,fly-airplane_plane2_city3-2_city8-2,1062083,3,123,164,287,0
3_126785,fly-airplane_plane2_city6-2_city7-2,126785,3,123,164,287,0
3_7865618,fly-airplane_plane2_city6-2_city3-2,7865618,3,123,164,287,0
3_7800082,fly-airplane_plane2_city6-2_city2-2,7800082,3,123,164,287,0
3_257857,fly-airplane_plane2_city6-2_city9-2,257857,3,123,164,287,0
3_7996690,fly-airplane_plane2_city6-2_city5-2,7996690,3,123,164,287,0
3_7734546,fly-airplane_plane2_city6-2_city1-2,7734546,3,123,164,287,0
3_3997835,fly-airplane_plane2_city6-2_city10-2,3997835,3,123,164,287,0
3_192321,fly-airplane_plane2_city6-2_city8-2,192321,3,123,164,287,0
3_3953460,fly-airplane_plane2_city2-2_city7-2,3953460,3,122,164,286,0
3_3691316,fly-airplane_plane2_city2-2_city3-2,3691316,3,122,164,286,0
3_3887924,fly-airplane_plane2_city2-2_city6-2,3887924,3,122,164,286,0
3_4084532,fly-airplane_plane2_city2-2_city9-2,4084532,3,122,164,286,0
3_3822388,fly-airplane_plane2_city2-2_city5-2,3822388,3,122,164,286,0
3_3560244,fly-airplane_plane2_city2-2_city1-2,3560244,3,122,164,286,0
3_7507441,fly-airplane_plane2_city2-2_city10-2,7507441,3,122,164,286,0
3_4018996,fly-airplane_plane2_city2-2_city8-2,4018996,3,122,164,286,0
3_7258000,fly-airplane_plane2_city9-2_city7-2,7258000,3,123,164,287,0
3_6995856,fly-airplane_plane2_city9-2_city3-2,6995856,3,123,164,287,0
3_7192464,fly-airplane_plane2_city9-2_city6-2,7192464,3,123,164,287,0
3_6930320,fly-airplane_plane2_city9-2_city2-2,6930320,3,123,164,287,0
3_7126928,fly-airplane_plane2_city9-2_city5-2,7126928,3,123,164,287,0
3_6864784,fly-airplane_plane2_city9-2_city1-2,6864784,3,123,164,287,0
3_5366119,fly-airplane_plane2_city9-2_city10-2,5366119,3,123,164,287,0
3_7323536,fly-airplane_plane2_city9-2_city8-2,7323536,3,123,164,287,0
3_3083698,fly-airplane_plane2_city5-2_city7-2,3083698,3,123,164,287,0
3_2821554,fly-airplane_plane2_city5-2_city3-2,2821554,3,123,164,287,0
3_3018162,fly-airplane_plane2_city5-2_city6-2,3018162,3,123,164,287,0
3_2756018,fly-airplane_plane2_city5-2_city2-2,2756018,3,123,164,287,0
3_3214770,fly-airplane_plane2_city5-2_city9-2,3214770,3,123,164,287,0
3_2690482,fly-airplane_plane2_city5-2_city1-2,2690482,3,123,164,287,0
3_874748,fly-airplane_plane2_city5-2_city10-2,874748,3,123,164,287,0
3_3149234,fly-airplane_plane2_city5-2_city8-2,3149234,3,123,164,287,0
3_6910373,fly-airplane_plane2_city1-2_city7-2,6910373,3,122,164,286,0
3_6648229,fly-airplane_plane2_city1-2_city3-2,6648229,3,122,164,286,0
3_6844837,fly-airplane_plane2_city1-2_city6-2,6844837,3,122,164,286,0
3_6582693,fly-airplane_plane2_city1-2_city2-2,6582693,3,122,164,286,0
3_7041445,fly-airplane_plane2_city1-2_city9-2,7041445,3,122,164,286,0
3_6779301,fly-airplane_plane2_city1-2_city5-2,6779301,3,122,164,286,0
3_4384354,fly-airplane_plane2_city1-2_city10-2,4384354,3,122,164,286,0
3_6975909,fly-airplane_plane2_city1-2_city8-2,6975909,3,122,164,286,0
3_147109,fly-airplane_plane2_city10-2_city7-2,147109,3,123,164,287,0
3_7885942,fly-airplane_plane2_city10-2_city3-2,7885942,3,123,164,287,0
3_81573,fly-airplane_plane2_city10-2_city6-2,81573,3,123,164,287,0
3_7820406,fly-airplane_plane2_city10-2_city2-2,7820406,3,123,164,287,0
3_278181,fly-airplane_plane2_city10-2_city9-2,278181,3,123,164,287,0
3_16037,fly-airplane_plane2_city10-2_city5-2,16037,3,123,164,287,0
3_7754870,fly-airplane_plane2_city10-2_city1-2,7754870,3,123,164,287,0
3_212645,fly-airplane_plane2_city10-2_city8-2,212645,3,123,164,287,0
3_2213936,fly-airplane_plane2_city8-2_city7-2,2213936,3,123,164,287,0
3_1951792,fly-airplane_plane2_city8-2_city3-2,1951792,3,123,164,287,0
3_2148400,fly-airplane_plane2_city8-2_city6-2,2148400,3,123,164,287,0
3_1886256,fly-airplane_plane2_city8-2_city2-2,1886256,3,123,164,287,0
3_2345008,fly-airplane_plane2_city8-2_city9-2,2345008,3,123,164,287,0
3_2082864,fly-airplane_plane2_city8-2_city5-2,2082864,3,123,164,287,0
3_1820720,fly-airplane_plane2_city8-2_city1-2,1820720,3,123,164,287,0
3_2243032,fly-airplane_plane2_city8-2_city10-2,2243032,3,123,164,287,0
3_1329180,unload-airplane_package1_plane2_city2-2,1329180,3,137,204,341,0
3_3403147,unload-airplane_package3_plane2_city3-2,3403147,3,146,246,392,0
3_3599755,unload-airplane_package3_plane2_city6-2,3599755,3,146,246,392,0
3_3337611,unload-airplane_package3_plane2_city2-2,3337611,3,145,245,390,0
3_3796363,unload-airplane_package3_plane2_city9-2,3796363,3,146,246,392,0
3_3534219,unload-airplane_package3_plane2_city5-2,3534219,3,146,246,392,0
3_3272075,unload-airplane_package3_plane2_city1-2,3272075,3,145,245,390,0
3_3730827,unload-airplane_package3_plane2_city8-2,3730827,3,146,246,392,0
3_5744970,unload-airplane_package3_plane2_city10-2,5744970,3,146,245,391,0
3_1281200,noop_city_city10,1281200,3,1,1,2,0
3_4939727,noop_in_package5_plane3,4939727,3,124,123,247,0
3_1487151,unload-airplane_package5_plane3_city1-2,1487151,3,137,244,381,0
3_2133321,in_package4_plane3,2133321,3,19,25,44,0
3_1823615,noop_airport_city7-2,1823615,3,1,1,2,0
3_5956609,fly-airplane_plane3_city7-2_city3-2,5956609,3,123,209,332,0
3_6153217,fly-airplane_plane3_city7-2_city6-2,6153217,3,123,209,332,0
3_5891073,fly-airplane_plane3_city7-2_city2-2,5891073,3,123,209,332,0
3_6349825,fly-airplane_plane3_city7-2_city9-2,6349825,3,123,209,332,0
3_6087681,fly-airplane_plane3_city7-2_city5-2,6087681,3,123,209,332,0
3_5825537,fly-airplane_plane3_city7-2_city1-2,5825537,3,123,209,332,0
3_3351128,fly-airplane_plane3_city7-2_city10-2,3351128,3,123,209,332,0
3_6284289,fly-airplane_plane3_city7-2_city8-2,6284289,3,123,209,332,0
3_2044451,fly-airplane_plane3_city3-2_city7-2,2044451,3,122,204,326,0
3_1174689,fly-airplane_plane3_city6-2_city7-2,1174689,3,123,204,327,0
3_4131602,fly-airplane_plane3_city5-2_city7-2,4131602,3,123,204,327,0
3_7958277,fly-airplane_plane3_city1-2_city7-2,7958277,3,122,204,326,0
3_3261840,fly-airplane_plane3_city8-2_city7-2,3261840,3,123,204,327,0
3_7004513,fly-airplane_plane4_city7-2_city3-2,7004513,3,122,164,286,0
3_7201121,fly-airplane_plane4_city7-2_city6-2,7201121,3,122,164,286,0
3_6938977,fly-airplane_plane4_city7-2_city2-2,6938977,3,122,164,286,0
3_7397729,fly-airplane_plane4_city7-2_city9-2,7397729,3,122,164,286,0
3_7135585,fly-airplane_plane4_city7-2_city5-2,7135585,3,122,164,286,0
3_6873441,fly-airplane_plane4_city7-2_city1-2,6873441,3,122,164,286,0
3_7582311,fly-airplane_plane4_city7-2_city10-2,7582311,3,122,164,286,0
3_7332193,fly-airplane_plane4_city7-2_city8-2,7332193,3,122,164,286,0
3_3092355,fly-airplane_plane4_city3-2_city7-2,3092355,3,123,164,287,0
3_2222593,fly-airplane_plane4_city6-2_city7-2,2222593,3,123,164,287,0
3_1005204,fly-airplane_plane4_city1-2_city7-2,1005204,3,122,164,286,0
3_608498,fly-airplane_plane4_city10-2_city7-2,608498,3,123,164,287,0
3_4309744,fly-airplane_plane4_city8-2_city7-2,4309744,3,123,164,287,0
3_5018865,noop_airplane_plane3,5018865,3,1,1,2,0
3_1978915,fly-airplane_plane3_city3-2_city6-2,1978915,3,122,204,326,0
3_1716771,fly-airplane_plane3_city3-2_city2-2,1716771,3,122,204,326,0
3_2175523,fly-airplane_plane3_city3-2_city9-2,2175523,3,122,204,326,0
3_1913379,fly-airplane_plane3_city3-2_city5-2,1913379,3,122,204,326,0
3_1651235,fly-airplane_plane3_city3-2_city1-2,1651235,3,122,204,326,0
3_6860734,fly-airplane_plane3_city3-2_city10-2,6860734,3,122,204,326,0
3_2109987,fly-airplane_plane3_city3-2_city8-2,2109987,3,122,204,326,0
3_912545,fly-airplane_plane3_city6-2_city3-2,912545,3,123,204,327,0
3_847009,fly-airplane_plane3_city6-2_city2-2,847009,3,123,204,327,0
3_1305761,fly-airplane_plane3_city6-2_city9-2,1305761,3,123,204,327,0
3_1043617,fly-airplane_plane3_city6-2_city5-2,1043617,3,123,204,327,0
3_781473,fly-airplane_plane3_city6-2_city1-2,781473,3,123,204,327,0
3_228041,fly-airplane_plane3_city6-2_city10-2,228041,3,123,204,327,0
3_1240225,fly-airplane_plane3_city6-2_city8-2,1240225,3,123,204,327,0
3_3869458,fly-airplane_plane3_city5-2_city3-2,3869458,3,123,204,327,0
3_4066066,fly-airplane_plane3_city5-2_city6-2,4066066,3,123,204,327,0
3_3803922,fly-airplane_plane3_city5-2_city2-2,3803922,3,123,204,327,0
3_4262674,fly-airplane_plane3_city5-2_city9-2,4262674,3,123,204,327,0
3_3738386,fly-airplane_plane3_city5-2_city1-2,3738386,3,123,204,327,0
3_5105931,fly-airplane_plane3_city5-2_city10-2,5105931,3,123,204,327,0
3_4197138,fly-airplane_plane3_city5-2_city8-2,4197138,3,123,204,327,0
3_7696133,fly-airplane_plane3_city1-2_city3-2,7696133,3,122,204,326,0
3_7892741,fly-airplane_plane3_city1-2_city6-2,7892741,3,122,204,326,0
3_7630597,fly-airplane_plane3_city1-2_city2-2,7630597,3,122,204,326,0
3_88372,fly-airplane_plane3_city1-2_city9-2,88372,3,122,204,326,0
3_7827205,fly-airplane_plane3_city1-2_city5-2,7827205,3,122,204,326,0
3_614560,fly-airplane_plane3_city1-2_city10-2,614560,3,122,204,326,0
3_22836,fly-airplane_plane3_city1-2_city8-2,22836,3,122,204,326,0
3_2999696,fly-airplane_plane3_city8-2_city3-2,2999696,3,123,204,327,0
3_3196304,fly-airplane_plane3_city8-2_city6-2,3196304,3,123,204,327,0
3_2934160,fly-airplane_plane3_city8-2_city2-2,2934160,3,123,204,327,0
3_3392912,fly-airplane_plane3_city8-2_city9-2,3392912,3,123,204,327,0
3_3130768,fly-airplane_plane3_city8-2_city5-2,3130768,3,123,204,327,0
3_2868624,fly-airplane_plane3_city8-2_city1-2,2868624,3,123,204,327,0
3_6474215,fly-airplane_plane3_city8-2_city10-2,6474215,3,123,204,327,0
3_7610769,unload-airplane_package3_plane3_city3-2,7610769,3,155,290,445,0
3_4614496,unload-airplane_package4_plane3_city3-2,4614496,3,136,246,382,0
3_4811104,unload-airplane_package4_plane3_city6-2,4811104,3,137,246,383,0
3_4745568,unload-airplane_package4_plane3_city5-2,4745568,3,137,246,383,0
3_4483424,unload-airplane_package4_plane3_city1-2,4483424,3,136,245,381,0
3_4942176,unload-airplane_package4_plane3_city8-2,4942176,3,137,246,383,0
3_4939728,noop_in_package5_plane4,4939728,3,124,75,199,0
3_5694773,unload-airplane_package5_plane4_city1-2,5694773,3,137,204,341,0
3_4233888,noop_in-city_city9-1_city9,4233888,3,1,1,2,0
3_5018866,noop_airplane_plane4,5018866,3,1,1,2,0
3_3026819,fly-airplane_plane4_city3-2_city6-2,3026819,3,123,164,287,0
3_2764675,fly-airplane_plane4_city3-2_city2-2,2764675,3,123,164,287,0
3_3223427,fly-airplane_plane4_city3-2_city9-2,3223427,3,123,164,287,0
3_2961283,fly-airplane_plane4_city3-2_city5-2,2961283,3,123,164,287,0
3_2699139,fly-airplane_plane4_city3-2_city1-2,2699139,3,123,164,287,0
3_3090940,fly-airplane_plane4_city3-2_city10-2,3090940,3,123,164,287,0
3_3157891,fly-airplane_plane4_city3-2_city8-2,3157891,3,123,164,287,0
3_1960449,fly-airplane_plane4_city6-2_city3-2,1960449,3,123,164,287,0
3_1894913,fly-airplane_plane4_city6-2_city2-2,1894913,3,123,164,287,0
3_2353665,fly-airplane_plane4_city6-2_city9-2,2353665,3,123,164,287,0
3_2091521,fly-airplane_plane4_city6-2_city5-2,2091521,3,123,164,287,0
3_1829377,fly-airplane_plane4_city6-2_city1-2,1829377,3,123,164,287,0
3_4459224,fly-airplane_plane4_city6-2_city10-2,4459224,3,123,164,287,0
3_2288129,fly-airplane_plane4_city6-2_city8-2,2288129,3,123,164,287,0
3_743060,fly-airplane_plane4_city1-2_city3-2,743060,3,122,164,286,0
3_939668,fly-airplane_plane4_city1-2_city6-2,939668,3,122,164,286,0
3_677524,fly-airplane_plane4_city1-2_city2-2,677524,3,122,164,286,0
3_1136276,fly-airplane_plane4_city1-2_city9-2,1136276,3,122,164,286,0
3_874132,fly-airplane_plane4_city1-2_city5-2,874132,3,122,164,286,0
3_4845743,fly-airplane_plane4_city1-2_city10-2,4845743,3,122,164,286,0
3_1070740,fly-airplane_plane4_city1-2_city8-2,1070740,3,122,164,286,0
3_346354,fly-airplane_plane4_city10-2_city3-2,346354,3,123,164,287,0
3_542962,fly-airplane_plane4_city10-2_city6-2,542962,3,123,164,287,0
3_280818,fly-airplane_plane4_city10-2_city2-2,280818,3,123,164,287,0
3_739570,fly-airplane_plane4_city10-2_city9-2,739570,3,123,164,287,0
3_477426,fly-airplane_plane4_city10-2_city5-2,477426,3,123,164,287,0
3_215282,fly-airplane_plane4_city10-2_city1-2,215282,3,123,164,287,0
3_674034,fly-airplane_plane4_city10-2_city8-2,674034,3,123,164,287,0
3_4047600,fly-airplane_plane4_city8-2_city3-2,4047600,3,123,164,287,0
3_4244208,fly-airplane_plane4_city8-2_city6-2,4244208,3,123,164,287,0
3_3982064,fly-airplane_plane4_city8-2_city2-2,3982064,3,123,164,287,0
3_4440816,fly-airplane_plane4_city8-2_city9-2,4440816,3,123,164,287,0
3_4178672,fly-airplane_plane4_city8-2_city5-2,4178672,3,123,164,287,0
3_3916528,fly-airplane_plane4_city8-2_city1-2,3916528,3,123,164,287,0
3_2704421,fly-airplane_plane4_city8-2_city10-2,2704421,3,123,164,287,0
3_3817414,unload-airplane_package3_plane4_city3-2,3817414,3,146,246,392,0
3_4014022,unload-airplane_package3_plane4_city6-2,4014022,3,146,246,392,0
3_3686342,unload-airplane_package3_plane4_city1-2,3686342,3,145,245,390,0
3_4145094,unload-airplane_package3_plane4_city8-2,4145094,3,146,246,392,0
3_7784621,unload-airplane_package3_plane4_city10-2,7784621,3,146,245,391,0
3_1885288,noop_at_plane3_city5-2,1885288,3,119,197,316,0
3_2650101,noop_at_plane2_city10-2,2650101,3,119,156,275,0
3_5809715,noop_at_plane2_city7-2,5809715,3,116,157,273,0
3_4560839,noop_in-city_city2-2_city2,4560839,3,1,1,2,0
3_6728647,drive-truck_truck2_city2-1_city2-2_city2,6728647,3,13,10,23,0
3_3971182,drive-truck_truck2_city2-2_city2-1_city2,3971182,3,12,10,22,0
3_2773648,noop_location_city3-1,2773648,3,1,1,2,0
3_5830766,noop_at_plane4_city1-2,5830766,3,116,156,272,0
3_2962340,noop_at_truck7_city7-1,2962340,3,7,7,14,0
3_5040038,in_package4_truck7,5040038,3,8,17,25,0
3_5915916,at_truck7_city7-2,5915916,3,3,8,11,0
3_2773649,noop_location_city3-2,2773649,3,1,1,2,0
3_2713826,unload-truck_package3_truck3_city3-2,2713826,3,41,111,152,0
3_2962341,noop_at_truck7_city7-2,2962341,3,4,5,9,0
3_5915915,at_truck7_city7-1,5915915,3,4,4,8,0
3_6289518,noop_at_plane4_city8-2,6289518,3,119,157,276,0
3_2010292,noop_in-city_city9-2_city9,2010292,3,1,1,2,0
3_6144820,noop_at_truck4_city4-1,6144820,3,4,6,10,0
3_1097419,at_truck4_city4-2,1097419,3,3,8,11,0
3_1561471,noop_airport_city3-2,1561471,3,1,1,2,0
3_1602093,noop_at_plane1_city7-2,1602093,3,109,157,266,0
3_6110934,noop_in_package4_plane1,6110934,3,124,140,264,0
3_3772549,at_package4_city7-2,3772549,3,15,20,35,0
3_6118830,noop_at_truck10_city10-1,6118830,3,5,13,18,0
3_3142669,unload-truck_package2_truck10_city10-1,3142669,3,12,17,29,0
3_7404958,load-truck_package2_truck10_city10-1,7404958,3,12,17,29,0
3_3973470,at_truck10_city10-2,3973470,3,3,10,13,0
3_5547571,noop_at_plane2_city3-2,5547571,3,118,157,275,0
3_6144821,noop_at_truck4_city4-2,6144821,3,4,4,8,0
3_1097418,at_truck4_city4-1,1097418,3,3,2,5,0
3_1623144,noop_at_plane3_city1-2,1623144,3,116,196,312,0
3_6110935,noop_in_package4_plane2,6110935,3,133,129,262,0
3_6118831,noop_at_truck10_city10-2,6118831,3,6,6,12,0
3_3142670,unload-truck_package2_truck10_city10-2,3142670,3,12,15,27,0
3_3973469,at_truck10_city10-1,3973469,3,3,4,7,0
3_7612973,noop_in-city_city6-1_city6,7612973,3,1,1,2,0
3_6110936,noop_in_package4_plane3,6110936,3,31,107,138,0
3_2081896,noop_at_plane3_city8-2,2081896,3,119,197,316,0
3_6110937,noop_in_package4_plane4,6110937,3,133,129,262,0
3_2970256,noop_location_city6-1,2970256,3,1,1,2,0
3_6027374,noop_at_plane4_city4-2,6027374,3,119,157,276,0
3_7846438,noop_in_package5_truck1,7846438,3,18,53,71,0
3_4176918,unload-truck_package5_truck1_city1-2,4176918,3,23,57,80,0
3_4279898,at_truck1_city1-1,4279898,3,4,4,8,0
3_2970257,noop_location_city6-2,2970257,3,1,1,2,0
3_1339949,noop_at_plane1_city3-2,1339949,3,109,157,266,0
3_3405350,noop_in-city_city5-1_city5,3405350,3,1,1,2,0
3_2656144,drive-truck_truck5_city5-1_city5-2_city5,2656144,3,10,7,17,0
3_7899656,drive-truck_truck5_city5-2_city5-1_city5,7899656,3,10,7,17,0
3_5389377,noop_in-city_city6-2_city6,5389377,3,1,1,2,0
3_2417001,noop_at_truck5_city5-1,2417001,3,4,6,10,0
3_5370577,at_truck5_city5-2,5370577,3,3,8,11,0
3_1758079,noop_airport_city6-2,1758079,3,1,1,2,0
3_3822037,noop_in_package2_truck10,3822037,3,5,11,16,0
3_7160435,at_package2_city10-1,7160435,3,3,3,6,0
3_2417002,noop_at_truck5_city5-2,2417002,3,4,4,8,0
3_5370576,at_truck5_city5-1,5370576,3,3,2,5,0
3_1819752,noop_at_plane3_city4-2,1819752,3,119,197,316,0
3_5744179,noop_at_plane2_city6-2,5744179,3,119,157,276,0
3_7282143,noop_in_package3_plane1,7282143,3,133,140,273,0
3_7303760,at_package3_city3-2,7303760,3,15,19,34,0
3_2708112,noop_location_city2-1,2708112,3,1,1,2,0
3_5599481,noop_at_truck2_city2-1,5599481,3,7,8,15,0
3_552080,at_truck2_city2-2,552080,3,3,9,12,0
3_1181754,noop_in-city_city5-2_city5,1181754,3,1,1,2,0
3_2708113,noop_location_city2-2,2708113,3,1,1,2,0
3_4433214,unload-truck_package1_truck2_city2-2,4433214,3,23,57,80,0
3_7282144,noop_in_package3_plane2,7282144,3,40,107,147,0
3_7282145,noop_in_package3_plane3,7282145,3,142,177,319,0
3_3166864,noop_location_city9-1,3166864,3,1,1,2,0
3_62686,noop_truck_truck1,62686,3,1,1,2,0
3_85171,drive-truck_truck1_city1-1_city1-2_city1,85171,3,13,10,23,0
3_5328683,drive-truck_truck1_city1-2_city1-1_city1,5328683,3,12,10,22,0
3_5599482,noop_at_truck2_city2-2,5599482,3,4,5,9,0
3_552079,at_truck2_city2-1,552079,3,4,4,8,0
3_6223982,noop_at_plane4_city7-2,6223982,3,116,157,273,0
3_3166865,noop_location_city9-2,3166865,3,1,1,2,0
3_62687,noop_truck_truck2,62687,3,1,1,2,0
3_7282146,noop_in_package3_plane4,7282146,3,40,107,147,0
3_1536557,noop_at_plane1_city6-2,1536557,3,112,157,269,0
3_4109194,noop_in-city_city10-1_city10,4109194,3,1,1,2,0
3_1495935,noop_airport_city2-2,1495935,3,1,1,2,0
3_62688,noop_truck_truck3,62688,3,1,1,2,0
3_4530298,noop_in_package1_truck2,4530298,3,18,53,71,0
3_6823957,at_package1_city2-2,6823957,3,15,7,22,0
3_6784435,noop_in-city_city2-1_city2,6784435,3,1,1,2,0
3_4975108,noop_in-city_city4-2_city4,4975108,3,1,1,2,0
3_62689,noop_truck_truck4,62689,3,1,1,2,0
3_45710,noop_truck_truck10,45710,3,1,1,2,0
3_5482035,noop_at_plane2_city2-2,5482035,3,116,156,272,0
3_1954687,noop_airport_city9-2,1954687,3,1,1,2,0
3_62690,noop_truck_truck5,62690,3,1,1,2,0
3_4305438,noop_at_package2_city10-1,4305438,3,5,11,16,0
3_1676676,in_package2_truck10,1676676,3,4,4,8,0
3_2016360,noop_at_plane3_city7-2,2016360,3,118,202,320,0
3_62691,noop_truck_truck6,62691,3,1,1,2,0
3_5940787,noop_at_plane2_city9-2,5940787,3,119,157,276,0
3_5961838,noop_at_plane4_city3-2,5961838,3,118,157,275,0
3_2904720,noop_location_city5-1,2904720,3,1,1,2,0
3_62692,noop_truck_truck7,62692,3,1,1,2,0
3_1871662,noop_at_truck3_city3-1,1871662,3,7,7,14,0
3_4825238,at_truck3_city3-2,4825238,3,3,8,11,0
3_2576812,noop_in-city_city1-1_city1,2576812,3,1,1,2,0
3_2904721,noop_location_city5-2,2904721,3,1,1,2,0
3_62693,noop_truck_truck8,62693,3,1,1,2,0
3_6584618,drive-truck_truck8_city8-1_city8-2_city8,6584618,3,10,7,17,0
3_3827153,drive-truck_truck8_city8-2_city8-1_city8,3827153,3,10,7,17,0
3_4689752,noop_at_plane4_city10-2,4689752,3,119,156,275,0
3_1016676,noop_in_package4_truck7,1016676,3,27,107,134,0
3_62694,noop_truck_truck9,62694,3,1,1,2,0
3_1871663,noop_at_truck3_city3-2,1871663,3,4,5,9,0
3_4825237,at_truck3_city3-1,4825237,3,4,4,8,0
3_1274413,noop_at_plane1_city2-2,1274413,3,109,156,265,0
3_1837095,noop_obj_package1,1837095,3,1,1,2,0
3_26265,noop_in-city_city8-1_city8,26265,3,1,1,2,0
3_1692543,noop_airport_city5-2,1692543,3,1,1,2,0
3_1837096,noop_obj_package2,1837096,3,1,1,2,0
3_1733165,noop_at_plane1_city9-2,1733165,3,112,157,269,0
3_353216,noop_in-city_city1-2_city1,353216,3,1,1,2,0
3_1837097,noop_obj_package3,1837097,3,1,1,2,0
3_1754216,noop_at_plane3_city3-2,1754216,3,116,197,313,0
3_5678643,noop_at_plane2_city5-2,5678643,3,119,157,276,0
3_2642576,noop_location_city1-1,2642576,3,1,1,2,0
3_4005493,noop_city_city1,4005493,3,1,1,2,0
3_1837098,noop_obj_package4,1837098,3,1,1,2,0
3_2187881,noop_in_package3_truck3,2187881,3,36,107,143,0
3_2642577,noop_location_city1-2,2642577,3,1,1,2,0
3_4005494,noop_city_city2,4005494,3,1,1,2,0
3_1837099,noop_obj_package5,1837099,3,1,1,2,0
3_3819619,noop_in-city_city7-1_city7,3819619,3,1,1,2,0
3_5803646,noop_in-city_city8-2_city8,5803646,3,1,1,2,0
3_3101328,noop_location_city8-1,3101328,3,1,1,2,0
3_4005495,noop_city_city3,4005495,3,1,1,2,0
3_6158446,noop_at_plane4_city6-2,6158446,3,119,157,276,0
3_3101329,noop_location_city8-2,3101329,3,1,1,2,0
3_4005496,noop_city_city4,4005496,3,1,1,2,0
3_1623584,noop_in_package1_plane1,1623584,3,115,86,201,0
3_7235498,noop_at_truck8_city8-1,7235498,3,4,6,10,0
3_2188097,at_truck8_city8-2,2188097,3,3,8,11,0
3_1430399,noop_airport_city1-2,1430399,3,1,1,2,0
3_6333557,noop_airport_city10-2,6333557,3,1,1,2,0
3_4613021,noop_location_city10-1,4613021,3,1,1,2,0
3_4005497,noop_city_city5,4005497,3,1,1,2,0
3_1471021,noop_at_plane1_city5-2,1471021,3,112,157,269,0
3_1623585,noop_in_package1_plane2,1623585,3,124,75,199,0
3_4613022,noop_location_city10-2,4613022,3,1,1,2,0
3_4005498,noop_city_city6,4005498,3,1,1,2,0
3_7235499,noop_at_truck8_city8-2,7235499,3,4,4,8,0
3_2188096,at_truck8_city8-1,2188096,3,3,2,5,0
3_5416499,noop_at_plane2_city1-2,5416499,3,116,156,272,0
3_1623586,noop_in_package1_plane3,1623586,3,124,123,247,0
3_1326323,noop_at_truck1_city1-1,1326323,3,7,8,15,0
3_4279899,at_truck1_city1-2,4279899,3,3,9,12,0
3_1596023,noop_in-city_city7-2_city7,1596023,3,1,1,2,0
3_1889151,noop_airport_city8-2,1889151,3,1,1,2,0
3_4005499,noop_city_city7,4005499,3,1,1,2,0
3_1623587,noop_in_package1_plane4,1623587,3,124,75,199,0
3_5917910,noop_at_package4_city7-2,5917910,3,25,107,132,0
3_4005500,noop_city_city8,4005500,3,1,1,2,0
3_1326324,noop_at_truck1_city1-2,1326324,3,4,5,9,0
3_1950824,noop_at_plane3_city6-2,1950824,3,119,197,316,0
3_5875251,noop_at_plane2_city8-2,5875251,3,119,157,276,0
3_5630764,noop_at_plane1_city10-2,5630764,3,112,156,268,0
3_6497299,city_city8,6497299,3,1,3,4,0
3_6195675,in-city_city5-1_city5,6195675,3,1,3,4,0
3_7104561,city_city10,7104561,3,1,3,4,0
2_3882950,unload-airplane_package3_plane4_city4-2,3882950,2,5,143,148,0
3_7369296,at_package3_city4-2,7369296,3,2,20,22,0
3_585448,airport_city8-2,585448,3,1,73,74,0
3_6497300,city_city9,6497300,3,1,3,4,0
2_1487151,unload-airplane_package5_plane3_city1-2,1487151,2,4,134,138,0
1_962112,in_package5_plane3,962112,1,0,1,1,0
2_5536802,unload-airplane_package1_plane3_city2-2,5536802,2,4,134,138,0
1_5646948,in_package1_plane3,5646948,1,0,1,1,0
2_7196502,unload-airplane_package3_plane1_city3-2,7196502,2,4,143,147,0
1_3304528,in_package3_plane1,3304528,1,0,1,1,0
3_3972079,in-city_city5-2_city5,3972079,3,1,3,4,0
3_1988052,in-city_city4-1_city4,1988052,3,1,3,4,0
2_4811104,unload-airplane_package4_plane3_city6-2,4811104,2,5,134,139,0
3_3707013,at_package4_city6-2,3707013,3,1,32,33,0
2_3599755,unload-airplane_package3_plane2_city6-2,3599755,2,5,143,148,0
3_7500368,at_package3_city6-2,7500368,3,2,20,22,0
3_5263322,location_city6-1,5263322,3,1,3,4,0
2_5280506,unload-airplane_package5_plane2_city1-2,5280506,2,4,134,138,0
1_962111,in_package5_plane2,962111,1,0,1,1,0
3_625646,airport_city10-2,625646,3,1,73,74,0
3_5263323,location_city6-2,5263323,3,1,41,42,0
3_323304,airport_city4-2,323304,3,1,73,74,0
3_7765433,in-city_city4-2_city4,7765433,3,1,3,4,0
2_4079558,unload-airplane_package3_plane4_city7-2,4079558,2,5,142,147,0
3_7565904,at_package3_city7-2,7565904,3,2,6,8,0
3_1230283,truck_truck10,1230283,3,1,13,14,0
2_4548960,unload-airplane_package4_plane3_city2-2,4548960,2,5,133,138,0
3_3444869,at_package4_city2-2,3444869,3,1,31,32,0
2_3337611,unload-airplane_package3_plane2_city2-2,3337611,2,5,142,147,0
3_7238224,at_package3_city2-2,7238224,3,2,20,22,0
2_3812211,unload-airplane_package4_plane3_city10-2,3812211,2,5,134,139,0
3_1199110,at_package4_city10-2,1199110,3,1,32,33,0
3_5367137,in-city_city1-1_city1,5367137,3,1,3,4,0
3_5001178,location_city2-1,5001178,3,1,5,6,0
2_5007712,unload-airplane_package4_plane3_city9-2,5007712,2,5,134,139,0
3_3903621,at_package4_city9-2,3903621,3,1,32,33,0
3_5001179,location_city2-2,5001179,3,1,42,43,0
3_3715160,airplane_plane1,3715160,3,1,173,174,0
2_3796363,unload-airplane_package3_plane2_city9-2,3796363,2,5,143,148,0
3_7696976,at_package3_city9-2,7696976,3,2,20,22,0
3_5459930,location_city9-1,5459930,3,1,3,4,0
3_3715161,airplane_plane2,3715161,3,1,173,174,0
2_4433214,unload-truck_package1_truck2_city2-2,4433214,2,4,20,24,0
1_552683,in_package1_truck2,552683,1,0,1,1,0
3_2816590,in-city_city8-1_city8,2816590,3,1,3,4,0
3_5459931,location_city9-2,5459931,3,1,41,42,0
3_3715162,airplane_plane3,3715162,3,1,173,174,0
3_519912,airport_city7-2,519912,3,1,73,74,0
3_3143541,in-city_city1-2_city1,3143541,3,1,3,4,0
3_3715163,airplane_plane4,3715163,3,1,173,174,0
2_669018,unload-airplane_package4_plane2_city7-2,669018,2,4,143,147,0
1_2133320,in_package4_plane2,2133320,1,0,1,1,0
2_4745568,unload-airplane_package4_plane3_city5-2,4745568,2,5,134,139,0
3_3641477,at_package4_city5-2,3641477,3,1,32,33,0
2_4176918,unload-truck_package5_truck1_city1-2,4176918,2,4,20,24,0
1_3868823,in_package5_truck1,3868823,1,0,1,1,0
3_6609944,in-city_city7-1_city7,6609944,3,1,3,4,0
2_3534219,unload-airplane_package3_plane2_city5-2,3534219,2,5,143,148,0
3_7434832,at_package3_city5-2,7434832,3,2,20,22,0
2_7610769,unload-airplane_package3_plane3_city3-2,7610769,2,4,152,156,0
1_3304530,in_package3_plane3,3304530,1,0,1,1,0
3_5197786,location_city5-1,5197786,3,1,3,4,0
2_5744970,unload-airplane_package3_plane2_city10-2,5744970,2,5,143,148,0
3_4179773,at_package3_city10-2,4179773,3,2,20,22,0
2_3142670,unload-truck_package2_truck10_city10-2,3142670,2,5,9,14,0
3_7160436,at_package2_city10-2,7160436,3,1,9,10,0
3_7566596,location_city10-1,7566596,3,1,5,6,0
3_5197787,location_city5-2,5197787,3,1,41,42,0
3_257768,airport_city3-2,257768,3,1,73,74,0
2_7784621,unload-airplane_package3_plane4_city10-2,7784621,2,5,143,148,0
3_7566597,location_city10-2,7566597,3,1,51,52,0
2_4014022,unload-airplane_package3_plane4_city6-2,4014022,2,5,143,148,0
3_4386348,in-city_city7-2_city7,4386348,3,1,3,4,0
3_2402321,in-city_city6-1_city6,2402321,3,1,3,4,0
2_4462373,unload-airplane_package4_plane1_city7-2,4462373,2,4,134,138,0
1_2133319,in_package4_plane1,2133319,1,0,1,1,0
2_5694773,unload-airplane_package5_plane4_city1-2,5694773,2,4,134,138,0
1_962113,in_package5_plane4,962113,1,0,1,1,0
2_4483424,unload-airplane_package4_plane3_city1-2,4483424,2,5,133,138,0
3_3379333,at_package4_city1-2,3379333,3,1,31,32,0
2_4939725,noop_in_package5_plane1,4939725,2,0,115,115,0
1_962110,in_package5_plane1,962110,1,0,1,1,0
2_3272075,unload-airplane_package3_plane2_city1-2,3272075,2,5,142,147,0
3_7172688,at_package3_city1-2,7172688,3,2,20,22,0
3_4935642,location_city1-1,4935642,3,1,5,6,0
2_1016676,noop_in_package4_truck7,1016676,2,0,27,27,0
1_5040038,in_package4_truck7,5040038,1,0,1,1,0
2_4939726,noop_in_package5_plane2,4939726,2,1,124,125,0
2_4942176,unload-airplane_package4_plane3_city8-2,4942176,2,5,134,139,0
3_3838085,at_package4_city8-2,3838085,3,1,32,33,0
2_2713826,unload-truck_package3_truck3_city3-2,2713826,2,4,38,42,0
1_6211243,in_package3_truck3,6211243,1,0,1,1,0
3_4935643,location_city1-2,4935643,3,1,42,43,0
3_178725,in-city_city6-2_city6,178725,3,1,3,4,0
2_4939727,noop_in_package5_plane3,4939727,2,1,124,125,0
2_3730827,unload-airplane_package3_plane2_city8-2,3730827,2,5,143,148,0
3_7631440,at_package3_city8-2,7631440,3,2,20,22,0
3_5394394,location_city8-1,5394394,3,1,3,4,0
2_4939728,noop_in_package5_plane4,4939728,2,1,124,125,0
2_3751878,unload-airplane_package3_plane4_city2-2,3751878,2,5,142,147,0
3_5394395,location_city8-2,5394395,3,1,41,42,0
3_454376,airport_city6-2,454376,3,1,73,74,0
2_1329180,unload-airplane_package1_plane2_city2-2,1329180,2,4,134,138,0
1_5646947,in_package1_plane2,5646947,1,0,1,1,0
2_4210630,unload-airplane_package3_plane4_city9-2,4210630,2,5,143,148,0
2_2187881,noop_in_package3_truck3,2187881,2,1,36,37,0
3_5781406,in-city_city3-1_city3,5781406,3,1,3,4,0
2_808231,unload-truck_package4_truck7_city7-2,808231,2,5,29,34,0
2_4680032,unload-airplane_package4_plane3_city4-2,4680032,2,5,134,139,0
3_3575941,at_package4_city4-2,3575941,3,1,32,33,0
2_3468683,unload-airplane_package3_plane2_city4-2,3468683,2,5,143,148,0
2_1623584,noop_in_package1_plane1,1623584,2,0,115,115,0
1_5646946,in_package1_plane1,5646946,1,0,1,1,0
2_6110934,noop_in_package4_plane1,6110934,2,1,124,125,0
3_5132250,location_city4-1,5132250,3,1,3,4,0
2_1072884,unload-airplane_package5_plane1_city1-2,1072884,2,5,125,130,0
2_1623585,noop_in_package1_plane2,1623585,2,1,124,125,0
3_1573783,in-city_city2-1_city2,1573783,3,1,3,4,0
3_192232,airport_city2-2,192232,3,1,73,74,0
2_6110935,noop_in_package4_plane2,6110935,2,1,133,134,0
3_3557810,in-city_city3-2_city3,3557810,3,1,3,4,0
3_5132251,location_city4-2,5132251,3,1,41,42,0
3_7347850,in-city_city10-2_city10,7347850,3,1,3,4,0
2_5122535,unload-airplane_package1_plane1_city2-2,5122535,2,5,125,130,0
2_1083285,unload-airplane_package4_plane4_city7-2,1083285,2,4,143,147,0
1_2133322,in_package4_plane4,2133322,1,0,1,1,0
2_1623586,noop_in_package1_plane3,1623586,2,1,124,125,0
3_2661380,truck_truck1,2661380,3,1,12,13,0
2_3948486,unload-airplane_package3_plane4_city5-2,3948486,2,5,143,148,0
2_1623587,noop_in_package1_plane4,1623587,2,0,124,124,0
1_5646949,in_package1_plane4,5646949,1,0,1,1,0
3_650984,airport_city9-2,650984,3,1,73,74,0
3_2661381,truck_truck2,2661381,3,1,12,13,0
2_6110937,noop_in_package4_plane4,6110937,2,1,133,134,0
3_2661382,truck_truck3,2661382,3,1,11,12,0
2_7846438,noop_in_package5_truck1,7846438,2,1,18,19,0
3_7024213,in-city_city9-1_city9,7024213,3,1,3,4,0
3_2661383,truck_truck4,2661383,3,1,9,10,0
3_7351164,in-city_city2-2_city2,7351164,3,1,3,4,0
3_2661384,truck_truck5,2661384,3,1,9,10,0
3_2661385,truck_truck6,2661385,3,1,9,10,0
2_3665291,unload-airplane_package3_plane2_city7-2,3665291,2,5,142,147,0
3_2661386,truck_truck7,2661386,3,1,11,12,0
3_4800617,in-city_city9-2_city9,4800617,3,1,3,4,0
3_5328858,location_city7-1,5328858,3,1,5,6,0
2_3686342,unload-airplane_package3_plane4_city1-2,3686342,2,5,142,147,0
3_6497292,city_city1,6497292,3,1,3,4,0
3_388840,airport_city5-2,388840,3,1,73,74,0
3_2661387,truck_truck8,2661387,3,1,9,10,0
2_7282143,noop_in_package3_plane1,7282143,2,1,133,134,0
3_5328859,location_city7-2,5328859,3,1,41,42,0
3_6497293,city_city2,6497293,3,1,3,4,0
3_2661388,truck_truck9,2661388,3,1,9,10,0
3_518082,in-city_city10-1_city10,518082,3,1,3,4,0
2_4145094,unload-airplane_package3_plane4_city8-2,4145094,2,5,143,148,0
3_6497294,city_city3,6497294,3,1,3,4,0
3_4435789,obj_package1,4435789,3,1,94,95,0
2_7282145,noop_in_package3_plane3,7282145,2,1,142,143,0
3_6497295,city_city4,6497295,3,1,3,4,0
3_592994,in-city_city8-2_city8,592994,3,1,3,4,0
3_4435790,obj_package2,4435790,3,1,13,14,0
2_4614496,unload-airplane_package4_plane3_city3-2,4614496,2,5,133,138,0
3_3510405,at_package4_city3-2,3510405,3,1,21,22,0
3_6497296,city_city5,6497296,3,1,3,4,0
3_4435791,obj_package3,4435791,3,1,103,104,0
2_1743447,unload-airplane_package1_plane4_city2-2,1743447,2,5,134,139,0
3_6497297,city_city6,6497297,3,1,3,4,0
3_4435792,obj_package4,4435792,3,1,103,104,0
2_4530298,noop_in_package1_truck2,4530298,2,1,18,19,0
3_5066714,location_city3-1,5066714,3,1,5,6,0
3_6497298,city_city7,6497298,3,1,3,4,0
3_126696,airport_city1-2,126696,3,1,73,74,0
3_4435793,obj_package5,4435793,3,1,94,95,0
3_5066715,location_city3-2,5066715,3,1,41,42,0
4_7670415,noop_at_plane3_city10-2,7670415,4,196,172,368,0
4_4181684,fly-airplane_plane3_city10-2_city4-2,4181684,4,206,183,389,0
4_4378292,fly-airplane_plane3_city10-2_city7-2,4378292,4,206,183,389,0
4_4116148,fly-airplane_plane3_city10-2_city3-2,4116148,4,206,183,389,0
4_4312756,fly-airplane_plane3_city10-2_city6-2,4312756,4,206,183,389,0
4_4050612,fly-airplane_plane3_city10-2_city2-2,4050612,4,206,183,389,0
4_4509364,fly-airplane_plane3_city10-2_city9-2,4509364,4,206,183,389,0
4_4247220,fly-airplane_plane3_city10-2_city5-2,4247220,4,206,183,389,0
4_3985076,fly-airplane_plane3_city10-2_city1-2,3985076,4,206,183,389,0
4_4443828,fly-airplane_plane3_city10-2_city8-2,4443828,4,206,183,389,0
4_668499,unload-airplane_package1_plane3_city10-2,668499,4,252,279,531,0
4_2764307,unload-airplane_package3_plane3_city10-2,2764307,4,298,281,579,0
4_3812211,unload-airplane_package4_plane3_city10-2,3812211,4,248,281,529,0
4_4860115,unload-airplane_package5_plane3_city10-2,4860115,4,252,279,531,0
4_4979283,load-airplane_package2_plane3_city10-2,4979283,4,212,191,403,0
4_6027187,load-airplane_package3_plane3_city10-2,6027187,4,288,281,569,0
4_7075091,load-airplane_package4_plane3_city10-2,7075091,4,254,281,535,0
4_4904399,at_plane3_city6-2,4904399,4,35,29,64,0
4_4707791,at_plane3_city3-2,4707791,4,35,29,64,0
4_3575941,at_package4_city4-2,3575941,4,35,30,65,0
4_4969935,at_plane3_city7-2,4969935,4,36,29,65,0
4_3838085,at_package4_city8-2,3838085,4,35,30,65,0
4_3379333,at_package4_city1-2,3379333,4,34,30,64,0
4_4773327,at_plane3_city4-2,4773327,4,35,29,64,0
4_3641477,at_package4_city5-2,3641477,4,35,30,65,0
4_3903621,at_package4_city9-2,3903621,4,35,30,65,0
4_3444869,at_package4_city2-2,3444869,4,34,30,64,0
4_3707013,at_package4_city6-2,3707013,4,35,30,65,0
4_3510405,at_package4_city3-2,3510405,4,34,8,42,0
4_5035471,at_plane3_city8-2,5035471,4,35,29,64,0
4_4576719,at_plane3_city1-2,4576719,4,35,29,64,0
4_4838863,at_plane3_city5-2,4838863,4,35,29,64,0
4_5101007,at_plane3_city9-2,5101007,4,35,29,64,0
4_4642255,at_plane3_city2-2,4642255,4,35,27,62,0
4_5896302,noop_at_plane4_city2-2,5896302,4,156,175,331,0
4_5852660,fly-airplane_plane4_city2-2_city4-2,5852660,4,166,184,350,0
4_6049268,fly-airplane_plane4_city2-2_city7-2,6049268,4,166,184,350,0
4_5787124,fly-airplane_plane4_city2-2_city3-2,5787124,4,166,184,350,0
4_5983732,fly-airplane_plane4_city2-2_city6-2,5983732,4,166,184,350,0
4_6180340,fly-airplane_plane4_city2-2_city9-2,6180340,4,166,184,350,0
4_5918196,fly-airplane_plane4_city2-2_city5-2,5918196,4,166,184,350,0
4_7968830,fly-airplane_plane4_city2-2_city10-2,7968830,4,166,184,350,0
4_5656052,fly-airplane_plane4_city2-2_city1-2,5656052,4,166,184,350,0
4_6114804,fly-airplane_plane4_city2-2_city8-2,6114804,4,166,184,350,0
4_1743447,unload-airplane_package1_plane4_city2-2,1743447,4,207,266,473,0
4_3751878,unload-airplane_package3_plane4_city2-2,3751878,4,248,284,532,0
4_755605,unload-airplane_package4_plane4_city2-2,755605,4,252,284,536,0
4_5760309,unload-airplane_package5_plane4_city2-2,5760309,4,206,266,472,0
4_4756559,load-airplane_package1_plane4_city2-2,4756559,4,203,266,469,0
4_6764990,load-airplane_package3_plane4_city2-2,6764990,4,248,284,532,0
4_3768717,load-airplane_package4_plane4_city2-2,3768717,4,380,284,664,0
4_1111044,at_plane4_city6-2,1111044,4,27,29,56,0
4_712137,at_plane4_city10-2,712137,4,27,29,56,0
4_914436,at_plane4_city3-2,914436,4,27,29,56,0
4_1176580,at_plane4_city7-2,1176580,4,27,29,56,0
4_979972,at_plane4_city4-2,979972,4,27,29,56,0
4_1242116,at_plane4_city8-2,1242116,4,27,29,56,0
4_783364,at_plane4_city1-2,783364,4,27,29,56,0
4_1045508,at_plane4_city5-2,1045508,4,27,29,56,0
4_1307652,at_plane4_city9-2,1307652,4,27,28,55,0
4_4005501,noop_city_city9,4005501,4,1,1,2,0
4_5227117,drive-truck_truck9_city9-1_city9-2_city9,5227117,4,12,13,25,0
4_2469652,drive-truck_truck9_city9-2_city9-1_city9,2469652,4,12,11,23,0
4_2839184,noop_location_city4-1,2839184,4,1,1,2,0
4_4013645,drive-truck_truck4_city4-1_city4-2_city4,4013645,4,12,13,25,0
4_1256180,drive-truck_truck4_city4-2_city4-1_city4,1256180,4,12,11,23,0
4_2937985,noop_in-city_city10-2_city10,2937985,4,1,1,2,0
4_7656764,drive-truck_truck10_city10-1_city10-2_city10,7656764,4,21,17,38,0
4_1874900,drive-truck_truck10_city10-2_city10-1_city10,1874900,4,16,15,31,0
4_2839185,noop_location_city4-2,2839185,4,1,1,2,0
4_5253607,unload-airplane_package1_plane1_city4-2,5253607,4,209,266,475,0
4_1460252,unload-airplane_package1_plane2_city4-2,1460252,4,207,266,473,0
4_5667874,unload-airplane_package1_plane3_city4-2,5667874,4,253,282,535,0
4_1874519,unload-airplane_package1_plane4_city4-2,1874519,4,207,266,473,0
4_7262038,unload-airplane_package3_plane1_city4-2,7262038,4,255,284,539,0
4_3468683,unload-airplane_package3_plane2_city4-2,3468683,4,249,284,533,0
4_7676305,unload-airplane_package3_plane3_city4-2,7676305,4,299,284,583,0
4_3882950,unload-airplane_package3_plane4_city4-2,3882950,4,249,284,533,0
4_4265765,unload-airplane_package4_plane1_city4-2,4265765,4,255,284,539,0
4_472410,unload-airplane_package4_plane2_city4-2,472410,4,253,284,537,0
4_4680032,unload-airplane_package4_plane3_city4-2,4680032,4,249,284,533,0
4_886677,unload-airplane_package4_plane4_city4-2,886677,4,253,284,537,0
4_1269492,unload-airplane_package5_plane1_city4-2,1269492,4,209,266,475,0
4_5477114,unload-airplane_package5_plane2_city4-2,5477114,4,207,266,473,0
4_1683759,unload-airplane_package5_plane3_city4-2,1683759,4,253,282,535,0
4_5891381,unload-airplane_package5_plane4_city4-2,5891381,4,207,266,473,0
4_2274173,load-airplane_package3_plane1_city4-2,2274173,4,249,284,533,0
4_6481795,load-airplane_package3_plane2_city4-2,6481795,4,249,284,533,0
4_2688440,load-airplane_package3_plane3_city4-2,2688440,4,289,284,573,0
4_6896062,load-airplane_package3_plane4_city4-2,6896062,4,249,284,533,0
4_7278877,load-airplane_package4_plane1_city4-2,7278877,4,384,284,668,0
4_3485522,load-airplane_package4_plane2_city4-2,3485522,4,384,284,668,0
4_7693144,load-airplane_package4_plane3_city4-2,7693144,4,255,284,539,0
4_3899789,load-airplane_package4_plane4_city4-2,3899789,4,384,284,668,0
4_7744832,load-truck_package3_truck4_city4-2,7744832,4,114,131,245,0
4_4748559,load-truck_package4_truck4_city4-2,4748559,4,249,131,380,0
4_1208877,noop_at_plane1_city1-2,1208877,4,156,175,331,0
4_5665861,fly-airplane_plane1_city1-2_city4-2,5665861,4,166,184,350,0
4_5862469,fly-airplane_plane1_city1-2_city7-2,5862469,4,166,184,350,0
4_5600325,fly-airplane_plane1_city1-2_city3-2,5600325,4,166,184,350,0
4_5796933,fly-airplane_plane1_city1-2_city6-2,5796933,4,166,184,350,0
4_5534789,fly-airplane_plane1_city1-2_city2-2,5534789,4,166,184,350,0
4_5993541,fly-airplane_plane1_city1-2_city9-2,5993541,4,166,184,350,0
4_5731397,fly-airplane_plane1_city1-2_city5-2,5731397,4,166,184,350,0
4_153171,fly-airplane_plane1_city1-2_city10-2,153171,4,166,184,350,0
4_5928005,fly-airplane_plane1_city1-2_city8-2,5928005,4,166,184,350,0
4_5056999,unload-airplane_package1_plane1_city1-2,5056999,4,208,266,474,0
4_7065430,unload-airplane_package3_plane1_city1-2,7065430,4,254,284,538,0
4_4069157,unload-airplane_package4_plane1_city1-2,4069157,4,254,284,538,0
4_1072884,unload-airplane_package5_plane1_city1-2,1072884,4,209,266,475,0
4_2077565,load-airplane_package3_plane1_city1-2,2077565,4,248,284,532,0
4_7082269,load-airplane_package4_plane1_city1-2,7082269,4,380,284,664,0
4_4085996,load-airplane_package5_plane1_city1-2,4085996,4,203,266,469,0
4_1653149,at_plane1_city10-2,1653149,4,27,29,56,0
4_4424596,at_plane1_city5-2,4424596,4,27,29,56,0
4_4686740,at_plane1_city9-2,4686740,4,27,29,56,0
4_4227988,at_plane1_city2-2,4227988,4,27,29,56,0
4_4490132,at_plane1_city6-2,4490132,4,27,29,56,0
4_4293524,at_plane1_city3-2,4293524,4,27,29,56,0
4_4555668,at_plane1_city7-2,4555668,4,27,29,56,0
4_4359060,at_plane1_city4-2,4359060,4,27,29,56,0
4_4621204,at_plane1_city8-2,4621204,4,27,28,55,0
4_6355054,noop_at_plane4_city9-2,6355054,4,157,175,332,0
4_1156223,fly-airplane_plane4_city9-2_city4-2,1156223,4,166,184,350,0
4_1352831,fly-airplane_plane4_city9-2_city7-2,1352831,4,166,184,350,0
4_1090687,fly-airplane_plane4_city9-2_city3-2,1090687,4,166,184,350,0
4_1287295,fly-airplane_plane4_city9-2_city6-2,1287295,4,166,184,350,0
4_1025151,fly-airplane_plane4_city9-2_city2-2,1025151,4,166,184,350,0
4_1221759,fly-airplane_plane4_city9-2_city5-2,1221759,4,166,184,350,0
4_5827508,fly-airplane_plane4_city9-2_city10-2,5827508,4,166,184,350,0
4_959615,fly-airplane_plane4_city9-2_city1-2,959615,4,166,184,350,0
4_1418367,fly-airplane_plane4_city9-2_city8-2,1418367,4,166,184,350,0
4_2202199,unload-airplane_package1_plane4_city9-2,2202199,4,207,266,473,0
4_4210630,unload-airplane_package3_plane4_city9-2,4210630,4,249,284,533,0
4_1214357,unload-airplane_package4_plane4_city9-2,1214357,4,253,284,537,0
4_6219061,unload-airplane_package5_plane4_city9-2,6219061,4,207,266,473,0
4_7223742,load-airplane_package3_plane4_city9-2,7223742,4,249,284,533,0
4_4227469,load-airplane_package4_plane4_city9-2,4227469,4,384,284,668,0
4_848900,at_plane4_city2-2,848900,4,27,19,46,0
4_7198704,noop_in-city_city4-1_city4,7198704,4,1,1,2,0
4_1710288,noop_at_package3_city7-2,1710288,4,107,127,234,0
4_2470781,load-airplane_package3_plane1_city7-2,2470781,4,249,284,533,0
4_6678403,load-airplane_package3_plane2_city7-2,6678403,4,249,284,533,0
4_2885048,load-airplane_package3_plane3_city7-2,2885048,4,294,284,578,0
4_7092670,load-airplane_package3_plane4_city7-2,7092670,4,249,284,533,0
4_4562352,load-truck_package3_truck7_city7-2,4562352,4,115,134,249,0
4_7369296,at_package3_city4-2,7369296,4,23,30,53,0
4_6211243,in_package3_truck3,6211243,4,17,27,44,0
4_7631440,at_package3_city8-2,7631440,4,23,30,53,0
4_7172688,at_package3_city1-2,7172688,4,23,30,53,0
4_7434832,at_package3_city5-2,7434832,4,23,30,53,0
4_3304531,in_package3_plane4,3304531,4,34,35,69,0
4_3304530,in_package3_plane3,3304530,4,44,35,79,0
4_3304529,in_package3_plane2,3304529,4,34,35,69,0
4_3304528,in_package3_plane1,3304528,4,37,35,72,0
4_7696976,at_package3_city9-2,7696976,4,23,30,53,0
4_7238224,at_package3_city2-2,7238224,4,23,30,53,0
4_4179773,at_package3_city10-2,4179773,4,23,30,53,0
4_7500368,at_package3_city6-2,7500368,4,23,30,53,0
4_7303760,at_package3_city3-2,7303760,4,24,30,54,0
4_1667629,noop_at_plane1_city8-2,1667629,4,157,175,332,0
4_969424,fly-airplane_plane1_city8-2_city4-2,969424,4,166,184,350,0
4_1166032,fly-airplane_plane1_city8-2_city7-2,1166032,4,166,184,350,0
4_903888,fly-airplane_plane1_city8-2_city3-2,903888,4,166,184,350,0
4_1100496,fly-airplane_plane1_city8-2_city6-2,1100496,4,166,184,350,0
4_838352,fly-airplane_plane1_city8-2_city2-2,838352,4,166,184,350,0
4_1297104,fly-airplane_plane1_city8-2_city9-2,1297104,4,166,184,350,0
4_1034960,fly-airplane_plane1_city8-2_city5-2,1034960,4,166,184,350,0
4_6012826,fly-airplane_plane1_city8-2_city10-2,6012826,4,166,184,350,0
4_772816,fly-airplane_plane1_city8-2_city1-2,772816,4,166,184,350,0
4_5515751,unload-airplane_package1_plane1_city8-2,5515751,4,209,266,475,0
4_7524182,unload-airplane_package3_plane1_city8-2,7524182,4,255,284,539,0
4_4527909,unload-airplane_package4_plane1_city8-2,4527909,4,255,284,539,0
4_1531636,unload-airplane_package5_plane1_city8-2,1531636,4,209,266,475,0
4_2536317,load-airplane_package3_plane1_city8-2,2536317,4,249,284,533,0
4_7541021,load-airplane_package4_plane1_city8-2,7541021,4,384,284,668,0
4_4162452,at_plane1_city1-2,4162452,4,27,19,46,0
4_1627007,noop_airport_city4-2,1627007,4,1,1,2,0
4_4992707,fly-airplane_plane1_city4-2_city7-2,4992707,4,166,184,350,0
4_4730563,fly-airplane_plane1_city4-2_city3-2,4730563,4,166,184,350,0
4_4927171,fly-airplane_plane1_city4-2_city6-2,4927171,4,166,184,350,0
4_4665027,fly-airplane_plane1_city4-2_city2-2,4665027,4,166,184,350,0
4_5123779,fly-airplane_plane1_city4-2_city9-2,5123779,4,166,184,350,0
4_4861635,fly-airplane_plane1_city4-2_city5-2,4861635,4,166,184,350,0
4_1521455,fly-airplane_plane1_city4-2_city10-2,1521455,4,166,184,350,0
4_4599491,fly-airplane_plane1_city4-2_city1-2,4599491,4,166,184,350,0
4_5058243,fly-airplane_plane1_city4-2_city8-2,5058243,4,166,184,350,0
4_3926337,fly-airplane_plane1_city7-2_city4-2,3926337,4,166,184,350,0
4_7753012,fly-airplane_plane1_city3-2_city4-2,7753012,4,166,184,350,0
4_6883250,fly-airplane_plane1_city6-2_city4-2,6883250,4,166,184,350,0
4_2708948,fly-airplane_plane1_city2-2_city4-2,2708948,4,166,184,350,0
4_6013488,fly-airplane_plane1_city9-2_city4-2,6013488,4,166,184,350,0
4_1839186,fly-airplane_plane1_city5-2_city4-2,1839186,4,166,184,350,0
4_3720295,fly-airplane_plane1_city10-2_city4-2,3720295,4,166,183,349,0
4_6040611,fly-airplane_plane2_city4-2_city7-2,6040611,4,166,184,350,0
4_5778467,fly-airplane_plane2_city4-2_city3-2,5778467,4,166,184,350,0
4_5975075,fly-airplane_plane2_city4-2_city6-2,5975075,4,166,184,350,0
4_5712931,fly-airplane_plane2_city4-2_city2-2,5712931,4,166,184,350,0
4_6171683,fly-airplane_plane2_city4-2_city9-2,6171683,4,166,184,350,0
4_5909539,fly-airplane_plane2_city4-2_city5-2,5909539,4,166,184,350,0
4_5752638,fly-airplane_plane2_city4-2_city10-2,5752638,4,166,184,350,0
4_5647395,fly-airplane_plane2_city4-2_city1-2,5647395,4,166,184,350,0
4_6106147,fly-airplane_plane2_city4-2_city8-2,6106147,4,166,184,350,0
4_4974241,fly-airplane_plane2_city7-2_city4-2,4974241,4,166,184,350,0
4_799939,fly-airplane_plane2_city3-2_city4-2,799939,4,166,184,350,0
4_7931154,fly-airplane_plane2_city6-2_city4-2,7931154,4,166,184,350,0
4_3756852,fly-airplane_plane2_city2-2_city4-2,3756852,4,166,184,350,0
4_7061392,fly-airplane_plane2_city9-2_city4-2,7061392,4,166,184,350,0
4_2887090,fly-airplane_plane2_city5-2_city4-2,2887090,4,166,184,350,0
4_7951478,fly-airplane_plane2_city10-2_city4-2,7951478,4,166,183,349,0
4_6713765,fly-airplane_plane2_city1-2_city4-2,6713765,4,166,184,350,0
4_2017328,fly-airplane_plane2_city8-2_city4-2,2017328,4,166,184,350,0
4_7088515,fly-airplane_plane3_city4-2_city7-2,7088515,4,206,184,390,0
4_6826371,fly-airplane_plane3_city4-2_city3-2,6826371,4,206,184,390,0
4_7022979,fly-airplane_plane3_city4-2_city6-2,7022979,4,206,184,390,0
4_6760835,fly-airplane_plane3_city4-2_city2-2,6760835,4,206,184,390,0
4_7219587,fly-airplane_plane3_city4-2_city9-2,7219587,4,206,184,390,0
4_6957443,fly-airplane_plane3_city4-2_city5-2,6957443,4,206,184,390,0
4_1982844,fly-airplane_plane3_city4-2_city10-2,1982844,4,206,184,390,0
4_6695299,fly-airplane_plane3_city4-2_city1-2,6695299,4,206,184,390,0
4_7154051,fly-airplane_plane3_city4-2_city8-2,7154051,4,206,184,390,0
4_6022145,fly-airplane_plane3_city7-2_city4-2,6022145,4,211,184,395,0
4_1847843,fly-airplane_plane3_city3-2_city4-2,1847843,4,206,184,390,0
4_978081,fly-airplane_plane3_city6-2_city4-2,978081,4,206,184,390,0
4_4804756,fly-airplane_plane3_city2-2_city4-2,4804756,4,206,184,390,0
4_108319,fly-airplane_plane3_city9-2_city4-2,108319,4,206,184,390,0
4_3934994,fly-airplane_plane3_city5-2_city4-2,3934994,4,206,184,390,0
4_7761669,fly-airplane_plane3_city1-2_city4-2,7761669,4,206,184,390,0
4_3065232,fly-airplane_plane3_city8-2_city4-2,3065232,4,206,184,390,0
4_135442,fly-airplane_plane4_city4-2_city7-2,135442,4,166,184,350,0
4_7874275,fly-airplane_plane4_city4-2_city3-2,7874275,4,166,184,350,0
4_69906,fly-airplane_plane4_city4-2_city6-2,69906,4,166,184,350,0
4_7808739,fly-airplane_plane4_city4-2_city2-2,7808739,4,166,184,350,0
4_266514,fly-airplane_plane4_city4-2_city9-2,266514,4,166,184,350,0
4_4370,fly-airplane_plane4_city4-2_city5-2,4370,4,166,184,350,0
4_6214027,fly-airplane_plane4_city4-2_city10-2,6214027,4,166,184,350,0
4_7743203,fly-airplane_plane4_city4-2_city1-2,7743203,4,166,184,350,0
4_200978,fly-airplane_plane4_city4-2_city8-2,200978,4,166,184,350,0
4_7070049,fly-airplane_plane4_city7-2_city4-2,7070049,4,166,184,350,0
4_2895747,fly-airplane_plane4_city3-2_city4-2,2895747,4,166,184,350,0
4_2025985,fly-airplane_plane4_city6-2_city4-2,2025985,4,166,184,350,0
4_4982898,fly-airplane_plane4_city5-2_city4-2,4982898,4,166,184,350,0
4_411890,fly-airplane_plane4_city10-2_city4-2,411890,4,166,183,349,0
4_808596,fly-airplane_plane4_city1-2_city4-2,808596,4,166,184,350,0
4_4113136,fly-airplane_plane4_city8-2_city4-2,4113136,4,166,184,350,0
4_3507679,noop_at_truck9_city9-1,3507679,4,6,12,18,0
4_6461255,at_truck9_city9-2,6461255,4,3,10,13,0
4_5655766,noop_at_package4_city3-2,5655766,4,240,127,367,0
4_7213341,load-airplane_package4_plane1_city3-2,7213341,4,382,284,666,0
4_3419986,load-airplane_package4_plane2_city3-2,3419986,4,382,284,666,0
4_7627608,load-airplane_package4_plane3_city3-2,7627608,4,253,284,537,0
4_3834253,load-airplane_package4_plane4_city3-2,3834253,4,382,284,666,0
4_475401,load-truck_package4_truck3_city3-2,475401,4,248,134,382,0
4_3772549,at_package4_city7-2,3772549,4,24,30,54,0
4_5646948,in_package1_plane3,5646948,4,26,34,60,0
4_5040038,in_package4_truck7,5040038,4,17,27,44,0
4_2133322,in_package4_plane4,2133322,4,36,35,71,0
4_2133321,in_package4_plane3,2133321,4,34,35,69,0
4_2133320,in_package4_plane2,2133320,4,36,35,71,0
4_2133319,in_package4_plane1,2133319,4,37,35,72,0
4_962112,in_package5_plane3,962112,4,26,34,60,0
4_1199110,at_package4_city10-2,1199110,4,35,29,64,0
4_3692800,at_plane3_city10-2,3692800,4,35,20,55,0
4_5613107,noop_at_plane2_city4-2,5613107,4,157,175,332,0
4_827849,at_plane2_city8-2,827849,4,27,29,56,0
4_369097,at_plane2_city1-2,369097,4,27,29,56,0
4_631241,at_plane2_city5-2,631241,4,27,29,56,0
4_893385,at_plane2_city9-2,893385,4,27,29,56,0
4_434633,at_plane2_city2-2,434633,4,27,29,56,0
4_696777,at_plane2_city6-2,696777,4,27,29,56,0
4_500169,at_plane2_city3-2,500169,4,27,29,56,0
4_6673463,at_plane2_city10-2,6673463,4,27,28,55,0
4_762313,at_plane2_city7-2,762313,4,27,29,56,0
4_1688680,noop_at_plane3_city2-2,1688680,4,196,175,371,0
4_5001364,fly-airplane_plane3_city2-2_city7-2,5001364,4,206,184,390,0
4_4739220,fly-airplane_plane3_city2-2_city3-2,4739220,4,206,184,390,0
4_4935828,fly-airplane_plane3_city2-2_city6-2,4935828,4,206,184,390,0
4_5132436,fly-airplane_plane3_city2-2_city9-2,5132436,4,206,184,390,0
4_4870292,fly-airplane_plane3_city2-2_city5-2,4870292,4,206,184,390,0
4_3737647,fly-airplane_plane3_city2-2_city10-2,3737647,4,206,184,390,0
4_4608148,fly-airplane_plane3_city2-2_city1-2,4608148,4,206,184,390,0
4_5066900,fly-airplane_plane3_city2-2_city8-2,5066900,4,206,184,390,0
4_5536802,unload-airplane_package1_plane3_city2-2,5536802,4,247,282,529,0
4_7545233,unload-airplane_package3_plane3_city2-2,7545233,4,298,284,582,0
4_4548960,unload-airplane_package4_plane3_city2-2,4548960,4,248,284,532,0
4_1552687,unload-airplane_package5_plane3_city2-2,1552687,4,252,282,534,0
4_548937,load-airplane_package1_plane3_city2-2,548937,4,243,266,509,0
4_2557368,load-airplane_package3_plane3_city2-2,2557368,4,288,284,572,0
4_7562072,load-airplane_package4_plane3_city2-2,7562072,4,252,284,536,0
4_3507680,noop_at_truck9_city9-2,3507680,4,4,4,8,0
4_5107691,load-truck_package3_truck9_city9-2,5107691,4,114,131,245,0
4_2111418,load-truck_package4_truck9_city9-2,2111418,4,249,131,380,0
4_6461254,at_truck9_city9-1,6461254,4,3,4,7,0
4_1731339,noop_at_package5_city1-2,1731339,4,53,109,162,0
4_292641,load-airplane_package5_plane2_city1-2,292641,4,203,266,469,0
4_4500263,load-airplane_package5_plane3_city1-2,4500263,4,243,266,509,0
4_706908,load-airplane_package5_plane4_city1-2,706908,4,203,266,469,0
4_4934766,load-truck_package5_truck1_city1-2,4934766,4,60,113,173,0
4_962110,in_package5_plane1,962110,4,19,26,45,0
4_962111,in_package5_plane2,962111,4,18,26,44,0
4_962113,in_package5_plane4,962113,4,18,26,44,0
4_3868823,in_package5_truck1,3868823,4,8,18,26,0
4_2991081,noop_in-city_city3-1_city3,2991081,4,1,1,2,0
4_5371146,drive-truck_truck3_city3-1_city3-2_city3,5371146,4,14,14,28,0
4_2613681,drive-truck_truck3_city3-2_city3-1_city3,2613681,4,14,14,28,0
4_2147432,noop_at_plane3_city9-2,2147432,4,197,175,372,0
4_304927,fly-airplane_plane3_city9-2_city7-2,304927,4,206,184,390,0
4_42783,fly-airplane_plane3_city9-2_city3-2,42783,4,206,184,390,0
4_239391,fly-airplane_plane3_city9-2_city6-2,239391,4,206,184,390,0
4_7978224,fly-airplane_plane3_city9-2_city2-2,7978224,4,206,184,390,0
4_173855,fly-airplane_plane3_city9-2_city5-2,173855,4,206,184,390,0
4_1596325,fly-airplane_plane3_city9-2_city10-2,1596325,4,206,184,390,0
4_7912688,fly-airplane_plane3_city9-2_city1-2,7912688,4,206,184,390,0
4_370463,fly-airplane_plane3_city9-2_city8-2,370463,4,206,184,390,0
4_5995554,unload-airplane_package1_plane3_city9-2,5995554,4,253,282,535,0
4_3008,unload-airplane_package3_plane3_city9-2,3008,4,299,284,583,0
4_5007712,unload-airplane_package4_plane3_city9-2,5007712,4,249,284,533,0
4_2011439,unload-airplane_package5_plane3_city9-2,2011439,4,253,282,535,0
4_3016120,load-airplane_package3_plane3_city9-2,3016120,4,289,284,573,0
4_19847,load-airplane_package4_plane3_city9-2,19847,4,255,284,539,0
4_6690159,noop_at_truck6_city6-1,6690159,4,6,12,18,0
4_1298643,drive-truck_truck6_city6-1_city6-2_city6,1298643,4,12,13,25,0
4_1642758,at_truck6_city6-2,1642758,4,3,10,13,0
4_968341,noop_at_package1_city2-2,968341,4,53,109,162,0
4_134670,load-airplane_package1_plane1_city2-2,134670,4,203,266,469,0
4_4342292,load-airplane_package1_plane2_city2-2,4342292,4,203,266,469,0
4_5191062,load-truck_package1_truck2_city2-2,5191062,4,60,113,173,0
4_5646949,in_package1_plane4,5646949,4,18,26,44,0
4_5646947,in_package1_plane2,5646947,4,18,26,44,0
4_5646946,in_package1_plane1,5646946,4,19,26,45,0
4_552683,in_package1_truck2,552683,4,8,18,26,0
4_6092910,noop_at_plane4_city5-2,6092910,4,157,175,332,0
4_5179506,fly-airplane_plane4_city5-2_city7-2,5179506,4,166,184,350,0
4_4917362,fly-airplane_plane4_city5-2_city3-2,4917362,4,166,184,350,0
4_5113970,fly-airplane_plane4_city5-2_city6-2,5113970,4,166,184,350,0
4_4851826,fly-airplane_plane4_city5-2_city2-2,4851826,4,166,184,350,0
4_5310578,fly-airplane_plane4_city5-2_city9-2,5310578,4,166,184,350,0
4_1336137,fly-airplane_plane4_city5-2_city10-2,1336137,4,166,184,350,0
4_4786290,fly-airplane_plane4_city5-2_city1-2,4786290,4,166,184,350,0
4_5245042,fly-airplane_plane4_city5-2_city8-2,5245042,4,166,184,350,0
4_1940055,unload-airplane_package1_plane4_city5-2,1940055,4,207,266,473,0
4_3948486,unload-airplane_package3_plane4_city5-2,3948486,4,249,284,533,0
4_952213,unload-airplane_package4_plane4_city5-2,952213,4,253,284,537,0
4_5956917,unload-airplane_package5_plane4_city5-2,5956917,4,207,266,473,0
4_6961598,load-airplane_package3_plane4_city5-2,6961598,4,249,284,533,0
4_3965325,load-airplane_package4_plane4_city5-2,3965325,4,384,284,668,0
4_6690160,noop_at_truck6_city6-2,6690160,4,4,4,8,0
4_6542155,drive-truck_truck6_city6-2_city6-1_city6,6542155,4,12,11,23,0
4_289194,load-truck_package3_truck6_city6-2,289194,4,114,131,245,0
4_5293898,load-truck_package4_truck6_city6-2,5293898,4,249,131,380,0
4_1642757,at_truck6_city6-1,1642757,4,3,6,9,0
4_3035792,noop_location_city7-1,3035792,4,1,1,2,0
4_7942119,drive-truck_truck7_city7-1_city7-2_city7,7942119,4,14,14,28,0
4_5184654,drive-truck_truck7_city7-2_city7-1_city7,5184654,4,14,14,28,0
4_808230,unload-truck_package4_truck7_city7-1,808230,4,115,136,251,0
4_3035793,noop_location_city7-2,3035793,4,1,1,2,0
4_5450215,unload-airplane_package1_plane1_city7-2,5450215,4,209,266,475,0
4_1656860,unload-airplane_package1_plane2_city7-2,1656860,4,207,266,473,0
4_5864482,unload-airplane_package1_plane3_city7-2,5864482,4,252,282,534,0
4_2071127,unload-airplane_package1_plane4_city7-2,2071127,4,207,266,473,0
4_7458646,unload-airplane_package3_plane1_city7-2,7458646,4,255,284,539,0
4_3665291,unload-airplane_package3_plane2_city7-2,3665291,4,249,284,533,0
4_7872913,unload-airplane_package3_plane3_city7-2,7872913,4,298,284,582,0
4_4079558,unload-airplane_package3_plane4_city7-2,4079558,4,249,284,533,0
4_4462373,unload-airplane_package4_plane1_city7-2,4462373,4,255,284,539,0
4_669018,unload-airplane_package4_plane2_city7-2,669018,4,253,284,537,0
4_4876640,unload-airplane_package4_plane3_city7-2,4876640,4,249,284,533,0
4_1083285,unload-airplane_package4_plane4_city7-2,1083285,4,253,284,537,0
4_1466100,unload-airplane_package5_plane1_city7-2,1466100,4,209,266,475,0
4_5673722,unload-airplane_package5_plane2_city7-2,5673722,4,207,266,473,0
4_1880367,unload-airplane_package5_plane3_city7-2,1880367,4,252,282,534,0
4_6087989,unload-airplane_package5_plane4_city7-2,6087989,4,207,266,473,0
4_808231,unload-truck_package4_truck7_city7-2,808231,4,114,131,245,0
4_7475485,load-airplane_package4_plane1_city7-2,7475485,4,249,284,533,0
4_3682130,load-airplane_package4_plane2_city7-2,3682130,4,249,284,533,0
4_7889752,load-airplane_package4_plane3_city7-2,7889752,4,249,284,533,0
4_4096397,load-airplane_package4_plane4_city7-2,4096397,4,249,284,533,0
4_1566079,load-truck_package4_truck7_city7-2,1566079,4,114,131,245,0
4_6345090,noop_at_package4_city10-2,6345090,4,241,127,368,0
4_5035440,load-airplane_package4_plane1_city10-2,5035440,4,382,281,663,0
4_2054777,load-airplane_package4_plane2_city10-2,2054777,4,382,281,663,0
4_4094428,load-airplane_package4_plane4_city10-2,4094428,4,382,281,663,0
4_7866348,load-truck_package4_truck10_city10-2,7866348,4,250,133,383,0
4_1405485,noop_at_plane1_city4-2,1405485,4,157,175,332,0
4_5018863,noop_airplane_plane1,5018863,4,1,1,2,0
4_3860801,fly-airplane_plane1_city7-2_city3-2,3860801,4,166,184,350,0
4_4057409,fly-airplane_plane1_city7-2_city6-2,4057409,4,166,184,350,0
4_3795265,fly-airplane_plane1_city7-2_city2-2,3795265,4,166,184,350,0
4_4254017,fly-airplane_plane1_city7-2_city9-2,4254017,4,166,184,350,0
4_3991873,fly-airplane_plane1_city7-2_city5-2,3991873,4,166,184,350,0
4_2889739,fly-airplane_plane1_city7-2_city10-2,2889739,4,166,184,350,0
4_3729729,fly-airplane_plane1_city7-2_city1-2,3729729,4,166,184,350,0
4_4188481,fly-airplane_plane1_city7-2_city8-2,4188481,4,166,184,350,0
4_7949620,fly-airplane_plane1_city3-2_city7-2,7949620,4,166,184,350,0
4_7884084,fly-airplane_plane1_city3-2_city6-2,7884084,4,166,184,350,0
4_7621940,fly-airplane_plane1_city3-2_city2-2,7621940,4,166,184,350,0
4_79715,fly-airplane_plane1_city3-2_city9-2,79715,4,166,184,350,0
4_7818548,fly-airplane_plane1_city3-2_city5-2,7818548,4,166,184,350,0
4_6399345,fly-airplane_plane1_city3-2_city10-2,6399345,4,166,184,350,0
4_7556404,fly-airplane_plane1_city3-2_city1-2,7556404,4,166,184,350,0
4_14179,fly-airplane_plane1_city3-2_city8-2,14179,4,166,184,350,0
4_7079858,fly-airplane_plane1_city6-2_city7-2,7079858,4,166,184,350,0
4_6817714,fly-airplane_plane1_city6-2_city3-2,6817714,4,166,184,350,0
4_6752178,fly-airplane_plane1_city6-2_city2-2,6752178,4,166,184,350,0
4_7210930,fly-airplane_plane1_city6-2_city9-2,7210930,4,166,184,350,0
4_6948786,fly-airplane_plane1_city6-2_city5-2,6948786,4,166,184,350,0
4_7767629,fly-airplane_plane1_city6-2_city10-2,7767629,4,166,184,350,0
4_6686642,fly-airplane_plane1_city6-2_city1-2,6686642,4,166,184,350,0
4_7145394,fly-airplane_plane1_city6-2_city8-2,7145394,4,166,184,350,0
4_2905556,fly-airplane_plane1_city2-2_city7-2,2905556,4,166,184,350,0
4_2643412,fly-airplane_plane1_city2-2_city3-2,2643412,4,166,184,350,0
4_2840020,fly-airplane_plane1_city2-2_city6-2,2840020,4,166,184,350,0
4_3036628,fly-airplane_plane1_city2-2_city9-2,3036628,4,166,184,350,0
4_2774484,fly-airplane_plane1_city2-2_city5-2,2774484,4,166,184,350,0
4_3276258,fly-airplane_plane1_city2-2_city10-2,3276258,4,166,184,350,0
4_2512340,fly-airplane_plane1_city2-2_city1-2,2512340,4,166,184,350,0
4_2971092,fly-airplane_plane1_city2-2_city8-2,2971092,4,166,184,350,0
4_6210096,fly-airplane_plane1_city9-2_city7-2,6210096,4,166,184,350,0
4_5947952,fly-airplane_plane1_city9-2_city3-2,5947952,4,166,184,350,0
4_6144560,fly-airplane_plane1_city9-2_city6-2,6144560,4,166,184,350,0
4_5882416,fly-airplane_plane1_city9-2_city2-2,5882416,4,166,184,350,0
4_6079024,fly-airplane_plane1_city9-2_city5-2,6079024,4,166,184,350,0
4_1134936,fly-airplane_plane1_city9-2_city10-2,1134936,4,166,184,350,0
4_5816880,fly-airplane_plane1_city9-2_city1-2,5816880,4,166,184,350,0
4_6275632,fly-airplane_plane1_city9-2_city8-2,6275632,4,166,184,350,0
4_2035794,fly-airplane_plane1_city5-2_city7-2,2035794,4,166,184,350,0
4_1773650,fly-airplane_plane1_city5-2_city3-2,1773650,4,166,184,350,0
4_1970258,fly-airplane_plane1_city5-2_city6-2,1970258,4,166,184,350,0
4_1708114,fly-airplane_plane1_city5-2_city2-2,1708114,4,166,184,350,0
4_2166866,fly-airplane_plane1_city5-2_city9-2,2166866,4,166,184,350,0
4_4644542,fly-airplane_plane1_city5-2_city10-2,4644542,4,166,184,350,0
4_1642578,fly-airplane_plane1_city5-2_city1-2,1642578,4,166,184,350,0
4_2101330,fly-airplane_plane1_city5-2_city8-2,2101330,4,166,184,350,0
4_3916903,fly-airplane_plane1_city10-2_city7-2,3916903,4,166,183,349,0
4_3654759,fly-airplane_plane1_city10-2_city3-2,3654759,4,166,183,349,0
4_3851367,fly-airplane_plane1_city10-2_city6-2,3851367,4,166,183,349,0
4_3589223,fly-airplane_plane1_city10-2_city2-2,3589223,4,166,183,349,0
4_4047975,fly-airplane_plane1_city10-2_city9-2,4047975,4,166,183,349,0
4_3785831,fly-airplane_plane1_city10-2_city5-2,3785831,4,166,183,349,0
4_3523687,fly-airplane_plane1_city10-2_city1-2,3523687,4,166,183,349,0
4_3982439,fly-airplane_plane1_city10-2_city8-2,3982439,4,166,183,349,0
4_5188071,unload-airplane_package1_plane1_city3-2,5188071,4,209,266,475,0
4_5384679,unload-airplane_package1_plane1_city6-2,5384679,4,209,266,475,0
4_5122535,unload-airplane_package1_plane1_city2-2,5122535,4,209,266,475,0
4_5581287,unload-airplane_package1_plane1_city9-2,5581287,4,209,266,475,0
4_5319143,unload-airplane_package1_plane1_city5-2,5319143,4,209,266,475,0
4_6629825,unload-airplane_package1_plane1_city10-2,6629825,4,208,263,471,0
4_7196502,unload-airplane_package3_plane1_city3-2,7196502,4,255,284,539,0
4_7393110,unload-airplane_package3_plane1_city6-2,7393110,4,255,284,539,0
4_7130966,unload-airplane_package3_plane1_city2-2,7130966,4,254,284,538,0
4_7589718,unload-airplane_package3_plane1_city9-2,7589718,4,255,284,539,0
4_7327574,unload-airplane_package3_plane1_city5-2,7327574,4,255,284,539,0
4_724656,unload-airplane_package3_plane1_city10-2,724656,4,254,281,535,0
4_4200229,unload-airplane_package4_plane1_city3-2,4200229,4,255,284,539,0
4_4396837,unload-airplane_package4_plane1_city6-2,4396837,4,255,284,539,0
4_4134693,unload-airplane_package4_plane1_city2-2,4134693,4,254,284,538,0
4_4593445,unload-airplane_package4_plane1_city9-2,4593445,4,255,284,539,0
4_4331301,unload-airplane_package4_plane1_city5-2,4331301,4,255,284,539,0
4_1772560,unload-airplane_package4_plane1_city10-2,1772560,4,254,281,535,0
4_1203956,unload-airplane_package5_plane1_city3-2,1203956,4,209,266,475,0
4_1400564,unload-airplane_package5_plane1_city6-2,1400564,4,209,266,475,0
4_1138420,unload-airplane_package5_plane1_city2-2,1138420,4,208,266,474,0
4_1597172,unload-airplane_package5_plane1_city9-2,1597172,4,209,266,475,0
4_1335028,unload-airplane_package5_plane1_city5-2,1335028,4,209,266,475,0
4_2820464,unload-airplane_package5_plane1_city10-2,2820464,4,208,263,471,0
4_2939632,load-airplane_package2_plane1_city10-2,2939632,4,172,191,363,0
4_2208637,load-airplane_package3_plane1_city3-2,2208637,4,249,284,533,0
4_2405245,load-airplane_package3_plane1_city6-2,2405245,4,249,284,533,0
4_2143101,load-airplane_package3_plane1_city2-2,2143101,4,248,284,532,0
4_2601853,load-airplane_package3_plane1_city9-2,2601853,4,249,284,533,0
4_2339709,load-airplane_package3_plane1_city5-2,2339709,4,249,284,533,0
4_3987536,load-airplane_package3_plane1_city10-2,3987536,4,248,281,529,0
4_7409949,load-airplane_package4_plane1_city6-2,7409949,4,384,284,668,0
4_7147805,load-airplane_package4_plane1_city2-2,7147805,4,380,284,664,0
4_7606557,load-airplane_package4_plane1_city9-2,7606557,4,384,284,668,0
4_7344413,load-airplane_package4_plane1_city5-2,7344413,4,384,284,668,0
4_767485,noop_in-city_city3-2_city3,767485,4,1,1,2,0
4_1448144,noop_at_package3_city3-2,1448144,4,107,127,234,0
4_6416259,load-airplane_package3_plane2_city3-2,6416259,4,249,284,533,0
4_2622904,load-airplane_package3_plane3_city3-2,2622904,4,289,284,573,0
4_6830526,load-airplane_package3_plane4_city3-2,6830526,4,249,284,533,0
4_3471674,load-truck_package3_truck3_city3-2,3471674,4,114,131,245,0
4_7565904,at_package3_city7-2,7565904,4,23,8,31,0
4_4939725,noop_in_package5_plane1,4939725,4,86,109,195,0
4_7586955,at_package5_city1-2,7586955,4,15,20,35,0
4_1281200,noop_city_city10,1281200,4,1,1,2,0
4_5018864,noop_airplane_plane2,5018864,4,1,1,2,0
4_4908705,fly-airplane_plane2_city7-2_city3-2,4908705,4,166,184,350,0
4_5105313,fly-airplane_plane2_city7-2_city6-2,5105313,4,166,184,350,0
4_4843169,fly-airplane_plane2_city7-2_city2-2,4843169,4,166,184,350,0
4_5301921,fly-airplane_plane2_city7-2_city9-2,5301921,4,166,184,350,0
4_5039777,fly-airplane_plane2_city7-2_city5-2,5039777,4,166,184,350,0
4_7120922,fly-airplane_plane2_city7-2_city10-2,7120922,4,166,184,350,0
4_4777633,fly-airplane_plane2_city7-2_city1-2,4777633,4,166,184,350,0
4_5236385,fly-airplane_plane2_city7-2_city8-2,5236385,4,166,184,350,0
4_996547,fly-airplane_plane2_city3-2_city7-2,996547,4,166,184,350,0
4_931011,fly-airplane_plane2_city3-2_city6-2,931011,4,166,184,350,0
4_668867,fly-airplane_plane2_city3-2_city2-2,668867,4,166,184,350,0
4_1127619,fly-airplane_plane2_city3-2_city9-2,1127619,4,166,184,350,0
4_865475,fly-airplane_plane2_city3-2_city5-2,865475,4,166,184,350,0
4_2629551,fly-airplane_plane2_city3-2_city10-2,2629551,4,166,184,350,0
4_603331,fly-airplane_plane2_city3-2_city1-2,603331,4,166,184,350,0
4_1062083,fly-airplane_plane2_city3-2_city8-2,1062083,4,166,184,350,0
4_126785,fly-airplane_plane2_city6-2_city7-2,126785,4,166,184,350,0
4_7865618,fly-airplane_plane2_city6-2_city3-2,7865618,4,166,184,350,0
4_7800082,fly-airplane_plane2_city6-2_city2-2,7800082,4,166,184,350,0
4_257857,fly-airplane_plane2_city6-2_city9-2,257857,4,166,184,350,0
4_7996690,fly-airplane_plane2_city6-2_city5-2,7996690,4,166,184,350,0
4_3997835,fly-airplane_plane2_city6-2_city10-2,3997835,4,166,184,350,0
4_7734546,fly-airplane_plane2_city6-2_city1-2,7734546,4,166,184,350,0
4_192321,fly-airplane_plane2_city6-2_city8-2,192321,4,166,184,350,0
4_3953460,fly-airplane_plane2_city2-2_city7-2,3953460,4,166,184,350,0
4_3691316,fly-airplane_plane2_city2-2_city3-2,3691316,4,166,184,350,0
4_3887924,fly-airplane_plane2_city2-2_city6-2,3887924,4,166,184,350,0
4_4084532,fly-airplane_plane2_city2-2_city9-2,4084532,4,166,184,350,0
4_3822388,fly-airplane_plane2_city2-2_city5-2,3822388,4,166,184,350,0
4_7507441,fly-airplane_plane2_city2-2_city10-2,7507441,4,166,184,350,0
4_3560244,fly-airplane_plane2_city2-2_city1-2,3560244,4,166,184,350,0
4_4018996,fly-airplane_plane2_city2-2_city8-2,4018996,4,166,184,350,0
4_7258000,fly-airplane_plane2_city9-2_city7-2,7258000,4,166,184,350,0
4_6995856,fly-airplane_plane2_city9-2_city3-2,6995856,4,166,184,350,0
4_7192464,fly-airplane_plane2_city9-2_city6-2,7192464,4,166,184,350,0
4_6930320,fly-airplane_plane2_city9-2_city2-2,6930320,4,166,184,350,0
4_7126928,fly-airplane_plane2_city9-2_city5-2,7126928,4,166,184,350,0
4_5366119,fly-airplane_plane2_city9-2_city10-2,5366119,4,166,184,350,0
4_6864784,fly-airplane_plane2_city9-2_city1-2,6864784,4,166,184,350,0
4_7323536,fly-airplane_plane2_city9-2_city8-2,7323536,4,166,184,350,0
4_3083698,fly-airplane_plane2_city5-2_city7-2,3083698,4,166,184,350,0
4_2821554,fly-airplane_plane2_city5-2_city3-2,2821554,4,166,184,350,0
4_3018162,fly-airplane_plane2_city5-2_city6-2,3018162,4,166,184,350,0
4_2756018,fly-airplane_plane2_city5-2_city2-2,2756018,4,166,184,350,0
4_3214770,fly-airplane_plane2_city5-2_city9-2,3214770,4,166,184,350,0
4_874748,fly-airplane_plane2_city5-2_city10-2,874748,4,166,184,350,0
4_2690482,fly-airplane_plane2_city5-2_city1-2,2690482,4,166,184,350,0
4_3149234,fly-airplane_plane2_city5-2_city8-2,3149234,4,166,184,350,0
4_147109,fly-airplane_plane2_city10-2_city7-2,147109,4,166,183,349,0
4_7885942,fly-airplane_plane2_city10-2_city3-2,7885942,4,166,183,349,0
4_81573,fly-airplane_plane2_city10-2_city6-2,81573,4,166,183,349,0
4_7820406,fly-airplane_plane2_city10-2_city2-2,7820406,4,166,183,349,0
4_278181,fly-airplane_plane2_city10-2_city9-2,278181,4,166,183,349,0
4_16037,fly-airplane_plane2_city10-2_city5-2,16037,4,166,183,349,0
4_7754870,fly-airplane_plane2_city10-2_city1-2,7754870,4,166,183,349,0
4_212645,fly-airplane_plane2_city10-2_city8-2,212645,4,166,183,349,0
4_6910373,fly-airplane_plane2_city1-2_city7-2,6910373,4,166,184,350,0
4_6648229,fly-airplane_plane2_city1-2_city3-2,6648229,4,166,184,350,0
4_6844837,fly-airplane_plane2_city1-2_city6-2,6844837,4,166,184,350,0
4_6582693,fly-airplane_plane2_city1-2_city2-2,6582693,4,166,184,350,0
4_7041445,fly-airplane_plane2_city1-2_city9-2,7041445,4,166,184,350,0
4_6779301,fly-airplane_plane2_city1-2_city5-2,6779301,4,166,184,350,0
4_4384354,fly-airplane_plane2_city1-2_city10-2,4384354,4,166,184,350,0
4_6975909,fly-airplane_plane2_city1-2_city8-2,6975909,4,166,184,350,0
4_2213936,fly-airplane_plane2_city8-2_city7-2,2213936,4,166,184,350,0
4_1951792,fly-airplane_plane2_city8-2_city3-2,1951792,4,166,184,350,0
4_2148400,fly-airplane_plane2_city8-2_city6-2,2148400,4,166,184,350,0
4_1886256,fly-airplane_plane2_city8-2_city2-2,1886256,4,166,184,350,0
4_2345008,fly-airplane_plane2_city8-2_city9-2,2345008,4,166,184,350,0
4_2082864,fly-airplane_plane2_city8-2_city5-2,2082864,4,166,184,350,0
4_2243032,fly-airplane_plane2_city8-2_city10-2,2243032,4,166,184,350,0
4_1820720,fly-airplane_plane2_city8-2_city1-2,1820720,4,166,184,350,0
4_1394716,unload-airplane_package1_plane2_city3-2,1394716,4,207,266,473,0
4_1591324,unload-airplane_package1_plane2_city6-2,1591324,4,207,266,473,0
4_1329180,unload-airplane_package1_plane2_city2-2,1329180,4,207,266,473,0
4_1787932,unload-airplane_package1_plane2_city9-2,1787932,4,207,266,473,0
4_1525788,unload-airplane_package1_plane2_city5-2,1525788,4,207,266,473,0
4_1263644,unload-airplane_package1_plane2_city1-2,1263644,4,206,266,472,0
4_1722396,unload-airplane_package1_plane2_city8-2,1722396,4,207,266,473,0
4_3649162,unload-airplane_package1_plane2_city10-2,3649162,4,206,263,469,0
4_3403147,unload-airplane_package3_plane2_city3-2,3403147,4,249,284,533,0
4_3599755,unload-airplane_package3_plane2_city6-2,3599755,4,249,284,533,0
4_3337611,unload-airplane_package3_plane2_city2-2,3337611,4,248,284,532,0
4_3796363,unload-airplane_package3_plane2_city9-2,3796363,4,249,284,533,0
4_3534219,unload-airplane_package3_plane2_city5-2,3534219,4,249,284,533,0
4_3272075,unload-airplane_package3_plane2_city1-2,3272075,4,248,284,532,0
4_3730827,unload-airplane_package3_plane2_city8-2,3730827,4,249,284,533,0
4_5744970,unload-airplane_package3_plane2_city10-2,5744970,4,248,281,529,0
4_406874,unload-airplane_package4_plane2_city3-2,406874,4,253,284,537,0
4_603482,unload-airplane_package4_plane2_city6-2,603482,4,253,284,537,0
4_341338,unload-airplane_package4_plane2_city2-2,341338,4,252,284,536,0
4_800090,unload-airplane_package4_plane2_city9-2,800090,4,253,284,537,0
4_537946,unload-airplane_package4_plane2_city5-2,537946,4,253,284,537,0
4_275802,unload-airplane_package4_plane2_city1-2,275802,4,252,284,536,0
4_734554,unload-airplane_package4_plane2_city8-2,734554,4,253,284,537,0
4_6792874,unload-airplane_package4_plane2_city10-2,6792874,4,252,281,533,0
4_5411578,unload-airplane_package5_plane2_city3-2,5411578,4,207,266,473,0
4_5608186,unload-airplane_package5_plane2_city6-2,5608186,4,207,266,473,0
4_5346042,unload-airplane_package5_plane2_city2-2,5346042,4,206,266,472,0
4_5804794,unload-airplane_package5_plane2_city9-2,5804794,4,207,266,473,0
4_5542650,unload-airplane_package5_plane2_city5-2,5542650,4,207,266,473,0
4_5280506,unload-airplane_package5_plane2_city1-2,5280506,4,207,266,473,0
4_5739258,unload-airplane_package5_plane2_city8-2,5739258,4,207,266,473,0
4_7840778,unload-airplane_package5_plane2_city10-2,7840778,4,206,263,469,0
4_7959946,load-airplane_package2_plane2_city10-2,7959946,4,172,191,363,0
4_6612867,load-airplane_package3_plane2_city6-2,6612867,4,249,284,533,0
4_6350723,load-airplane_package3_plane2_city2-2,6350723,4,248,284,532,0
4_6809475,load-airplane_package3_plane2_city9-2,6809475,4,249,284,533,0
4_6547331,load-airplane_package3_plane2_city5-2,6547331,4,249,284,533,0
4_6285187,load-airplane_package3_plane2_city1-2,6285187,4,248,284,532,0
4_6743939,load-airplane_package3_plane2_city8-2,6743939,4,249,284,533,0
4_1006873,load-airplane_package3_plane2_city10-2,1006873,4,248,281,529,0
4_3616594,load-airplane_package4_plane2_city6-2,3616594,4,384,284,668,0
4_3354450,load-airplane_package4_plane2_city2-2,3354450,4,380,284,664,0
4_3813202,load-airplane_package4_plane2_city9-2,3813202,4,384,284,668,0
4_3551058,load-airplane_package4_plane2_city5-2,3551058,4,384,284,668,0
4_3288914,load-airplane_package4_plane2_city1-2,3288914,4,380,284,664,0
4_3747666,load-airplane_package4_plane2_city8-2,3747666,4,384,284,668,0
4_4939726,noop_in_package5_plane2,4939726,4,75,109,184,0
4_5018865,noop_airplane_plane3,5018865,4,1,1,2,0
4_5956609,fly-airplane_plane3_city7-2_city3-2,5956609,4,211,184,395,0
4_6153217,fly-airplane_plane3_city7-2_city6-2,6153217,4,211,184,395,0
4_5891073,fly-airplane_plane3_city7-2_city2-2,5891073,4,211,184,395,0
4_6349825,fly-airplane_plane3_city7-2_city9-2,6349825,4,211,184,395,0
4_6087681,fly-airplane_plane3_city7-2_city5-2,6087681,4,211,184,395,0
4_3351128,fly-airplane_plane3_city7-2_city10-2,3351128,4,211,184,395,0
4_5825537,fly-airplane_plane3_city7-2_city1-2,5825537,4,211,184,395,0
4_6284289,fly-airplane_plane3_city7-2_city8-2,6284289,4,211,184,395,0
4_2044451,fly-airplane_plane3_city3-2_city7-2,2044451,4,206,184,390,0
4_1978915,fly-airplane_plane3_city3-2_city6-2,1978915,4,206,184,390,0
4_1716771,fly-airplane_plane3_city3-2_city2-2,1716771,4,206,184,390,0
4_2175523,fly-airplane_plane3_city3-2_city9-2,2175523,4,206,184,390,0
4_1913379,fly-airplane_plane3_city3-2_city5-2,1913379,4,206,184,390,0
4_6860734,fly-airplane_plane3_city3-2_city10-2,6860734,4,206,184,390,0
4_1651235,fly-airplane_plane3_city3-2_city1-2,1651235,4,206,184,390,0
4_2109987,fly-airplane_plane3_city3-2_city8-2,2109987,4,206,184,390,0
4_1174689,fly-airplane_plane3_city6-2_city7-2,1174689,4,206,184,390,0
4_912545,fly-airplane_plane3_city6-2_city3-2,912545,4,206,184,390,0
4_847009,fly-airplane_plane3_city6-2_city2-2,847009,4,206,184,390,0
4_1305761,fly-airplane_plane3_city6-2_city9-2,1305761,4,206,184,390,0
4_1043617,fly-airplane_plane3_city6-2_city5-2,1043617,4,206,184,390,0
4_228041,fly-airplane_plane3_city6-2_city10-2,228041,4,206,184,390,0
4_781473,fly-airplane_plane3_city6-2_city1-2,781473,4,206,184,390,0
4_1240225,fly-airplane_plane3_city6-2_city8-2,1240225,4,206,184,390,0
4_4131602,fly-airplane_plane3_city5-2_city7-2,4131602,4,206,184,390,0
4_3869458,fly-airplane_plane3_city5-2_city3-2,3869458,4,206,184,390,0
4_4066066,fly-airplane_plane3_city5-2_city6-2,4066066,4,206,184,390,0
4_3803922,fly-airplane_plane3_city5-2_city2-2,3803922,4,206,184,390,0
4_4262674,fly-airplane_plane3_city5-2_city9-2,4262674,4,206,184,390,0
4_5105931,fly-airplane_plane3_city5-2_city10-2,5105931,4,206,184,390,0
4_3738386,fly-airplane_plane3_city5-2_city1-2,3738386,4,206,184,390,0
4_4197138,fly-airplane_plane3_city5-2_city8-2,4197138,4,206,184,390,0
4_7958277,fly-airplane_plane3_city1-2_city7-2,7958277,4,206,184,390,0
4_7696133,fly-airplane_plane3_city1-2_city3-2,7696133,4,206,184,390,0
4_7892741,fly-airplane_plane3_city1-2_city6-2,7892741,4,206,184,390,0
4_7630597,fly-airplane_plane3_city1-2_city2-2,7630597,4,206,184,390,0
4_88372,fly-airplane_plane3_city1-2_city9-2,88372,4,206,184,390,0
4_7827205,fly-airplane_plane3_city1-2_city5-2,7827205,4,206,184,390,0
4_614560,fly-airplane_plane3_city1-2_city10-2,614560,4,206,184,390,0
4_22836,fly-airplane_plane3_city1-2_city8-2,22836,4,206,184,390,0
4_3261840,fly-airplane_plane3_city8-2_city7-2,3261840,4,206,184,390,0
4_2999696,fly-airplane_plane3_city8-2_city3-2,2999696,4,206,184,390,0
4_3196304,fly-airplane_plane3_city8-2_city6-2,3196304,4,206,184,390,0
4_2934160,fly-airplane_plane3_city8-2_city2-2,2934160,4,206,184,390,0
4_3392912,fly-airplane_plane3_city8-2_city9-2,3392912,4,206,184,390,0
4_3130768,fly-airplane_plane3_city8-2_city5-2,3130768,4,206,184,390,0
4_6474215,fly-airplane_plane3_city8-2_city10-2,6474215,4,206,184,390,0
4_2868624,fly-airplane_plane3_city8-2_city1-2,2868624,4,206,184,390,0
4_5602338,unload-airplane_package1_plane3_city3-2,5602338,4,253,282,535,0
4_5798946,unload-airplane_package1_plane3_city6-2,5798946,4,253,282,535,0
4_5733410,unload-airplane_package1_plane3_city5-2,5733410,4,253,282,535,0
4_5471266,unload-airplane_package1_plane3_city1-2,5471266,4,252,282,534,0
4_5930018,unload-airplane_package1_plane3_city8-2,5930018,4,253,282,535,0
4_7610769,unload-airplane_package3_plane3_city3-2,7610769,4,293,284,577,0
4_7807377,unload-airplane_package3_plane3_city6-2,7807377,4,299,284,583,0
4_7741841,unload-airplane_package3_plane3_city5-2,7741841,4,299,284,583,0
4_7479697,unload-airplane_package3_plane3_city1-2,7479697,4,298,284,582,0
4_7938449,unload-airplane_package3_plane3_city8-2,7938449,4,299,284,583,0
4_4614496,unload-airplane_package4_plane3_city3-2,4614496,4,249,284,533,0
4_4811104,unload-airplane_package4_plane3_city6-2,4811104,4,249,284,533,0
4_4745568,unload-airplane_package4_plane3_city5-2,4745568,4,249,284,533,0
4_4483424,unload-airplane_package4_plane3_city1-2,4483424,4,248,284,532,0
4_4942176,unload-airplane_package4_plane3_city8-2,4942176,4,249,284,533,0
4_1618223,unload-airplane_package5_plane3_city3-2,1618223,4,253,282,535,0
4_1814831,unload-airplane_package5_plane3_city6-2,1814831,4,253,282,535,0
4_1749295,unload-airplane_package5_plane3_city5-2,1749295,4,253,282,535,0
4_1487151,unload-airplane_package5_plane3_city1-2,1487151,4,247,282,529,0
4_1945903,unload-airplane_package5_plane3_city8-2,1945903,4,253,282,535,0
4_2819512,load-airplane_package3_plane3_city6-2,2819512,4,289,284,573,0
4_2753976,load-airplane_package3_plane3_city5-2,2753976,4,289,284,573,0
4_2491832,load-airplane_package3_plane3_city1-2,2491832,4,288,284,572,0
4_2950584,load-airplane_package3_plane3_city8-2,2950584,4,289,284,573,0
4_7824216,load-airplane_package4_plane3_city6-2,7824216,4,255,284,539,0
4_7758680,load-airplane_package4_plane3_city5-2,7758680,4,255,284,539,0
4_7496536,load-airplane_package4_plane3_city1-2,7496536,4,252,284,536,0
4_7955288,load-airplane_package4_plane3_city8-2,7955288,4,255,284,539,0
4_1823615,noop_airport_city7-2,1823615,4,1,1,2,0
4_7004513,fly-airplane_plane4_city7-2_city3-2,7004513,4,166,184,350,0
4_7201121,fly-airplane_plane4_city7-2_city6-2,7201121,4,166,184,350,0
4_6938977,fly-airplane_plane4_city7-2_city2-2,6938977,4,166,184,350,0
4_7397729,fly-airplane_plane4_city7-2_city9-2,7397729,4,166,184,350,0
4_7135585,fly-airplane_plane4_city7-2_city5-2,7135585,4,166,184,350,0
4_7582311,fly-airplane_plane4_city7-2_city10-2,7582311,4,166,184,350,0
4_6873441,fly-airplane_plane4_city7-2_city1-2,6873441,4,166,184,350,0
4_7332193,fly-airplane_plane4_city7-2_city8-2,7332193,4,166,184,350,0
4_3092355,fly-airplane_plane4_city3-2_city7-2,3092355,4,166,184,350,0
4_2222593,fly-airplane_plane4_city6-2_city7-2,2222593,4,166,184,350,0
4_608498,fly-airplane_plane4_city10-2_city7-2,608498,4,166,183,349,0
4_1005204,fly-airplane_plane4_city1-2_city7-2,1005204,4,166,184,350,0
4_4309744,fly-airplane_plane4_city8-2_city7-2,4309744,4,166,184,350,0
4_4939727,noop_in_package5_plane3,4939727,4,123,125,248,0
4_5852374,noop_at_package4_city6-2,5852374,4,242,127,369,0
4_4030861,load-airplane_package4_plane4_city6-2,4030861,4,384,284,668,0
4_5809715,noop_at_plane2_city7-2,5809715,4,157,175,332,0
4_565705,at_plane2_city4-2,565705,4,27,19,46,0
4_2650101,noop_at_plane2_city10-2,2650101,4,156,172,328,0
4_1885288,noop_at_plane3_city5-2,1885288,4,197,175,372,0
4_5018866,noop_airplane_plane4,5018866,4,1,1,2,0
4_3026819,fly-airplane_plane4_city3-2_city6-2,3026819,4,166,184,350,0
4_2764675,fly-airplane_plane4_city3-2_city2-2,2764675,4,166,184,350,0
4_3223427,fly-airplane_plane4_city3-2_city9-2,3223427,4,166,184,350,0
4_2961283,fly-airplane_plane4_city3-2_city5-2,2961283,4,166,184,350,0
4_3090940,fly-airplane_plane4_city3-2_city10-2,3090940,4,166,184,350,0
4_2699139,fly-airplane_plane4_city3-2_city1-2,2699139,4,166,184,350,0
4_3157891,fly-airplane_plane4_city3-2_city8-2,3157891,4,166,184,350,0
4_1960449,fly-airplane_plane4_city6-2_city3-2,1960449,4,166,184,350,0
4_1894913,fly-airplane_plane4_city6-2_city2-2,1894913,4,166,184,350,0
4_2353665,fly-airplane_plane4_city6-2_city9-2,2353665,4,166,184,350,0
4_2091521,fly-airplane_plane4_city6-2_city5-2,2091521,4,166,184,350,0
4_4459224,fly-airplane_plane4_city6-2_city10-2,4459224,4,166,184,350,0
4_1829377,fly-airplane_plane4_city6-2_city1-2,1829377,4,166,184,350,0
4_2288129,fly-airplane_plane4_city6-2_city8-2,2288129,4,166,184,350,0
4_346354,fly-airplane_plane4_city10-2_city3-2,346354,4,166,183,349,0
4_542962,fly-airplane_plane4_city10-2_city6-2,542962,4,166,183,349,0
4_280818,fly-airplane_plane4_city10-2_city2-2,280818,4,166,183,349,0
4_739570,fly-airplane_plane4_city10-2_city9-2,739570,4,166,183,349,0
4_477426,fly-airplane_plane4_city10-2_city5-2,477426,4,166,183,349,0
4_215282,fly-airplane_plane4_city10-2_city1-2,215282,4,166,183,349,0
4_674034,fly-airplane_plane4_city10-2_city8-2,674034,4,166,183,349,0
4_743060,fly-airplane_plane4_city1-2_city3-2,743060,4,166,184,350,0
4_939668,fly-airplane_plane4_city1-2_city6-2,939668,4,166,184,350,0
4_677524,fly-airplane_plane4_city1-2_city2-2,677524,4,166,184,350,0
4_1136276,fly-airplane_plane4_city1-2_city9-2,1136276,4,166,184,350,0
4_874132,fly-airplane_plane4_city1-2_city5-2,874132,4,166,184,350,0
4_4845743,fly-airplane_plane4_city1-2_city10-2,4845743,4,166,184,350,0
4_1070740,fly-airplane_plane4_city1-2_city8-2,1070740,4,166,184,350,0
4_4047600,fly-airplane_plane4_city8-2_city3-2,4047600,4,166,184,350,0
4_4244208,fly-airplane_plane4_city8-2_city6-2,4244208,4,166,184,350,0
4_3982064,fly-airplane_plane4_city8-2_city2-2,3982064,4,166,184,350,0
4_4440816,fly-airplane_plane4_city8-2_city9-2,4440816,4,166,184,350,0
4_4178672,fly-airplane_plane4_city8-2_city5-2,4178672,4,166,184,350,0
4_2704421,fly-airplane_plane4_city8-2_city10-2,2704421,4,166,184,350,0
4_3916528,fly-airplane_plane4_city8-2_city1-2,3916528,4,166,184,350,0
4_1808983,unload-airplane_package1_plane4_city3-2,1808983,4,207,266,473,0
4_2005591,unload-airplane_package1_plane4_city6-2,2005591,4,207,266,473,0
4_1677911,unload-airplane_package1_plane4_city1-2,1677911,4,206,266,472,0
4_2136663,unload-airplane_package1_plane4_city8-2,2136663,4,207,266,473,0
4_5688813,unload-airplane_package1_plane4_city10-2,5688813,4,206,263,469,0
4_3817414,unload-airplane_package3_plane4_city3-2,3817414,4,249,284,533,0
4_4014022,unload-airplane_package3_plane4_city6-2,4014022,4,249,284,533,0
4_3686342,unload-airplane_package3_plane4_city1-2,3686342,4,248,284,532,0
4_4145094,unload-airplane_package3_plane4_city8-2,4145094,4,249,284,533,0
4_7784621,unload-airplane_package3_plane4_city10-2,7784621,4,248,281,529,0
4_821141,unload-airplane_package4_plane4_city3-2,821141,4,253,284,537,0
4_1017749,unload-airplane_package4_plane4_city6-2,1017749,4,253,284,537,0
4_690069,unload-airplane_package4_plane4_city1-2,690069,4,252,284,536,0
4_1148821,unload-airplane_package4_plane4_city8-2,1148821,4,253,284,537,0
4_831548,unload-airplane_package4_plane4_city10-2,831548,4,252,281,533,0
4_5825845,unload-airplane_package5_plane4_city3-2,5825845,4,207,266,473,0
4_6022453,unload-airplane_package5_plane4_city6-2,6022453,4,207,266,473,0
4_5694773,unload-airplane_package5_plane4_city1-2,5694773,4,207,266,473,0
4_6153525,unload-airplane_package5_plane4_city8-2,6153525,4,207,266,473,0
4_1879452,unload-airplane_package5_plane4_city10-2,1879452,4,206,263,469,0
4_1998620,load-airplane_package2_plane4_city10-2,1998620,4,172,191,363,0
4_7027134,load-airplane_package3_plane4_city6-2,7027134,4,249,284,533,0
4_6699454,load-airplane_package3_plane4_city1-2,6699454,4,248,284,532,0
4_7158206,load-airplane_package3_plane4_city8-2,7158206,4,249,284,533,0
4_3046524,load-airplane_package3_plane4_city10-2,3046524,4,248,281,529,0
4_3703181,load-airplane_package4_plane4_city1-2,3703181,4,380,284,664,0
4_4161933,load-airplane_package4_plane4_city8-2,4161933,4,384,284,668,0
4_4233888,noop_in-city_city9-1_city9,4233888,4,1,1,2,0
4_4939728,noop_in_package5_plane4,4939728,4,75,109,184,0
4_5830766,noop_at_plane4_city1-2,5830766,4,156,175,331,0
4_2773648,noop_location_city3-1,2773648,4,1,1,2,0
4_2713825,unload-truck_package3_truck3_city3-1,2713825,4,115,136,251,0
4_4560839,noop_in-city_city2-2_city2,4560839,4,1,1,2,0
4_6728647,drive-truck_truck2_city2-1_city2-2_city2,6728647,4,15,16,31,0
4_3971182,drive-truck_truck2_city2-2_city2-1_city2,3971182,4,15,15,30,0
4_2773649,noop_location_city3-2,2773649,4,1,1,2,0
4_2713826,unload-truck_package3_truck3_city3-2,2713826,4,114,131,245,0
4_2962340,noop_at_truck7_city7-1,2962340,4,7,11,18,0
4_5915916,at_truck7_city7-2,5915916,4,3,11,14,0
4_6289518,noop_at_plane4_city8-2,6289518,4,157,175,332,0
4_2962341,noop_at_truck7_city7-2,2962341,4,5,7,12,0
4_5915915,at_truck7_city7-1,5915915,4,3,6,9,0
4_2010292,noop_in-city_city9-2_city9,2010292,4,1,1,2,0
4_1644752,noop_at_package3_city6-2,1644752,4,107,127,234,0
4_1602093,noop_at_plane1_city7-2,1602093,4,157,175,332,0
4_1561471,noop_airport_city3-2,1561471,4,1,1,2,0
4_6144820,noop_at_truck4_city4-1,6144820,4,6,12,18,0
4_1097419,at_truck4_city4-2,1097419,4,3,10,13,0
4_5590230,noop_at_package4_city2-2,5590230,4,239,127,366,0
4_4203220,load-truck_package4_truck2_city2-2,4203220,4,247,134,381,0
4_1623144,noop_at_plane3_city1-2,1623144,4,196,175,371,0
4_6144821,noop_at_truck4_city4-2,6144821,4,4,4,8,0
4_1097418,at_truck4_city4-1,1097418,4,3,6,9,0
4_5547571,noop_at_plane2_city3-2,5547571,4,157,175,332,0
4_6118830,noop_at_truck10_city10-1,6118830,4,13,14,27,0
4_3142669,unload-truck_package2_truck10_city10-1,3142669,4,20,31,51,0
4_7404958,load-truck_package2_truck10_city10-1,7404958,4,20,31,51,0
4_7160436,at_package2_city10-2,7160436,4,9,12,21,0
4_3973470,at_truck10_city10-2,3973470,4,3,12,15,0
4_6110934,noop_in_package4_plane1,6110934,4,140,127,267,0
4_6118831,noop_at_truck10_city10-2,6118831,4,6,6,12,0
4_3142670,unload-truck_package2_truck10_city10-2,3142670,4,18,23,41,0
4_7404959,load-truck_package2_truck10_city10-2,7404959,4,18,23,41,0
4_3635165,load-truck_package3_truck10_city10-2,3635165,4,116,133,249,0
4_3973469,at_truck10_city10-1,3973469,4,4,8,12,0
4_6110935,noop_in_package4_plane2,6110935,4,129,127,256,0
4_6048982,noop_at_package4_city9-2,6048982,4,242,127,369,0
4_2081896,noop_at_plane3_city8-2,2081896,4,197,175,372,0
4_6110936,noop_in_package4_plane3,6110936,4,107,127,234,0
4_7612973,noop_in-city_city6-1_city6,7612973,4,1,1,2,0
4_6027374,noop_at_plane4_city4-2,6027374,4,157,175,332,0
4_2970256,noop_location_city6-1,2970256,4,1,1,2,0
4_6110937,noop_in_package4_plane4,6110937,4,129,127,256,0
4_1324776,noop_at_package3_city10-2,1324776,4,107,127,234,0
4_2970257,noop_location_city6-2,2970257,4,1,1,2,0
4_7846438,noop_in_package5_truck1,7846438,4,53,109,162,0
4_4176917,unload-truck_package5_truck1_city1-1,4176917,4,62,120,182,0
4_4176918,unload-truck_package5_truck1_city1-2,4176918,4,60,113,173,0
4_1382608,noop_at_package3_city2-2,1382608,4,107,127,234,0
4_7199493,load-truck_package3_truck2_city2-2,7199493,4,115,134,249,0
4_1339949,noop_at_plane1_city3-2,1339949,4,157,175,332,0
4_5389377,noop_in-city_city6-2_city6,5389377,4,1,1,2,0
4_3405350,noop_in-city_city5-1_city5,3405350,4,1,1,2,0
4_2656144,drive-truck_truck5_city5-1_city5-2_city5,2656144,4,12,13,25,0
4_7899656,drive-truck_truck5_city5-2_city5-1_city5,7899656,4,12,11,23,0
4_1841360,noop_at_package3_city9-2,1841360,4,107,127,234,0
4_3822037,noop_in_package2_truck10,3822037,4,11,19,30,0
4_7160435,at_package2_city10-1,7160435,4,4,7,11,0
4_1758079,noop_airport_city6-2,1758079,4,1,1,2,0
4_2417001,noop_at_truck5_city5-1,2417001,4,6,12,18,0
4_5370577,at_truck5_city5-2,5370577,4,3,10,13,0
4_5786838,noop_at_package4_city5-2,5786838,4,242,127,369,0
4_1020740,load-truck_package4_truck5_city5-2,1020740,4,249,131,380,0
4_5744179,noop_at_plane2_city6-2,5744179,4,157,175,332,0
4_1819752,noop_at_plane3_city4-2,1819752,4,197,175,372,0
4_2417002,noop_at_truck5_city5-2,2417002,4,4,4,8,0
4_4017013,load-truck_package3_truck5_city5-2,4017013,4,114,131,245,0
4_5370576,at_truck5_city5-1,5370576,4,3,6,9,0
4_2708112,noop_location_city2-1,2708112,4,1,1,2,0
4_4433213,unload-truck_package1_truck2_city2-1,4433213,4,62,120,182,0
4_7282143,noop_in_package3_plane1,7282143,4,140,127,267,0
4_7282144,noop_in_package3_plane2,7282144,4,107,127,234,0
4_2708113,noop_location_city2-2,2708113,4,1,1,2,0
4_4433214,unload-truck_package1_truck2_city2-2,4433214,4,60,113,173,0
4_1181754,noop_in-city_city5-2_city5,1181754,4,1,1,2,0
4_5599481,noop_at_truck2_city2-1,5599481,4,8,13,21,0
4_552080,at_truck2_city2-2,552080,4,3,11,14,0
4_6223982,noop_at_plane4_city7-2,6223982,4,157,175,332,0
4_5599482,noop_at_truck2_city2-2,5599482,4,5,7,12,0
4_552079,at_truck2_city2-1,552079,4,3,9,12,0
4_62686,noop_truck_truck1,62686,4,1,1,2,0
4_85171,drive-truck_truck1_city1-1_city1-2_city1,85171,4,15,16,31,0
4_5328683,drive-truck_truck1_city1-2_city1-1_city1,5328683,4,15,15,30,0
4_2926335,load-truck_package3_truck1_city1-2,2926335,4,115,134,249,0
4_7931039,load-truck_package4_truck1_city1-2,7931039,4,247,134,381,0
4_3166864,noop_location_city9-1,3166864,4,1,1,2,0
4_7282145,noop_in_package3_plane3,7282145,4,177,127,304,0
4_7282146,noop_in_package3_plane4,7282146,4,107,127,234,0
4_62687,noop_truck_truck2,62687,4,1,1,2,0
4_3166865,noop_location_city9-2,3166865,4,1,1,2,0
4_1579216,noop_at_package3_city5-2,1579216,4,107,127,234,0
4_62688,noop_truck_truck3,62688,4,1,1,2,0
4_1495935,noop_airport_city2-2,1495935,4,1,1,2,0
4_4109194,noop_in-city_city10-1_city10,4109194,4,1,1,2,0
4_1536557,noop_at_plane1_city6-2,1536557,4,157,175,332,0
4_5524694,noop_at_package4_city1-2,5524694,4,239,127,366,0
4_5482035,noop_at_plane2_city2-2,5482035,4,156,175,331,0
4_45710,noop_truck_truck10,45710,4,1,1,2,0
4_62689,noop_truck_truck4,62689,4,1,1,2,0
4_4975108,noop_in-city_city4-2_city4,4975108,4,1,1,2,0
4_6784435,noop_in-city_city2-1_city2,6784435,4,1,1,2,0
4_4530298,noop_in_package1_truck2,4530298,4,53,109,162,0
4_6823957,at_package1_city2-2,6823957,4,15,21,36,0
4_62690,noop_truck_truck5,62690,4,1,1,2,0
4_1954687,noop_airport_city9-2,1954687,4,1,1,2,0
4_5983446,noop_at_package4_city8-2,5983446,4,242,127,369,0
4_5839237,load-truck_package4_truck8_city8-2,5839237,4,249,131,380,0
4_5940787,noop_at_plane2_city9-2,5940787,4,157,175,332,0
4_62691,noop_truck_truck6,62691,4,1,1,2,0
4_2016360,noop_at_plane3_city7-2,2016360,4,202,175,377,0
4_4305438,noop_at_package2_city10-1,4305438,4,11,19,30,0
4_1676676,in_package2_truck10,1676676,4,6,7,13,0
4_4305439,noop_at_package2_city10-2,4305439,4,13,19,32,0
4_62692,noop_truck_truck7,62692,4,1,1,2,0
4_2904720,noop_location_city5-1,2904720,4,1,1,2,0
4_5961838,noop_at_plane4_city3-2,5961838,4,157,175,332,0
4_4689752,noop_at_plane4_city10-2,4689752,4,156,172,328,0
4_62693,noop_truck_truck8,62693,4,1,1,2,0
4_6584618,drive-truck_truck8_city8-1_city8-2_city8,6584618,4,12,13,25,0
4_3827153,drive-truck_truck8_city8-2_city8-1_city8,3827153,4,12,11,23,0
4_834533,load-truck_package3_truck8_city8-2,834533,4,114,131,245,0
4_2904721,noop_location_city5-2,2904721,4,1,1,2,0
4_2576812,noop_in-city_city1-1_city1,2576812,4,1,1,2,0
4_1871662,noop_at_truck3_city3-1,1871662,4,7,11,18,0
4_4825238,at_truck3_city3-2,4825238,4,3,12,15,0
4_1317072,noop_at_package3_city1-2,1317072,4,107,127,234,0
4_1274413,noop_at_plane1_city2-2,1274413,4,156,175,331,0
4_1871663,noop_at_truck3_city3-2,1871663,4,5,7,12,0
4_4825237,at_truck3_city3-1,4825237,4,3,7,10,0
4_62694,noop_truck_truck9,62694,4,1,1,2,0
4_1016676,noop_in_package4_truck7,1016676,4,107,127,234,0
4_1837095,noop_obj_package1,1837095,4,1,1,2,0
4_1775824,noop_at_package3_city8-2,1775824,4,107,127,234,0
4_1733165,noop_at_plane1_city9-2,1733165,4,157,175,332,0
4_1837096,noop_obj_package2,1837096,4,1,1,2,0
4_1692543,noop_airport_city5-2,1692543,4,1,1,2,0
4_26265,noop_in-city_city8-1_city8,26265,4,1,1,2,0
4_5721302,noop_at_package4_city4-2,5721302,4,242,127,369,0
4_5678643,noop_at_plane2_city5-2,5678643,4,157,175,332,0
4_1754216,noop_at_plane3_city3-2,1754216,4,197,175,372,0
4_1837097,noop_obj_package3,1837097,4,1,1,2,0
4_353216,noop_in-city_city1-2_city1,353216,4,1,1,2,0
4_1837098,noop_obj_package4,1837098,4,1,1,2,0
4_4005493,noop_city_city1,4005493,4,1,1,2,0
4_2642576,noop_location_city1-1,2642576,4,1,1,2,0
4_1837099,noop_obj_package5,1837099,4,1,1,2,0
4_4005494,noop_city_city2,4005494,4,1,1,2,0
4_2642577,noop_location_city1-2,2642577,4,1,1,2,0
4_2187881,noop_in_package3_truck3,2187881,4,107,127,234,0
4_6158446,noop_at_plane4_city6-2,6158446,4,157,175,332,0
4_4005495,noop_city_city3,4005495,4,1,1,2,0
4_3101328,noop_location_city8-1,3101328,4,1,1,2,0
4_5803646,noop_in-city_city8-2_city8,5803646,4,1,1,2,0
4_3819619,noop_in-city_city7-1_city7,3819619,4,1,1,2,0
4_4005496,noop_city_city4,4005496,4,1,1,2,0
4_3101329,noop_location_city8-2,3101329,4,1,1,2,0
4_1513680,noop_at_package3_city4-2,1513680,4,107,127,234,0
4_1471021,noop_at_plane1_city5-2,1471021,4,157,175,332,0
4_4005497,noop_city_city5,4005497,4,1,1,2,0
4_4613021,noop_location_city10-1,4613021,4,1,1,2,0
4_6333557,noop_airport_city10-2,6333557,4,1,1,2,0
4_1430399,noop_airport_city1-2,1430399,4,1,1,2,0
4_7235498,noop_at_truck8_city8-1,7235498,4,6,12,18,0
4_2188097,at_truck8_city8-2,2188097,4,3,11,14,0
4_1623584,noop_in_package1_plane1,1623584,4,86,109,195,0
4_5416499,noop_at_plane2_city1-2,5416499,4,156,175,331,0
4_7235499,noop_at_truck8_city8-2,7235499,4,4,4,8,0
4_2188096,at_truck8_city8-1,2188096,4,3,6,9,0
4_4005498,noop_city_city6,4005498,4,1,1,2,0
4_4613022,noop_location_city10-2,4613022,4,1,1,2,0
4_1623585,noop_in_package1_plane2,1623585,4,75,109,184,0
4_4005499,noop_city_city7,4005499,4,1,1,2,0
4_1889151,noop_airport_city8-2,1889151,4,1,1,2,0
4_1596023,noop_in-city_city7-2_city7,1596023,4,1,1,2,0
4_1326323,noop_at_truck1_city1-1,1326323,4,8,13,21,0
4_4279899,at_truck1_city1-2,4279899,4,3,12,15,0
4_1623586,noop_in_package1_plane3,1623586,4,123,125,248,0
4_5630764,noop_at_plane1_city10-2,5630764,4,156,172,328,0
4_5875251,noop_at_plane2_city8-2,5875251,4,157,175,332,0
4_1950824,noop_at_plane3_city6-2,1950824,4,197,175,372,0
4_1326324,noop_at_truck1_city1-2,1326324,4,5,7,12,0
4_4279898,at_truck1_city1-1,4279898,4,3,9,12,0
4_4005500,noop_city_city8,4005500,4,1,1,2,0
4_5917910,noop_at_package4_city7-2,5917910,4,107,127,234,0
4_1623587,noop_in_package1_plane4,1623587,4,75,109,184,0
4_6497299,city_city8,6497299,4,1,3,4,0
4_6195675,in-city_city5-1_city5,6195675,4,1,3,4,0
4_7104561,city_city10,7104561,4,1,3,4,0
3_1466100,unload-airplane_package5_plane1_city7-2,1466100,3,5,206,211,0
4_7980171,at_package5_city7-2,7980171,4,4,21,25,0
3_5542650,unload-airplane_package5_plane2_city5-2,5542650,3,5,204,209,0
4_7849099,at_package5_city5-2,7849099,4,4,21,25,0
3_3354450,load-airplane_package4_plane2_city2-2,3354450,3,4,377,381,0
2_3444869,at_package4_city2-2,3444869,2,0,5,5,0
4_585448,airport_city8-2,585448,4,1,73,74,0
4_6497300,city_city9,6497300,4,1,3,4,0
3_5515751,unload-airplane_package1_plane1_city8-2,5515751,3,5,206,211,0
4_7217173,at_package1_city8-2,7217173,4,4,21,25,0
3_4331301,unload-airplane_package4_plane1_city5-2,4331301,3,5,252,257,0
3_2143101,load-airplane_package3_plane1_city2-2,2143101,3,4,245,249,0
2_7238224,at_package3_city2-2,7238224,2,0,5,5,0
3_475401,load-truck_package4_truck3_city3-2,475401,3,4,245,249,0
2_3510405,at_package4_city3-2,3510405,2,0,5,5,0
4_5040034,in_package4_truck3,5040034,4,1,31,32,0
3_5721302,noop_at_package4_city4-2,5721302,3,0,242,242,0
2_3575941,at_package4_city4-2,3575941,2,0,5,5,0
3_1644752,noop_at_package3_city6-2,1644752,3,0,107,107,0
2_7500368,at_package3_city6-2,7500368,2,0,5,5,0
3_1460252,unload-airplane_package1_plane2_city4-2,1460252,3,5,204,209,0
4_6955029,at_package1_city4-2,6955029,4,4,21,25,0
3_275802,unload-airplane_package4_plane2_city1-2,275802,3,5,249,254,0
3_1879452,unload-airplane_package5_plane4_city10-2,1879452,3,5,203,208,0
4_6219424,at_package5_city10-2,6219424,4,4,21,25,0
3_3813202,load-airplane_package4_plane2_city9-2,3813202,3,4,381,385,0
2_3903621,at_package4_city9-2,3903621,2,0,5,5,0
3_4562352,load-truck_package3_truck7_city7-2,4562352,3,4,112,116,0
2_7565904,at_package3_city7-2,7565904,2,0,5,5,0
4_6211247,in_package3_truck7,6211247,4,1,29,30,0
3_1945903,unload-airplane_package5_plane3_city8-2,1945903,3,5,250,255,0
4_44730,at_package5_city8-2,44730,4,4,21,25,0
3_6022453,unload-airplane_package5_plane4_city6-2,6022453,3,5,204,209,0
4_7914635,at_package5_city6-2,7914635,4,4,21,25,0
3_2601853,load-airplane_package3_plane1_city9-2,2601853,3,4,246,250,0
2_7696976,at_package3_city9-2,7696976,2,0,5,5,0
3_6678403,load-airplane_package3_plane2_city7-2,6678403,3,5,246,251,0
3_3834253,load-airplane_package4_plane4_city3-2,3834253,3,5,379,384,0
4_3972079,in-city_city5-2_city5,3972079,4,1,3,4,0
4_1988052,in-city_city4-1_city4,1988052,4,1,3,4,0
3_5995554,unload-airplane_package1_plane3_city9-2,5995554,3,5,250,255,0
4_7282709,at_package1_city9-2,7282709,4,4,21,25,0
3_734554,unload-airplane_package4_plane2_city8-2,734554,3,5,250,255,0
3_6699454,load-airplane_package3_plane4_city1-2,6699454,3,4,245,249,0
2_7172688,at_package3_city1-2,7172688,2,0,5,5,0
3_1940055,unload-airplane_package1_plane4_city5-2,1940055,3,5,204,209,0
4_7020565,at_package1_city5-2,7020565,4,4,21,25,0
3_7676305,unload-airplane_package3_plane3_city4-2,7676305,3,5,296,301,0
3_755605,unload-airplane_package4_plane4_city2-2,755605,3,5,249,254,0
3_7147805,load-airplane_package4_plane1_city2-2,7147805,3,5,377,382,0
4_5263322,location_city6-1,5263322,4,1,5,6,0
3_724656,unload-airplane_package3_plane1_city10-2,724656,3,5,251,256,0
3_1203956,unload-airplane_package5_plane1_city3-2,1203956,3,5,206,211,0
4_7718027,at_package5_city3-2,7718027,4,4,21,25,0
3_7158206,load-airplane_package3_plane4_city8-2,7158206,3,4,246,250,0
2_7631440,at_package3_city8-2,7631440,2,0,5,5,0
4_625646,airport_city10-2,625646,4,1,73,74,0
4_5263323,location_city6-2,5263323,4,1,47,48,0
4_323304,airport_city4-2,323304,4,1,73,74,0
3_5253607,unload-airplane_package1_plane1_city4-2,5253607,3,5,206,211,0
3_2764307,unload-airplane_package3_plane3_city10-2,2764307,3,5,295,300,0
3_4069157,unload-airplane_package4_plane1_city1-2,4069157,3,5,251,256,0
3_1214357,unload-airplane_package4_plane4_city9-2,1214357,3,5,250,255,0
3_7606557,load-airplane_package4_plane1_city9-2,7606557,3,5,381,386,0
4_7765433,in-city_city4-2_city4,7765433,4,1,3,4,0
3_1382608,noop_at_package3_city2-2,1382608,3,1,107,108,0
3_3008,unload-airplane_package3_plane3_city9-2,3008,3,5,296,301,0
3_5739258,unload-airplane_package5_plane2_city8-2,5739258,3,5,204,209,0
3_3551058,load-airplane_package4_plane2_city5-2,3551058,3,4,381,385,0
2_3641477,at_package4_city5-2,3641477,2,0,5,5,0
3_7627608,load-airplane_package4_plane3_city3-2,7627608,3,5,250,255,0
3_4527909,unload-airplane_package4_plane1_city8-2,4527909,3,5,252,257,0
3_1683759,unload-airplane_package5_plane3_city4-2,1683759,3,5,250,255,0
4_7783563,at_package5_city4-2,7783563,4,4,21,25,0
3_5760309,unload-airplane_package5_plane4_city2-2,5760309,3,5,203,208,0
4_7652491,at_package5_city2-2,7652491,4,4,21,25,0
3_2339709,load-airplane_package3_plane1_city5-2,2339709,3,4,246,250,0
2_7434832,at_package3_city5-2,7434832,2,0,5,5,0
3_7404959,load-truck_package2_truck10_city10-2,7404959,3,4,15,19,0
2_7160436,at_package2_city10-2,7160436,2,0,5,5,0
3_4748559,load-truck_package4_truck4_city4-2,4748559,3,5,246,251,0
4_5040035,in_package4_truck4,5040035,4,1,31,32,0
4_1230283,truck_truck10,1230283,4,1,17,18,0
3_1841360,noop_at_package3_city9-2,1841360,3,1,107,108,0
3_1656860,unload-airplane_package1_plane2_city7-2,1656860,3,5,204,209,0
4_7151637,at_package1_city7-2,7151637,4,4,21,25,0
3_5733410,unload-airplane_package1_plane3_city5-2,5733410,3,5,250,255,0
3_7393110,unload-airplane_package3_plane1_city6-2,7393110,3,5,252,257,0
3_1772560,unload-airplane_package4_plane1_city10-2,1772560,3,5,251,256,0
3_472410,unload-airplane_package4_plane2_city4-2,472410,3,5,250,255,0
3_1677911,unload-airplane_package1_plane4_city1-2,1677911,3,5,203,208,0
4_6758421,at_package1_city1-2,6758421,4,4,21,25,0
3_6219061,unload-airplane_package5_plane4_city9-2,6219061,3,5,204,209,0
4_110266,at_package5_city9-2,110266,4,4,21,25,0
3_4030861,load-airplane_package4_plane4_city6-2,4030861,3,4,381,385,0
2_3707013,at_package4_city6-2,3707013,2,0,5,5,0
4_5367137,in-city_city1-1_city1,5367137,4,1,3,4,0
4_5001178,location_city2-1,5001178,4,1,7,8,0
3_3649162,unload-airplane_package1_plane2_city10-2,3649162,3,5,203,208,0
4_2140122,at_package1_city10-2,2140122,4,4,21,25,0
3_2819512,load-airplane_package3_plane3_city6-2,2819512,3,5,286,291,0
3_6896062,load-airplane_package3_plane4_city4-2,6896062,3,4,246,250,0
2_7369296,at_package3_city4-2,7369296,2,0,5,5,0
4_5001179,location_city2-2,5001179,4,1,47,48,0
4_3715160,airplane_plane1,3715160,4,1,182,183,0
3_2136663,unload-airplane_package1_plane4_city8-2,2136663,3,5,204,209,0
3_5688813,unload-airplane_package1_plane4_city10-2,5688813,3,5,203,208,0
3_7872913,unload-airplane_package3_plane3_city7-2,7872913,3,5,295,300,0
3_952213,unload-airplane_package4_plane4_city5-2,952213,3,5,250,255,0
3_4433213,unload-truck_package1_truck2_city2-1,4433213,3,5,59,64,0
4_6823956,at_package1_city2-1,6823956,4,1,18,19,0
3_7344413,load-airplane_package4_plane1_city5-2,7344413,3,5,381,386,0
3_4017013,load-truck_package3_truck5_city5-2,4017013,3,5,111,116,0
4_6211245,in_package3_truck5,6211245,4,1,28,29,0
4_5459930,location_city9-1,5459930,4,1,5,6,0
4_3715161,airplane_plane2,3715161,4,1,182,183,0
3_1400564,unload-airplane_package5_plane1_city6-2,1400564,3,5,206,211,0
3_2820464,unload-airplane_package5_plane1_city10-2,2820464,3,5,205,210,0
3_5477114,unload-airplane_package5_plane2_city4-2,5477114,3,5,204,209,0
3_3288914,load-airplane_package4_plane2_city1-2,3288914,3,4,377,381,0
2_3379333,at_package4_city1-2,3379333,2,0,5,5,0
4_2816590,in-city_city8-1_city8,2816590,4,1,3,4,0
4_5459931,location_city9-2,5459931,4,1,47,48,0
4_519912,airport_city7-2,519912,4,1,73,74,0
4_3715162,airplane_plane3,3715162,4,1,182,183,0
3_5450215,unload-airplane_package1_plane1_city7-2,5450215,3,5,206,211,0
3_4265765,unload-airplane_package4_plane1_city4-2,4265765,3,5,252,257,0
3_4860115,unload-airplane_package5_plane3_city10-2,4860115,3,5,249,254,0
3_2077565,load-airplane_package3_plane1_city1-2,2077565,3,5,245,250,0
3_3635165,load-truck_package3_truck10_city10-2,3635165,3,4,113,117,0
2_4179773,at_package3_city10-2,4179773,2,0,5,5,0
4_5884298,in_package3_truck10,5884298,4,1,28,29,0
4_3143541,in-city_city1-2_city1,3143541,4,1,3,4,0
3_1579216,noop_at_package3_city5-2,1579216,3,1,107,108,0
4_3715163,airplane_plane4,3715163,4,1,182,183,0
3_5655766,noop_at_package4_city3-2,5655766,3,1,240,241,0
3_1394716,unload-airplane_package1_plane2_city3-2,1394716,3,5,204,209,0
4_6889493,at_package1_city3-2,6889493,4,4,21,25,0
3_5471266,unload-airplane_package1_plane3_city1-2,5471266,3,5,249,254,0
3_7130966,unload-airplane_package3_plane1_city2-2,7130966,3,5,251,256,0
3_3747666,load-airplane_package4_plane2_city8-2,3747666,3,4,381,385,0
2_3838085,at_package4_city8-2,3838085,2,0,5,5,0
3_7824216,load-airplane_package4_plane3_city6-2,7824216,3,5,252,257,0
3_1880367,unload-airplane_package5_plane3_city7-2,1880367,3,5,249,254,0
3_5956917,unload-airplane_package5_plane4_city5-2,5956917,3,5,204,209,0
3_4176917,unload-truck_package5_truck1_city1-1,4176917,3,5,59,64,0
4_7586954,at_package5_city1-1,7586954,4,1,2,3,0
3_2536317,load-airplane_package3_plane1_city8-2,2536317,3,5,246,251,0
3_6612867,load-airplane_package3_plane2_city6-2,6612867,3,5,246,251,0
3_3768717,load-airplane_package4_plane4_city2-2,3768717,3,5,377,382,0
3_5930018,unload-airplane_package1_plane3_city8-2,5930018,3,5,250,255,0
3_7589718,unload-airplane_package3_plane1_city9-2,7589718,3,5,252,257,0
3_2557368,load-airplane_package3_plane3_city2-2,2557368,3,5,285,290,0
3_2111418,load-truck_package4_truck9_city9-2,2111418,3,5,246,251,0
4_5040040,in_package4_truck9,5040040,4,1,31,32,0
4_6609944,in-city_city7-1_city7,6609944,4,1,3,4,0
3_1874519,unload-airplane_package1_plane4_city4-2,1874519,3,5,204,209,0
3_690069,unload-airplane_package4_plane4_city1-2,690069,3,5,249,254,0
3_7082269,load-airplane_package4_plane1_city1-2,7082269,3,5,377,382,0
3_4227469,load-airplane_package4_plane4_city9-2,4227469,3,5,381,386,0
4_5197786,location_city5-1,5197786,4,1,5,6,0
3_1138420,unload-airplane_package5_plane1_city2-2,1138420,3,5,205,210,0
3_1998620,load-airplane_package2_plane4_city10-2,1998620,3,5,169,174,0
4_4475740,in_package2_plane4,4475740,4,1,26,27,0
3_3016120,load-airplane_package3_plane3_city9-2,3016120,3,5,286,291,0
3_7092670,load-airplane_package3_plane4_city7-2,7092670,3,5,246,251,0
3_4203220,load-truck_package4_truck2_city2-2,4203220,3,5,244,249,0
4_5040033,in_package4_truck2,5040033,4,1,31,32,0
4_7566596,location_city10-1,7566596,4,1,7,8,0
4_5197787,location_city5-2,5197787,4,1,47,48,0
4_257768,airport_city3-2,257768,4,1,73,74,0
3_5188071,unload-airplane_package1_plane1_city3-2,5188071,3,5,206,211,0
3_1148821,unload-airplane_package4_plane4_city8-2,1148821,3,5,250,255,0
3_7541021,load-airplane_package4_plane1_city8-2,7541021,3,5,381,386,0
4_7566597,location_city10-2,7566597,4,1,53,54,0
3_1317072,noop_at_package3_city1-2,1317072,3,1,107,108,0
3_1597172,unload-airplane_package5_plane1_city9-2,1597172,3,5,206,211,0
3_5673722,unload-airplane_package5_plane2_city7-2,5673722,3,5,204,209,0
3_3485522,load-airplane_package4_plane2_city4-2,3485522,3,5,381,386,0
3_7562072,load-airplane_package4_plane3_city2-2,7562072,3,5,249,254,0
4_4386348,in-city_city7-2_city7,4386348,4,1,3,4,0
4_2402321,in-city_city6-1_city6,2402321,4,1,3,4,0
3_1618223,unload-airplane_package5_plane3_city3-2,1618223,3,5,250,255,0
3_2274173,load-airplane_package3_plane1_city4-2,2274173,3,5,246,251,0
3_6350723,load-airplane_package3_plane2_city2-2,6350723,3,5,245,250,0
3_1006873,load-airplane_package3_plane2_city10-2,1006873,3,5,245,250,0
3_1775824,noop_at_package3_city8-2,1775824,3,1,107,108,0
3_5852374,noop_at_package4_city6-2,5852374,3,1,242,243,0
3_1591324,unload-airplane_package1_plane2_city6-2,1591324,3,5,204,209,0
4_7086101,at_package1_city6-2,7086101,4,4,6,10,0
3_5667874,unload-airplane_package1_plane3_city4-2,5667874,3,5,250,255,0
3_7327574,unload-airplane_package3_plane1_city5-2,7327574,3,5,252,257,0
3_406874,unload-airplane_package4_plane2_city3-2,406874,3,5,250,255,0
3_6792874,unload-airplane_package4_plane2_city10-2,6792874,3,5,249,254,0
3_3046524,load-airplane_package3_plane4_city10-2,3046524,3,5,245,250,0
3_6629825,unload-airplane_package1_plane1_city10-2,6629825,3,5,205,210,0
3_6153525,unload-airplane_package5_plane4_city8-2,6153525,3,5,204,209,0
3_2713825,unload-truck_package3_truck3_city3-1,2713825,3,5,112,117,0
4_7303759,at_package3_city3-1,7303759,4,1,26,27,0
3_6809475,load-airplane_package3_plane2_city9-2,6809475,3,5,246,251,0
3_3965325,load-airplane_package4_plane4_city5-2,3965325,3,5,381,386,0
4_4935642,location_city1-1,4935642,4,1,7,8,0
3_1324776,noop_at_package3_city10-2,1324776,3,1,107,108,0
3_2753976,load-airplane_package3_plane3_city5-2,2753976,3,5,286,291,0
4_4935643,location_city1-2,4935643,4,1,47,48,0
4_178725,in-city_city6-2_city6,178725,4,1,3,4,0
3_2071127,unload-airplane_package1_plane4_city7-2,2071127,3,5,204,209,0
3_7807377,unload-airplane_package3_plane3_city6-2,7807377,3,5,296,301,0
3_886677,unload-airplane_package4_plane4_city4-2,886677,3,5,250,255,0
3_7278877,load-airplane_package4_plane1_city4-2,7278877,3,5,381,386,0
3_2054777,load-airplane_package4_plane2_city10-2,2054777,3,4,379,383,0
2_1199110,at_package4_city10-2,1199110,2,0,5,5,0
4_5394394,location_city8-1,5394394,4,1,5,6,0
3_1335028,unload-airplane_package5_plane1_city5-2,1335028,3,5,206,211,0
3_5411578,unload-airplane_package5_plane2_city3-2,5411578,3,5,204,209,0
3_7840778,unload-airplane_package5_plane2_city10-2,7840778,3,5,203,208,0
3_4094428,load-airplane_package4_plane4_city10-2,4094428,3,5,379,384,0
4_5394395,location_city8-2,5394395,4,1,47,48,0
4_454376,airport_city6-2,454376,4,1,73,74,0
3_5384679,unload-airplane_package1_plane1_city6-2,5384679,3,5,206,211,0
3_4200229,unload-airplane_package4_plane1_city3-2,4200229,3,5,252,257,0
3_1513680,noop_at_package3_city4-2,1513680,3,1,107,108,0
3_5590230,noop_at_package4_city2-2,5590230,3,1,239,240,0
3_7065430,unload-airplane_package3_plane1_city1-2,7065430,3,5,251,256,0
3_808230,unload-truck_package4_truck7_city7-1,808230,3,5,112,117,0
4_3772548,at_package4_city7-1,3772548,4,1,28,29,0
3_7758680,load-airplane_package4_plane3_city5-2,7758680,3,5,252,257,0
4_5781406,in-city_city3-1_city3,5781406,4,1,3,4,0
3_1814831,unload-airplane_package5_plane3_city6-2,1814831,3,5,250,255,0
3_5891381,unload-airplane_package5_plane4_city4-2,5891381,3,5,204,209,0
3_2470781,load-airplane_package3_plane1_city7-2,2470781,3,5,246,251,0
3_6547331,load-airplane_package3_plane2_city5-2,6547331,3,5,246,251,0
3_3703181,load-airplane_package4_plane4_city1-2,3703181,3,5,377,382,0
3_6048982,noop_at_package4_city9-2,6048982,3,1,242,243,0
3_1787932,unload-airplane_package1_plane2_city9-2,1787932,3,5,204,209,0
3_5864482,unload-airplane_package1_plane3_city7-2,5864482,3,5,249,254,0
3_7524182,unload-airplane_package3_plane1_city8-2,7524182,3,5,252,257,0
3_603482,unload-airplane_package4_plane2_city6-2,603482,3,5,250,255,0
3_2939632,load-airplane_package2_plane1_city10-2,2939632,3,5,169,174,0
4_4475737,in_package2_plane1,4475737,4,1,26,27,0
3_2491832,load-airplane_package3_plane3_city1-2,2491832,3,5,285,290,0
3_7744832,load-truck_package3_truck4_city4-2,7744832,3,5,111,116,0
4_6211244,in_package3_truck4,6211244,4,1,28,29,0
3_1808983,unload-airplane_package1_plane4_city3-2,1808983,3,5,204,209,0
3_7545233,unload-airplane_package3_plane3_city2-2,7545233,3,5,295,300,0
3_4979283,load-airplane_package2_plane3_city10-2,4979283,3,5,209,214,0
4_4475739,in_package2_plane3,4475739,4,1,34,35,0
3_4161933,load-airplane_package4_plane4_city8-2,4161933,3,5,381,386,0
3_834533,load-truck_package3_truck8_city8-2,834533,3,5,111,116,0
4_6211248,in_package3_truck8,6211248,4,1,28,29,0
4_5132250,location_city4-1,5132250,4,1,5,6,0
3_2950584,load-airplane_package3_plane3_city8-2,2950584,3,5,286,291,0
3_7027134,load-airplane_package3_plane4_city6-2,7027134,3,5,246,251,0
4_1573783,in-city_city2-1_city2,1573783,4,1,3,4,0
4_192232,airport_city2-2,192232,4,1,73,74,0
4_3557810,in-city_city3-2_city3,3557810,4,1,3,4,0
4_5132251,location_city4-2,5132251,4,1,47,48,0
4_7347850,in-city_city10-2_city10,7347850,4,1,3,4,0
3_2926335,load-truck_package3_truck1_city1-2,2926335,3,5,112,117,0
4_6211241,in_package3_truck1,6211241,4,1,29,30,0
4_2661380,truck_truck1,2661380,4,1,15,16,0
3_1531636,unload-airplane_package5_plane1_city8-2,1531636,3,5,206,211,0
3_5608186,unload-airplane_package5_plane2_city6-2,5608186,3,5,204,209,0
3_3987536,load-airplane_package3_plane1_city10-2,3987536,3,5,245,250,0
3_3419986,load-airplane_package4_plane2_city3-2,3419986,3,5,379,384,0
3_7496536,load-airplane_package4_plane3_city1-2,7496536,3,5,249,254,0
4_650984,airport_city9-2,650984,4,1,73,74,0
4_2661381,truck_truck2,2661381,4,1,15,16,0
3_5581287,unload-airplane_package1_plane1_city9-2,5581287,3,5,206,211,0
3_4396837,unload-airplane_package4_plane1_city6-2,4396837,3,5,252,257,0
3_1552687,unload-airplane_package5_plane3_city2-2,1552687,3,5,249,254,0
3_6285187,load-airplane_package3_plane2_city1-2,6285187,3,5,245,250,0
3_6027187,load-airplane_package3_plane3_city10-2,6027187,3,5,285,290,0
3_5839237,load-truck_package4_truck8_city8-2,5839237,3,5,246,251,0
4_5040039,in_package4_truck8,5040039,4,1,30,31,0
4_2661382,truck_truck3,2661382,4,1,14,15,0
3_5786838,noop_at_package4_city5-2,5786838,3,1,242,243,0
4_7024213,in-city_city9-1_city9,7024213,4,1,3,4,0
3_1710288,noop_at_package3_city7-2,1710288,3,1,107,108,0
3_1525788,unload-airplane_package1_plane2_city5-2,1525788,3,5,204,209,0
3_5602338,unload-airplane_package1_plane3_city3-2,5602338,3,5,250,255,0
3_7262038,unload-airplane_package3_plane1_city4-2,7262038,3,5,252,257,0
3_341338,unload-airplane_package4_plane2_city2-2,341338,3,5,249,254,0
3_7955288,load-airplane_package4_plane3_city8-2,7955288,3,5,252,257,0
3_4305439,noop_at_package2_city10-2,4305439,3,1,13,14,0
4_2661383,truck_truck4,2661383,4,1,13,14,0
4_7351164,in-city_city2-2_city2,7351164,4,1,3,4,0
3_2011439,unload-airplane_package5_plane3_city9-2,2011439,3,5,250,255,0
3_6087989,unload-airplane_package5_plane4_city7-2,6087989,3,5,204,209,0
3_6743939,load-airplane_package3_plane2_city8-2,6743939,3,5,246,251,0
3_3899789,load-airplane_package4_plane4_city4-2,3899789,3,5,381,386,0
3_7931039,load-truck_package4_truck1_city1-2,7931039,3,5,244,249,0
4_5040032,in_package4_truck1,5040032,4,1,30,31,0
4_2661384,truck_truck5,2661384,4,1,13,14,0
3_6345090,noop_at_package4_city10-2,6345090,3,1,241,242,0
3_800090,unload-airplane_package4_plane2_city9-2,800090,3,5,250,255,0
3_2688440,load-airplane_package3_plane3_city4-2,2688440,3,5,286,291,0
3_6764990,load-airplane_package3_plane4_city2-2,6764990,3,5,245,250,0
3_5035440,load-airplane_package4_plane1_city10-2,5035440,3,5,379,384,0
3_1020740,load-truck_package4_truck5_city5-2,1020740,3,5,246,251,0
4_5040036,in_package4_truck5,5040036,4,1,31,32,0
4_2661385,truck_truck6,2661385,4,1,13,14,0
3_2005591,unload-airplane_package1_plane4_city6-2,2005591,3,5,204,209,0
3_7741841,unload-airplane_package3_plane3_city5-2,7741841,3,5,296,301,0
3_821141,unload-airplane_package4_plane4_city3-2,821141,3,5,250,255,0
3_7213341,load-airplane_package4_plane1_city3-2,7213341,3,5,379,384,0
3_7075091,load-airplane_package4_plane3_city10-2,7075091,3,5,251,256,0
3_5107691,load-truck_package3_truck9_city9-2,5107691,3,5,111,116,0
4_6211249,in_package3_truck9,6211249,4,1,28,29,0
4_2661386,truck_truck7,2661386,4,1,14,15,0
4_4800617,in-city_city9-2_city9,4800617,4,1,3,4,0
4_5328858,location_city7-1,5328858,4,1,6,7,0
3_1269492,unload-airplane_package5_plane1_city4-2,1269492,3,5,206,211,0
3_5346042,unload-airplane_package5_plane2_city2-2,5346042,3,5,203,208,0
3_7223742,load-airplane_package3_plane4_city9-2,7223742,3,5,246,251,0
4_6497292,city_city1,6497292,4,1,3,4,0
4_388840,airport_city5-2,388840,4,1,73,74,0
4_2661387,truck_truck8,2661387,4,1,13,14,0
4_5328859,location_city7-2,5328859,4,1,47,48,0
3_5319143,unload-airplane_package1_plane1_city5-2,5319143,3,5,206,211,0
3_4134693,unload-airplane_package4_plane1_city2-2,4134693,3,5,251,256,0
3_7199493,load-truck_package3_truck2_city2-2,7199493,3,5,112,117,0
4_6211242,in_package3_truck2,6211242,4,1,29,30,0
4_6497293,city_city2,6497293,4,1,3,4,0
4_2661388,truck_truck9,2661388,4,1,13,14,0
3_5524694,noop_at_package4_city1-2,5524694,3,1,239,240,0
4_518082,in-city_city10-1_city10,518082,4,1,3,4,0
3_1263644,unload-airplane_package1_plane2_city1-2,1263644,3,5,203,208,0
3_5804794,unload-airplane_package5_plane2_city9-2,5804794,3,5,204,209,0
3_3616594,load-airplane_package4_plane2_city6-2,3616594,3,5,381,386,0
3_7693144,load-airplane_package4_plane3_city4-2,7693144,3,5,252,257,0
3_289194,load-truck_package3_truck6_city6-2,289194,3,5,111,116,0
4_6211246,in_package3_truck6,6211246,4,1,28,29,0
4_6497294,city_city3,6497294,4,1,3,4,0
4_4435789,obj_package1,4435789,4,1,103,104,0
3_4593445,unload-airplane_package4_plane1_city9-2,4593445,3,5,252,257,0
3_1749295,unload-airplane_package5_plane3_city5-2,1749295,3,5,250,255,0
3_5825845,unload-airplane_package5_plane4_city3-2,5825845,3,5,204,209,0
3_2405245,load-airplane_package3_plane1_city6-2,2405245,3,5,246,251,0
3_6481795,load-airplane_package3_plane2_city4-2,6481795,3,5,246,251,0
4_6497295,city_city4,6497295,4,1,3,4,0
4_592994,in-city_city8-2_city8,592994,4,1,3,4,0
4_4435790,obj_package2,4435790,4,1,49,50,0
3_5983446,noop_at_package4_city8-2,5983446,3,1,242,243,0
3_1722396,unload-airplane_package1_plane2_city8-2,1722396,3,5,204,209,0
3_5798946,unload-airplane_package1_plane3_city6-2,5798946,3,5,250,255,0
3_7458646,unload-airplane_package3_plane1_city7-2,7458646,3,5,252,257,0
3_537946,unload-airplane_package4_plane2_city5-2,537946,3,5,250,255,0
3_7959946,load-airplane_package2_plane2_city10-2,7959946,3,5,169,174,0
4_4475738,in_package2_plane2,4475738,4,1,26,27,0
4_6497296,city_city5,6497296,4,1,3,4,0
4_4435791,obj_package3,4435791,4,1,112,113,0
3_7479697,unload-airplane_package3_plane3_city1-2,7479697,3,5,295,300,0
3_19847,load-airplane_package4_plane3_city9-2,19847,3,5,252,257,0
4_6497297,city_city6,6497297,4,1,3,4,0
4_4435792,obj_package4,4435792,4,1,112,113,0
4_5066714,location_city3-1,5066714,4,1,6,7,0
3_831548,unload-airplane_package4_plane4_city10-2,831548,3,5,249,254,0
3_2885048,load-airplane_package3_plane3_city7-2,2885048,3,5,291,296,0
3_6961598,load-airplane_package3_plane4_city5-2,6961598,3,5,246,251,0
3_7866348,load-truck_package4_truck10_city10-2,7866348,3,5,247,252,0
4_2090943,in_package4_truck10,2090943,4,1,30,31,0
3_5293898,load-truck_package4_truck6_city6-2,5293898,3,5,246,251,0
4_5040037,in_package4_truck6,5040037,4,1,31,32,0
4_6497298,city_city7,6497298,4,1,3,4,0
4_126696,airport_city1-2,126696,4,1,73,74,0
4_4435793,obj_package5,4435793,4,1,103,104,0
4_5066715,location_city3-2,5066715,4,1,47,48,0
3_5056999,unload-airplane_package1_plane1_city1-2,5056999,3,5,205,210,0
3_668499,unload-airplane_package1_plane3_city10-2,668499,3,5,249,254,0
3_2202199,unload-airplane_package1_plane4_city9-2,2202199,3,5,204,209,0
3_7938449,unload-airplane_package3_plane3_city8-2,7938449,3,5,296,301,0
3_1017749,unload-airplane_package4_plane4_city6-2,1017749,3,5,250,255,0
3_7409949,load-airplane_package4_plane1_city6-2,7409949,3,5,381,386,0
5_2937985,noop_in-city_city10-2_city10,2937985,5,1,1,2,0
5_7656764,drive-truck_truck10_city10-1_city10-2_city10,7656764,5,22,21,43,0
5_1874900,drive-truck_truck10_city10-2_city10-1_city10,1874900,5,20,19,39,0
5_2839184,noop_location_city4-1,2839184,5,1,1,2,0
5_4013645,drive-truck_truck4_city4-1_city4-2_city4,4013645,5,18,17,35,0
5_1256180,drive-truck_truck4_city4-2_city4-1_city4,1256180,5,16,15,31,0
5_4005501,noop_city_city9,4005501,5,1,1,2,0
5_5227117,drive-truck_truck9_city9-1_city9-2_city9,5227117,5,18,17,35,0
5_2469652,drive-truck_truck9_city9-2_city9-1_city9,2469652,5,16,15,31,0
5_5896302,noop_at_plane4_city2-2,5896302,5,175,182,357,0
5_5852660,fly-airplane_plane4_city2-2_city4-2,5852660,5,186,192,378,0
5_6049268,fly-airplane_plane4_city2-2_city7-2,6049268,5,186,192,378,0
5_5787124,fly-airplane_plane4_city2-2_city3-2,5787124,5,186,192,378,0
5_5983732,fly-airplane_plane4_city2-2_city6-2,5983732,5,186,192,378,0
5_6180340,fly-airplane_plane4_city2-2_city9-2,6180340,5,186,192,378,0
5_5918196,fly-airplane_plane4_city2-2_city5-2,5918196,5,186,192,378,0
5_5656052,fly-airplane_plane4_city2-2_city1-2,5656052,5,186,192,378,0
5_7968830,fly-airplane_plane4_city2-2_city10-2,7968830,5,186,192,378,0
5_6114804,fly-airplane_plane4_city2-2_city8-2,6114804,5,186,192,378,0
5_1743447,unload-airplane_package1_plane4_city2-2,1743447,5,269,291,560,0
5_3751878,unload-airplane_package3_plane4_city2-2,3751878,5,287,300,587,0
5_755605,unload-airplane_package4_plane4_city2-2,755605,5,287,300,587,0
5_5760309,unload-airplane_package5_plane4_city2-2,5760309,5,269,291,560,0
5_4756559,load-airplane_package1_plane4_city2-2,4756559,5,269,291,560,0
5_6764990,load-airplane_package3_plane4_city2-2,6764990,5,287,300,587,0
5_3768717,load-airplane_package4_plane4_city2-2,3768717,5,287,300,587,0
5_772444,load-airplane_package5_plane4_city2-2,772444,5,269,291,560,0
5_1111044,at_plane4_city6-2,1111044,5,28,29,57,0
5_4475740,in_package2_plane4,4475740,5,17,17,34,0
5_712137,at_plane4_city10-2,712137,5,27,29,56,0
5_914436,at_plane4_city3-2,914436,5,28,29,57,0
5_1307652,at_plane4_city9-2,1307652,5,28,28,56,0
5_1045508,at_plane4_city5-2,1045508,5,28,29,57,0
5_783364,at_plane4_city1-2,783364,5,28,29,57,0
5_1242116,at_plane4_city8-2,1242116,5,28,29,57,0
5_979972,at_plane4_city4-2,979972,5,28,29,57,0
5_1176580,at_plane4_city7-2,1176580,5,28,29,57,0
5_7670415,noop_at_plane3_city10-2,7670415,5,172,181,353,0
5_4181684,fly-airplane_plane3_city10-2_city4-2,4181684,5,185,192,377,0
5_4378292,fly-airplane_plane3_city10-2_city7-2,4378292,5,185,192,377,0
5_4116148,fly-airplane_plane3_city10-2_city3-2,4116148,5,185,192,377,0
5_4312756,fly-airplane_plane3_city10-2_city6-2,4312756,5,185,192,377,0
5_4050612,fly-airplane_plane3_city10-2_city2-2,4050612,5,185,192,377,0
5_4509364,fly-airplane_plane3_city10-2_city9-2,4509364,5,185,192,377,0
5_4247220,fly-airplane_plane3_city10-2_city5-2,4247220,5,185,192,377,0
5_3985076,fly-airplane_plane3_city10-2_city1-2,3985076,5,185,192,377,0
5_4443828,fly-airplane_plane3_city10-2_city8-2,4443828,5,185,192,377,0
5_668499,unload-airplane_package1_plane3_city10-2,668499,5,282,290,572,0
5_1716403,unload-airplane_package2_plane3_city10-2,1716403,5,210,227,437,0
5_2764307,unload-airplane_package3_plane3_city10-2,2764307,5,284,299,583,0
5_3812211,unload-airplane_package4_plane3_city10-2,3812211,5,284,299,583,0
5_4860115,unload-airplane_package5_plane3_city10-2,4860115,5,282,290,572,0
5_3931379,load-airplane_package1_plane3_city10-2,3931379,5,266,290,556,0
5_4979283,load-airplane_package2_plane3_city10-2,4979283,5,194,227,421,0
5_6027187,load-airplane_package3_plane3_city10-2,6027187,5,284,299,583,0
5_7075091,load-airplane_package4_plane3_city10-2,7075091,5,284,299,583,0
5_122018,load-airplane_package5_plane3_city10-2,122018,5,266,290,556,0
5_4904399,at_plane3_city6-2,4904399,5,28,29,57,0
5_4707791,at_plane3_city3-2,4707791,5,28,29,57,0
5_4969935,at_plane3_city7-2,4969935,5,28,29,57,0
5_4642255,at_plane3_city2-2,4642255,5,28,28,56,0
5_5101007,at_plane3_city9-2,5101007,5,28,29,57,0
5_4838863,at_plane3_city5-2,4838863,5,28,29,57,0
5_4576719,at_plane3_city1-2,4576719,5,28,29,57,0
5_5035471,at_plane3_city8-2,5035471,5,28,29,57,0
5_4773327,at_plane3_city4-2,4773327,5,28,29,57,0
5_1230485,noop_at_package1_city6-2,1230485,5,109,127,236,0
5_396814,load-airplane_package1_plane1_city6-2,396814,5,269,291,560,0
5_4604436,load-airplane_package1_plane2_city6-2,4604436,5,269,291,560,0
5_811081,load-airplane_package1_plane3_city6-2,811081,5,269,291,560,0
5_5018703,load-airplane_package1_plane4_city6-2,5018703,5,269,291,560,0
5_6281740,load-truck_package1_truck6_city6-2,6281740,5,116,133,249,0
5_5646949,in_package1_plane4,5646949,5,35,35,70,0
5_5646948,in_package1_plane3,5646948,5,43,35,78,0
5_5646947,in_package1_plane2,5646947,5,35,35,70,0
5_5646946,in_package1_plane1,5646946,5,35,35,70,0
5_6889493,at_package1_city3-2,6889493,5,24,30,54,0
5_7151637,at_package1_city7-2,7151637,5,24,30,54,0
5_552683,in_package1_truck2,552683,5,19,27,46,0
5_6955029,at_package1_city4-2,6955029,5,24,30,54,0
5_7217173,at_package1_city8-2,7217173,5,24,30,54,0
5_2140122,at_package1_city10-2,2140122,5,24,30,54,0
5_6758421,at_package1_city1-2,6758421,5,24,30,54,0
5_7020565,at_package1_city5-2,7020565,5,24,30,54,0
5_7282709,at_package1_city9-2,7282709,5,24,30,54,0
5_6823957,at_package1_city2-2,6823957,5,25,30,55,0
5_6823956,at_package1_city2-1,6823956,5,20,28,48,0
5_2839185,noop_location_city4-2,2839185,5,1,1,2,0
5_5253607,unload-airplane_package1_plane1_city4-2,5253607,5,269,291,560,0
5_1460252,unload-airplane_package1_plane2_city4-2,1460252,5,269,291,560,0
5_5667874,unload-airplane_package1_plane3_city4-2,5667874,5,285,291,576,0
5_1874519,unload-airplane_package1_plane4_city4-2,1874519,5,269,291,560,0
5_7262038,unload-airplane_package3_plane1_city4-2,7262038,5,287,300,587,0
5_3468683,unload-airplane_package3_plane2_city4-2,3468683,5,287,300,587,0
5_7676305,unload-airplane_package3_plane3_city4-2,7676305,5,287,300,587,0
5_3882950,unload-airplane_package3_plane4_city4-2,3882950,5,287,300,587,0
5_4265765,unload-airplane_package4_plane1_city4-2,4265765,5,287,300,587,0
5_472410,unload-airplane_package4_plane2_city4-2,472410,5,287,300,587,0
5_4680032,unload-airplane_package4_plane3_city4-2,4680032,5,287,300,587,0
5_886677,unload-airplane_package4_plane4_city4-2,886677,5,287,300,587,0
5_1269492,unload-airplane_package5_plane1_city4-2,1269492,5,269,291,560,0
5_5477114,unload-airplane_package5_plane2_city4-2,5477114,5,269,291,560,0
5_1683759,unload-airplane_package5_plane3_city4-2,1683759,5,285,291,576,0
5_5891381,unload-airplane_package5_plane4_city4-2,5891381,5,269,291,560,0
5_6986984,unload-truck_package3_truck4_city4-2,6986984,5,134,141,275,0
5_3990711,unload-truck_package4_truck4_city4-2,3990711,5,158,141,299,0
5_265742,load-airplane_package1_plane1_city4-2,265742,5,269,291,560,0
5_4473364,load-airplane_package1_plane2_city4-2,4473364,5,269,291,560,0
5_680009,load-airplane_package1_plane3_city4-2,680009,5,269,291,560,0
5_4887631,load-airplane_package1_plane4_city4-2,4887631,5,269,291,560,0
5_2274173,load-airplane_package3_plane1_city4-2,2274173,5,287,300,587,0
5_6481795,load-airplane_package3_plane2_city4-2,6481795,5,287,300,587,0
5_2688440,load-airplane_package3_plane3_city4-2,2688440,5,287,300,587,0
5_6896062,load-airplane_package3_plane4_city4-2,6896062,5,287,300,587,0
5_7278877,load-airplane_package4_plane1_city4-2,7278877,5,287,300,587,0
5_3485522,load-airplane_package4_plane2_city4-2,3485522,5,287,300,587,0
5_7693144,load-airplane_package4_plane3_city4-2,7693144,5,287,300,587,0
5_3899789,load-airplane_package4_plane4_city4-2,3899789,5,287,300,587,0
5_4282604,load-airplane_package5_plane1_city4-2,4282604,5,269,291,560,0
5_489249,load-airplane_package5_plane2_city4-2,489249,5,269,291,560,0
5_4696871,load-airplane_package5_plane3_city4-2,4696871,5,269,291,560,0
5_903516,load-airplane_package5_plane4_city4-2,903516,5,269,291,560,0
5_5736401,load-truck_package1_truck4_city4-2,5736401,5,116,133,249,0
5_7744832,load-truck_package3_truck4_city4-2,7744832,5,134,141,275,0
5_4748559,load-truck_package4_truck4_city4-2,4748559,5,134,141,275,0
5_1752286,load-truck_package5_truck4_city4-2,1752286,5,116,133,249,0
5_7198704,noop_in-city_city4-1_city4,7198704,5,1,1,2,0
5_6355054,noop_at_plane4_city9-2,6355054,5,175,182,357,0
5_1156223,fly-airplane_plane4_city9-2_city4-2,1156223,5,186,192,378,0
5_1352831,fly-airplane_plane4_city9-2_city7-2,1352831,5,186,192,378,0
5_1090687,fly-airplane_plane4_city9-2_city3-2,1090687,5,186,192,378,0
5_1287295,fly-airplane_plane4_city9-2_city6-2,1287295,5,186,192,378,0
5_1025151,fly-airplane_plane4_city9-2_city2-2,1025151,5,186,192,378,0
5_1221759,fly-airplane_plane4_city9-2_city5-2,1221759,5,186,192,378,0
5_959615,fly-airplane_plane4_city9-2_city1-2,959615,5,186,192,378,0
5_5827508,fly-airplane_plane4_city9-2_city10-2,5827508,5,186,192,378,0
5_1418367,fly-airplane_plane4_city9-2_city8-2,1418367,5,186,192,378,0
5_2202199,unload-airplane_package1_plane4_city9-2,2202199,5,269,291,560,0
5_4210630,unload-airplane_package3_plane4_city9-2,4210630,5,287,300,587,0
5_1214357,unload-airplane_package4_plane4_city9-2,1214357,5,287,300,587,0
5_6219061,unload-airplane_package5_plane4_city9-2,6219061,5,269,291,560,0
5_5215311,load-airplane_package1_plane4_city9-2,5215311,5,269,291,560,0
5_7223742,load-airplane_package3_plane4_city9-2,7223742,5,287,300,587,0
5_4227469,load-airplane_package4_plane4_city9-2,4227469,5,287,300,587,0
5_1231196,load-airplane_package5_plane4_city9-2,1231196,5,269,291,560,0
5_848900,at_plane4_city2-2,848900,5,28,20,48,0
5_1208877,noop_at_plane1_city1-2,1208877,5,175,182,357,0
5_5665861,fly-airplane_plane1_city1-2_city4-2,5665861,5,186,192,378,0
5_5862469,fly-airplane_plane1_city1-2_city7-2,5862469,5,186,192,378,0
5_5600325,fly-airplane_plane1_city1-2_city3-2,5600325,5,186,192,378,0
5_5796933,fly-airplane_plane1_city1-2_city6-2,5796933,5,186,192,378,0
5_5534789,fly-airplane_plane1_city1-2_city2-2,5534789,5,186,192,378,0
5_5993541,fly-airplane_plane1_city1-2_city9-2,5993541,5,186,192,378,0
5_5731397,fly-airplane_plane1_city1-2_city5-2,5731397,5,186,192,378,0
5_153171,fly-airplane_plane1_city1-2_city10-2,153171,5,186,192,378,0
5_5928005,fly-airplane_plane1_city1-2_city8-2,5928005,5,186,192,378,0
5_5056999,unload-airplane_package1_plane1_city1-2,5056999,5,269,291,560,0
5_7065430,unload-airplane_package3_plane1_city1-2,7065430,5,287,300,587,0
5_4069157,unload-airplane_package4_plane1_city1-2,4069157,5,287,300,587,0
5_1072884,unload-airplane_package5_plane1_city1-2,1072884,5,269,291,560,0
5_69134,load-airplane_package1_plane1_city1-2,69134,5,269,291,560,0
5_2077565,load-airplane_package3_plane1_city1-2,2077565,5,287,300,587,0
5_7082269,load-airplane_package4_plane1_city1-2,7082269,5,287,300,587,0
5_4085996,load-airplane_package5_plane1_city1-2,4085996,5,269,291,560,0
5_1653149,at_plane1_city10-2,1653149,5,27,29,56,0
5_4424596,at_plane1_city5-2,4424596,5,28,29,57,0
5_4686740,at_plane1_city9-2,4686740,5,28,29,57,0
5_4227988,at_plane1_city2-2,4227988,5,28,29,57,0
5_4475737,in_package2_plane1,4475737,5,17,17,34,0
5_4621204,at_plane1_city8-2,4621204,5,28,28,56,0
5_4359060,at_plane1_city4-2,4359060,5,28,29,57,0
5_4555668,at_plane1_city7-2,4555668,5,28,29,57,0
5_4293524,at_plane1_city3-2,4293524,5,28,29,57,0
5_4490132,at_plane1_city6-2,4490132,5,28,29,57,0
5_1731338,noop_at_package5_city1-1,1731338,5,118,135,253,0
5_4934765,load-truck_package5_truck1_city1-1,4934765,5,123,142,265,0
5_4279899,at_truck1_city1-2,4279899,5,4,12,16,0
5_7849099,at_package5_city5-2,7849099,5,24,30,54,0
5_6211241,in_package3_truck1,6211241,5,28,28,56,0
5_7652491,at_package5_city2-2,7652491,5,24,30,54,0
5_7914635,at_package5_city6-2,7914635,5,24,30,54,0
5_5040032,in_package4_truck1,5040032,5,30,28,58,0
5_44730,at_package5_city8-2,44730,5,24,30,54,0
5_7718027,at_package5_city3-2,7718027,5,24,30,54,0
5_6219424,at_package5_city10-2,6219424,5,24,30,54,0
5_3868823,in_package5_truck1,3868823,5,19,27,46,0
5_7980171,at_package5_city7-2,7980171,5,24,30,54,0
5_110266,at_package5_city9-2,110266,5,24,30,54,0
5_962113,in_package5_plane4,962113,5,35,35,70,0
5_7783563,at_package5_city4-2,7783563,5,24,30,54,0
5_962112,in_package5_plane3,962112,5,43,35,78,0
5_962111,in_package5_plane2,962111,5,35,35,70,0
5_962110,in_package5_plane1,962110,5,35,35,70,0
5_7586955,at_package5_city1-2,7586955,5,25,29,54,0
5_3507679,noop_at_truck9_city9-1,3507679,5,12,14,26,0
5_6211249,in_package3_truck9,6211249,5,27,27,54,0
5_5040040,in_package4_truck9,5040040,5,30,27,57,0
5_6461255,at_truck9_city9-2,6461255,5,3,11,14,0
5_1627007,noop_airport_city4-2,1627007,5,1,1,2,0
5_4992707,fly-airplane_plane1_city4-2_city7-2,4992707,5,186,192,378,0
5_4730563,fly-airplane_plane1_city4-2_city3-2,4730563,5,186,192,378,0
5_4927171,fly-airplane_plane1_city4-2_city6-2,4927171,5,186,192,378,0
5_4665027,fly-airplane_plane1_city4-2_city2-2,4665027,5,186,192,378,0
5_5123779,fly-airplane_plane1_city4-2_city9-2,5123779,5,186,192,378,0
5_4861635,fly-airplane_plane1_city4-2_city5-2,4861635,5,186,192,378,0
5_4599491,fly-airplane_plane1_city4-2_city1-2,4599491,5,186,192,378,0
5_1521455,fly-airplane_plane1_city4-2_city10-2,1521455,5,186,192,378,0
5_5058243,fly-airplane_plane1_city4-2_city8-2,5058243,5,186,192,378,0
5_3926337,fly-airplane_plane1_city7-2_city4-2,3926337,5,186,192,378,0
5_7753012,fly-airplane_plane1_city3-2_city4-2,7753012,5,186,192,378,0
5_6883250,fly-airplane_plane1_city6-2_city4-2,6883250,5,186,192,378,0
5_2708948,fly-airplane_plane1_city2-2_city4-2,2708948,5,186,192,378,0
5_6013488,fly-airplane_plane1_city9-2_city4-2,6013488,5,186,192,378,0
5_1839186,fly-airplane_plane1_city5-2_city4-2,1839186,5,186,192,378,0
5_3720295,fly-airplane_plane1_city10-2_city4-2,3720295,5,185,192,377,0
5_969424,fly-airplane_plane1_city8-2_city4-2,969424,5,186,192,378,0
5_6040611,fly-airplane_plane2_city4-2_city7-2,6040611,5,186,192,378,0
5_5778467,fly-airplane_plane2_city4-2_city3-2,5778467,5,186,192,378,0
5_5975075,fly-airplane_plane2_city4-2_city6-2,5975075,5,186,192,378,0
5_5712931,fly-airplane_plane2_city4-2_city2-2,5712931,5,186,192,378,0
5_6171683,fly-airplane_plane2_city4-2_city9-2,6171683,5,186,192,378,0
5_5909539,fly-airplane_plane2_city4-2_city5-2,5909539,5,186,192,378,0
5_5647395,fly-airplane_plane2_city4-2_city1-2,5647395,5,186,192,378,0
5_5752638,fly-airplane_plane2_city4-2_city10-2,5752638,5,186,192,378,0
5_6106147,fly-airplane_plane2_city4-2_city8-2,6106147,5,186,192,378,0
5_4974241,fly-airplane_plane2_city7-2_city4-2,4974241,5,186,192,378,0
5_799939,fly-airplane_plane2_city3-2_city4-2,799939,5,186,192,378,0
5_7931154,fly-airplane_plane2_city6-2_city4-2,7931154,5,186,192,378,0
5_3756852,fly-airplane_plane2_city2-2_city4-2,3756852,5,186,192,378,0
5_7061392,fly-airplane_plane2_city9-2_city4-2,7061392,5,186,192,378,0
5_2887090,fly-airplane_plane2_city5-2_city4-2,2887090,5,186,192,378,0
5_6713765,fly-airplane_plane2_city1-2_city4-2,6713765,5,186,192,378,0
5_7951478,fly-airplane_plane2_city10-2_city4-2,7951478,5,185,192,377,0
5_2017328,fly-airplane_plane2_city8-2_city4-2,2017328,5,186,192,378,0
5_7088515,fly-airplane_plane3_city4-2_city7-2,7088515,5,186,192,378,0
5_6826371,fly-airplane_plane3_city4-2_city3-2,6826371,5,186,192,378,0
5_7022979,fly-airplane_plane3_city4-2_city6-2,7022979,5,186,192,378,0
5_6760835,fly-airplane_plane3_city4-2_city2-2,6760835,5,186,192,378,0
5_7219587,fly-airplane_plane3_city4-2_city9-2,7219587,5,186,192,378,0
5_6957443,fly-airplane_plane3_city4-2_city5-2,6957443,5,186,192,378,0
5_6695299,fly-airplane_plane3_city4-2_city1-2,6695299,5,186,192,378,0
5_1982844,fly-airplane_plane3_city4-2_city10-2,1982844,5,186,192,378,0
5_7154051,fly-airplane_plane3_city4-2_city8-2,7154051,5,186,192,378,0
5_6022145,fly-airplane_plane3_city7-2_city4-2,6022145,5,186,192,378,0
5_1847843,fly-airplane_plane3_city3-2_city4-2,1847843,5,186,192,378,0
5_978081,fly-airplane_plane3_city6-2_city4-2,978081,5,186,192,378,0
5_4804756,fly-airplane_plane3_city2-2_city4-2,4804756,5,186,192,378,0
5_108319,fly-airplane_plane3_city9-2_city4-2,108319,5,186,192,378,0
5_3934994,fly-airplane_plane3_city5-2_city4-2,3934994,5,186,192,378,0
5_7761669,fly-airplane_plane3_city1-2_city4-2,7761669,5,186,192,378,0
5_3065232,fly-airplane_plane3_city8-2_city4-2,3065232,5,186,192,378,0
5_135442,fly-airplane_plane4_city4-2_city7-2,135442,5,186,192,378,0
5_7874275,fly-airplane_plane4_city4-2_city3-2,7874275,5,186,192,378,0
5_69906,fly-airplane_plane4_city4-2_city6-2,69906,5,186,192,378,0
5_7808739,fly-airplane_plane4_city4-2_city2-2,7808739,5,186,192,378,0
5_266514,fly-airplane_plane4_city4-2_city9-2,266514,5,186,192,378,0
5_4370,fly-airplane_plane4_city4-2_city5-2,4370,5,186,192,378,0
5_7743203,fly-airplane_plane4_city4-2_city1-2,7743203,5,186,192,378,0
5_6214027,fly-airplane_plane4_city4-2_city10-2,6214027,5,186,192,378,0
5_200978,fly-airplane_plane4_city4-2_city8-2,200978,5,186,192,378,0
5_7070049,fly-airplane_plane4_city7-2_city4-2,7070049,5,186,192,378,0
5_2895747,fly-airplane_plane4_city3-2_city4-2,2895747,5,186,192,378,0
5_2025985,fly-airplane_plane4_city6-2_city4-2,2025985,5,186,192,378,0
5_4982898,fly-airplane_plane4_city5-2_city4-2,4982898,5,186,192,378,0
5_808596,fly-airplane_plane4_city1-2_city4-2,808596,5,186,192,378,0
5_411890,fly-airplane_plane4_city10-2_city4-2,411890,5,185,192,377,0
5_4113136,fly-airplane_plane4_city8-2_city4-2,4113136,5,186,192,378,0
5_1667629,noop_at_plane1_city8-2,1667629,5,175,182,357,0
5_1166032,fly-airplane_plane1_city8-2_city7-2,1166032,5,186,192,378,0
5_903888,fly-airplane_plane1_city8-2_city3-2,903888,5,186,192,378,0
5_1100496,fly-airplane_plane1_city8-2_city6-2,1100496,5,186,192,378,0
5_838352,fly-airplane_plane1_city8-2_city2-2,838352,5,186,192,378,0
5_1297104,fly-airplane_plane1_city8-2_city9-2,1297104,5,186,192,378,0
5_1034960,fly-airplane_plane1_city8-2_city5-2,1034960,5,186,192,378,0
5_772816,fly-airplane_plane1_city8-2_city1-2,772816,5,186,192,378,0
5_6012826,fly-airplane_plane1_city8-2_city10-2,6012826,5,186,192,378,0
5_5515751,unload-airplane_package1_plane1_city8-2,5515751,5,269,291,560,0
5_7524182,unload-airplane_package3_plane1_city8-2,7524182,5,287,300,587,0
5_4527909,unload-airplane_package4_plane1_city8-2,4527909,5,287,300,587,0
5_1531636,unload-airplane_package5_plane1_city8-2,1531636,5,269,291,560,0
5_527886,load-airplane_package1_plane1_city8-2,527886,5,269,291,560,0
5_2536317,load-airplane_package3_plane1_city8-2,2536317,5,287,300,587,0
5_7541021,load-airplane_package4_plane1_city8-2,7541021,5,287,300,587,0
5_4544748,load-airplane_package5_plane1_city8-2,4544748,5,269,291,560,0
5_4162452,at_plane1_city1-2,4162452,5,28,20,48,0
5_1710288,noop_at_package3_city7-2,1710288,5,127,136,263,0
5_2470781,load-airplane_package3_plane1_city7-2,2470781,5,287,300,587,0
5_6678403,load-airplane_package3_plane2_city7-2,6678403,5,287,300,587,0
5_2885048,load-airplane_package3_plane3_city7-2,2885048,5,287,300,587,0
5_7092670,load-airplane_package3_plane4_city7-2,7092670,5,287,300,587,0
5_4562352,load-truck_package3_truck7_city7-2,4562352,5,137,142,279,0
5_6211248,in_package3_truck8,6211248,5,27,27,54,0
5_5884298,in_package3_truck10,5884298,5,27,27,54,0
5_6211247,in_package3_truck7,6211247,5,28,28,56,0
5_7369296,at_package3_city4-2,7369296,5,34,30,64,0
5_6211246,in_package3_truck6,6211246,5,27,27,54,0
5_6211245,in_package3_truck5,6211245,5,27,27,54,0
5_6211244,in_package3_truck4,6211244,5,27,27,54,0
5_6211243,in_package3_truck3,6211243,5,28,27,55,0
5_6211242,in_package3_truck2,6211242,5,28,28,56,0
5_7631440,at_package3_city8-2,7631440,5,34,30,64,0
5_7172688,at_package3_city1-2,7172688,5,34,30,64,0
5_7303759,at_package3_city3-1,7303759,5,28,28,56,0
5_7303760,at_package3_city3-2,7303760,5,34,30,64,0
5_7500368,at_package3_city6-2,7500368,5,34,30,64,0
5_4179773,at_package3_city10-2,4179773,5,34,30,64,0
5_7238224,at_package3_city2-2,7238224,5,34,30,64,0
5_7696976,at_package3_city9-2,7696976,5,34,30,64,0
5_3304528,in_package3_plane1,3304528,5,44,35,79,0
5_3304529,in_package3_plane2,3304529,5,44,35,79,0
5_3304530,in_package3_plane3,3304530,5,44,35,79,0
5_3304531,in_package3_plane4,3304531,5,44,35,79,0
5_7434832,at_package3_city5-2,7434832,5,34,30,64,0
5_1731339,noop_at_package5_city1-2,1731339,5,109,127,236,0
5_292641,load-airplane_package5_plane2_city1-2,292641,5,269,291,560,0
5_4500263,load-airplane_package5_plane3_city1-2,4500263,5,269,291,560,0
5_706908,load-airplane_package5_plane4_city1-2,706908,5,269,291,560,0
5_4934766,load-truck_package5_truck1_city1-2,4934766,5,116,133,249,0
5_7586954,at_package5_city1-1,7586954,5,20,5,25,0
5_3507680,noop_at_truck9_city9-2,3507680,5,4,6,10,0
5_4349843,unload-truck_package3_truck9_city9-2,4349843,5,134,141,275,0
5_1353570,unload-truck_package4_truck9_city9-2,1353570,5,158,141,299,0
5_3099260,load-truck_package1_truck9_city9-2,3099260,5,116,133,249,0
5_5107691,load-truck_package3_truck9_city9-2,5107691,5,134,141,275,0
5_2111418,load-truck_package4_truck9_city9-2,2111418,5,134,141,275,0
5_7116122,load-truck_package5_truck9_city9-2,7116122,5,116,133,249,0
5_6461254,at_truck9_city9-1,6461254,5,5,9,14,0
5_1688680,noop_at_plane3_city2-2,1688680,5,175,182,357,0
5_5001364,fly-airplane_plane3_city2-2_city7-2,5001364,5,186,192,378,0
5_4739220,fly-airplane_plane3_city2-2_city3-2,4739220,5,186,192,378,0
5_4935828,fly-airplane_plane3_city2-2_city6-2,4935828,5,186,192,378,0
5_5132436,fly-airplane_plane3_city2-2_city9-2,5132436,5,186,192,378,0
5_4870292,fly-airplane_plane3_city2-2_city5-2,4870292,5,186,192,378,0
5_4608148,fly-airplane_plane3_city2-2_city1-2,4608148,5,186,192,378,0
5_3737647,fly-airplane_plane3_city2-2_city10-2,3737647,5,186,192,378,0
5_5066900,fly-airplane_plane3_city2-2_city8-2,5066900,5,186,192,378,0
5_5536802,unload-airplane_package1_plane3_city2-2,5536802,5,285,291,576,0
5_7545233,unload-airplane_package3_plane3_city2-2,7545233,5,287,300,587,0
5_4548960,unload-airplane_package4_plane3_city2-2,4548960,5,287,300,587,0
5_1552687,unload-airplane_package5_plane3_city2-2,1552687,5,285,291,576,0
5_548937,load-airplane_package1_plane3_city2-2,548937,5,269,291,560,0
5_2557368,load-airplane_package3_plane3_city2-2,2557368,5,287,300,587,0
5_7562072,load-airplane_package4_plane3_city2-2,7562072,5,287,300,587,0
5_4565799,load-airplane_package5_plane3_city2-2,4565799,5,269,291,560,0
5_4475739,in_package2_plane3,4475739,5,25,17,42,0
5_3692800,at_plane3_city10-2,3692800,5,27,20,47,0
5_5613107,noop_at_plane2_city4-2,5613107,5,175,182,357,0
5_827849,at_plane2_city8-2,827849,5,28,29,57,0
5_369097,at_plane2_city1-2,369097,5,28,29,57,0
5_631241,at_plane2_city5-2,631241,5,28,29,57,0
5_4475738,in_package2_plane2,4475738,5,17,17,34,0
5_893385,at_plane2_city9-2,893385,5,28,29,57,0
5_762313,at_plane2_city7-2,762313,5,28,28,56,0
5_6673463,at_plane2_city10-2,6673463,5,27,29,56,0
5_500169,at_plane2_city3-2,500169,5,28,29,57,0
5_696777,at_plane2_city6-2,696777,5,28,29,57,0
5_434633,at_plane2_city2-2,434633,5,28,29,57,0
5_5655766,noop_at_package4_city3-2,5655766,5,127,136,263,0
5_7213341,load-airplane_package4_plane1_city3-2,7213341,5,287,300,587,0
5_3419986,load-airplane_package4_plane2_city3-2,3419986,5,287,300,587,0
5_7627608,load-airplane_package4_plane3_city3-2,7627608,5,287,300,587,0
5_3834253,load-airplane_package4_plane4_city3-2,3834253,5,287,300,587,0
5_475401,load-truck_package4_truck3_city3-2,475401,5,137,142,279,0
5_3772549,at_package4_city7-2,3772549,5,34,30,64,0
5_3772548,at_package4_city7-1,3772548,5,28,29,57,0
5_2090943,in_package4_truck10,2090943,5,29,27,56,0
5_3575941,at_package4_city4-2,3575941,5,34,30,64,0
5_5040039,in_package4_truck8,5040039,5,30,27,57,0
5_5040038,in_package4_truck7,5040038,5,28,27,55,0
5_5040037,in_package4_truck6,5040037,5,30,27,57,0
5_5040036,in_package4_truck5,5040036,5,30,27,57,0
5_3838085,at_package4_city8-2,3838085,5,34,30,64,0
5_5040035,in_package4_truck4,5040035,5,30,27,57,0
5_5040034,in_package4_truck3,5040034,5,31,28,59,0
5_5040033,in_package4_truck2,5040033,5,30,28,58,0
5_1199110,at_package4_city10-2,1199110,5,34,29,63,0
5_3707013,at_package4_city6-2,3707013,5,34,30,64,0
5_3444869,at_package4_city2-2,3444869,5,34,30,64,0
5_2133319,in_package4_plane1,2133319,5,44,35,79,0
5_2133320,in_package4_plane2,2133320,5,44,35,79,0
5_3903621,at_package4_city9-2,3903621,5,34,30,64,0
5_2133321,in_package4_plane3,2133321,5,44,35,79,0
5_2133322,in_package4_plane4,2133322,5,44,35,79,0
5_3641477,at_package4_city5-2,3641477,5,34,30,64,0
5_3379333,at_package4_city1-2,3379333,5,34,30,64,0
5_968340,noop_at_package1_city2-1,968340,5,118,135,253,0
5_5191061,load-truck_package1_truck2_city2-1,5191061,5,123,142,265,0
5_552080,at_truck2_city2-2,552080,5,4,12,16,0
5_7086101,at_package1_city6-2,7086101,5,24,6,30,0
5_2991081,noop_in-city_city3-1_city3,2991081,5,1,1,2,0
5_5371146,drive-truck_truck3_city3-1_city3-2_city3,5371146,5,19,18,37,0
5_2613681,drive-truck_truck3_city3-2_city3-1_city3,2613681,5,19,16,35,0
5_968341,noop_at_package1_city2-2,968341,5,109,127,236,0
5_134670,load-airplane_package1_plane1_city2-2,134670,5,269,291,560,0
5_4342292,load-airplane_package1_plane2_city2-2,4342292,5,269,291,560,0
5_5191062,load-truck_package1_truck2_city2-2,5191062,5,116,133,249,0
5_6690159,noop_at_truck6_city6-1,6690159,5,12,14,26,0
5_1298643,drive-truck_truck6_city6-1_city6-2_city6,1298643,5,18,17,35,0
5_1642758,at_truck6_city6-2,1642758,5,3,11,14,0
5_2147432,noop_at_plane3_city9-2,2147432,5,175,182,357,0
5_304927,fly-airplane_plane3_city9-2_city7-2,304927,5,186,192,378,0
5_42783,fly-airplane_plane3_city9-2_city3-2,42783,5,186,192,378,0
5_239391,fly-airplane_plane3_city9-2_city6-2,239391,5,186,192,378,0
5_7978224,fly-airplane_plane3_city9-2_city2-2,7978224,5,186,192,378,0
5_173855,fly-airplane_plane3_city9-2_city5-2,173855,5,186,192,378,0
5_7912688,fly-airplane_plane3_city9-2_city1-2,7912688,5,186,192,378,0
5_1596325,fly-airplane_plane3_city9-2_city10-2,1596325,5,186,192,378,0
5_370463,fly-airplane_plane3_city9-2_city8-2,370463,5,186,192,378,0
5_5995554,unload-airplane_package1_plane3_city9-2,5995554,5,285,291,576,0
5_3008,unload-airplane_package3_plane3_city9-2,3008,5,287,300,587,0
5_5007712,unload-airplane_package4_plane3_city9-2,5007712,5,287,300,587,0
5_2011439,unload-airplane_package5_plane3_city9-2,2011439,5,285,291,576,0
5_1007689,load-airplane_package1_plane3_city9-2,1007689,5,269,291,560,0
5_3016120,load-airplane_package3_plane3_city9-2,3016120,5,287,300,587,0
5_19847,load-airplane_package4_plane3_city9-2,19847,5,287,300,587,0
5_5024551,load-airplane_package5_plane3_city9-2,5024551,5,269,291,560,0
5_3035792,noop_location_city7-1,3035792,5,1,1,2,0
5_7942119,drive-truck_truck7_city7-1_city7-2_city7,7942119,5,19,18,37,0
5_5184654,drive-truck_truck7_city7-2_city7-1_city7,5184654,5,19,16,35,0
5_808230,unload-truck_package4_truck7_city7-1,808230,5,139,148,287,0
5_1566078,load-truck_package4_truck7_city7-1,1566078,5,139,150,289,0
5_6690160,noop_at_truck6_city6-2,6690160,5,4,6,10,0
5_6542155,drive-truck_truck6_city6-2_city6-1_city6,6542155,5,16,15,31,0
5_7532323,unload-truck_package3_truck6_city6-2,7532323,5,134,141,275,0
5_4536050,unload-truck_package4_truck6_city6-2,4536050,5,158,141,299,0
5_289194,load-truck_package3_truck6_city6-2,289194,5,134,141,275,0
5_5293898,load-truck_package4_truck6_city6-2,5293898,5,134,141,275,0
5_2297625,load-truck_package5_truck6_city6-2,2297625,5,116,133,249,0
5_1642757,at_truck6_city6-1,1642757,5,5,10,15,0
5_6092910,noop_at_plane4_city5-2,6092910,5,175,182,357,0
5_5179506,fly-airplane_plane4_city5-2_city7-2,5179506,5,186,192,378,0
5_4917362,fly-airplane_plane4_city5-2_city3-2,4917362,5,186,192,378,0
5_5113970,fly-airplane_plane4_city5-2_city6-2,5113970,5,186,192,378,0
5_4851826,fly-airplane_plane4_city5-2_city2-2,4851826,5,186,192,378,0
5_5310578,fly-airplane_plane4_city5-2_city9-2,5310578,5,186,192,378,0
5_4786290,fly-airplane_plane4_city5-2_city1-2,4786290,5,186,192,378,0
5_1336137,fly-airplane_plane4_city5-2_city10-2,1336137,5,186,192,378,0
5_5245042,fly-airplane_plane4_city5-2_city8-2,5245042,5,186,192,378,0
5_1940055,unload-airplane_package1_plane4_city5-2,1940055,5,269,291,560,0
5_3948486,unload-airplane_package3_plane4_city5-2,3948486,5,287,300,587,0
5_952213,unload-airplane_package4_plane4_city5-2,952213,5,287,300,587,0
5_5956917,unload-airplane_package5_plane4_city5-2,5956917,5,269,291,560,0
5_4953167,load-airplane_package1_plane4_city5-2,4953167,5,269,291,560,0
5_6961598,load-airplane_package3_plane4_city5-2,6961598,5,287,300,587,0
5_3965325,load-airplane_package4_plane4_city5-2,3965325,5,287,300,587,0
5_969052,load-airplane_package5_plane4_city5-2,969052,5,269,291,560,0
5_1427093,noop_at_package1_city9-2,1427093,5,109,127,236,0
5_593422,load-airplane_package1_plane1_city9-2,593422,5,269,291,560,0
5_4801044,load-airplane_package1_plane2_city9-2,4801044,5,269,291,560,0
5_1448143,noop_at_package3_city3-1,1448143,5,134,143,277,0
5_3471673,load-truck_package3_truck3_city3-1,3471673,5,139,150,289,0
5_4825238,at_truck3_city3-2,4825238,5,4,12,16,0
5_7565904,at_package3_city7-2,7565904,5,34,6,40,0
5_3035793,noop_location_city7-2,3035793,5,1,1,2,0
5_5450215,unload-airplane_package1_plane1_city7-2,5450215,5,269,291,560,0
5_1656860,unload-airplane_package1_plane2_city7-2,1656860,5,269,291,560,0
5_5864482,unload-airplane_package1_plane3_city7-2,5864482,5,285,291,576,0
5_2071127,unload-airplane_package1_plane4_city7-2,2071127,5,269,291,560,0
5_7458646,unload-airplane_package3_plane1_city7-2,7458646,5,287,300,587,0
5_3665291,unload-airplane_package3_plane2_city7-2,3665291,5,287,300,587,0
5_7872913,unload-airplane_package3_plane3_city7-2,7872913,5,287,300,587,0
5_4079558,unload-airplane_package3_plane4_city7-2,4079558,5,287,300,587,0
5_4462373,unload-airplane_package4_plane1_city7-2,4462373,5,287,300,587,0
5_669018,unload-airplane_package4_plane2_city7-2,669018,5,287,300,587,0
5_4876640,unload-airplane_package4_plane3_city7-2,4876640,5,287,300,587,0
5_1083285,unload-airplane_package4_plane4_city7-2,1083285,5,287,300,587,0
5_1466100,unload-airplane_package5_plane1_city7-2,1466100,5,269,291,560,0
5_5673722,unload-airplane_package5_plane2_city7-2,5673722,5,269,291,560,0
5_1880367,unload-airplane_package5_plane3_city7-2,1880367,5,285,291,576,0
5_6087989,unload-airplane_package5_plane4_city7-2,6087989,5,269,291,560,0
5_3804504,unload-truck_package3_truck7_city7-2,3804504,5,137,143,280,0
5_808231,unload-truck_package4_truck7_city7-2,808231,5,134,141,275,0
5_462350,load-airplane_package1_plane1_city7-2,462350,5,269,291,560,0
5_4669972,load-airplane_package1_plane2_city7-2,4669972,5,269,291,560,0
5_876617,load-airplane_package1_plane3_city7-2,876617,5,269,291,560,0
5_5084239,load-airplane_package1_plane4_city7-2,5084239,5,269,291,560,0
5_7475485,load-airplane_package4_plane1_city7-2,7475485,5,287,300,587,0
5_3682130,load-airplane_package4_plane2_city7-2,3682130,5,287,300,587,0
5_7889752,load-airplane_package4_plane3_city7-2,7889752,5,287,300,587,0
5_4096397,load-airplane_package4_plane4_city7-2,4096397,5,287,300,587,0
5_4479212,load-airplane_package5_plane1_city7-2,4479212,5,269,291,560,0
5_685857,load-airplane_package5_plane2_city7-2,685857,5,269,291,560,0
5_4893479,load-airplane_package5_plane3_city7-2,4893479,5,269,291,560,0
5_1100124,load-airplane_package5_plane4_city7-2,1100124,5,269,291,560,0
5_2553921,load-truck_package1_truck7_city7-2,2553921,5,119,134,253,0
5_1566079,load-truck_package4_truck7_city7-2,1566079,5,134,141,275,0
5_6570783,load-truck_package5_truck7_city7-2,6570783,5,119,134,253,0
5_4939725,noop_in_package5_plane1,4939725,5,109,127,236,0
5_1203956,unload-airplane_package5_plane1_city3-2,1203956,5,269,291,560,0
5_1400564,unload-airplane_package5_plane1_city6-2,1400564,5,269,291,560,0
5_1138420,unload-airplane_package5_plane1_city2-2,1138420,5,269,291,560,0
5_1597172,unload-airplane_package5_plane1_city9-2,1597172,5,269,291,560,0
5_1335028,unload-airplane_package5_plane1_city5-2,1335028,5,269,291,560,0
5_2820464,unload-airplane_package5_plane1_city10-2,2820464,5,266,290,556,0
5_1448144,noop_at_package3_city3-2,1448144,5,127,136,263,0
5_2208637,load-airplane_package3_plane1_city3-2,2208637,5,287,300,587,0
5_6416259,load-airplane_package3_plane2_city3-2,6416259,5,287,300,587,0
5_2622904,load-airplane_package3_plane3_city3-2,2622904,5,287,300,587,0
5_6830526,load-airplane_package3_plane4_city3-2,6830526,5,287,300,587,0
5_3471674,load-truck_package3_truck3_city3-2,3471674,5,134,141,275,0
5_767485,noop_in-city_city3-2_city3,767485,5,1,1,2,0
5_5018863,noop_airplane_plane1,5018863,5,1,1,2,0
5_3860801,fly-airplane_plane1_city7-2_city3-2,3860801,5,186,192,378,0
5_4057409,fly-airplane_plane1_city7-2_city6-2,4057409,5,186,192,378,0
5_3795265,fly-airplane_plane1_city7-2_city2-2,3795265,5,186,192,378,0
5_4254017,fly-airplane_plane1_city7-2_city9-2,4254017,5,186,192,378,0
5_3991873,fly-airplane_plane1_city7-2_city5-2,3991873,5,186,192,378,0
5_3729729,fly-airplane_plane1_city7-2_city1-2,3729729,5,186,192,378,0
5_2889739,fly-airplane_plane1_city7-2_city10-2,2889739,5,186,192,378,0
5_4188481,fly-airplane_plane1_city7-2_city8-2,4188481,5,186,192,378,0
5_7949620,fly-airplane_plane1_city3-2_city7-2,7949620,5,186,192,378,0
5_7884084,fly-airplane_plane1_city3-2_city6-2,7884084,5,186,192,378,0
5_7621940,fly-airplane_plane1_city3-2_city2-2,7621940,5,186,192,378,0
5_79715,fly-airplane_plane1_city3-2_city9-2,79715,5,186,192,378,0
5_7818548,fly-airplane_plane1_city3-2_city5-2,7818548,5,186,192,378,0
5_7556404,fly-airplane_plane1_city3-2_city1-2,7556404,5,186,192,378,0
5_6399345,fly-airplane_plane1_city3-2_city10-2,6399345,5,186,192,378,0
5_14179,fly-airplane_plane1_city3-2_city8-2,14179,5,186,192,378,0
5_7079858,fly-airplane_plane1_city6-2_city7-2,7079858,5,186,192,378,0
5_6817714,fly-airplane_plane1_city6-2_city3-2,6817714,5,186,192,378,0
5_6752178,fly-airplane_plane1_city6-2_city2-2,6752178,5,186,192,378,0
5_7210930,fly-airplane_plane1_city6-2_city9-2,7210930,5,186,192,378,0
5_6948786,fly-airplane_plane1_city6-2_city5-2,6948786,5,186,192,378,0
5_6686642,fly-airplane_plane1_city6-2_city1-2,6686642,5,186,192,378,0
5_7767629,fly-airplane_plane1_city6-2_city10-2,7767629,5,186,192,378,0
5_7145394,fly-airplane_plane1_city6-2_city8-2,7145394,5,186,192,378,0
5_2905556,fly-airplane_plane1_city2-2_city7-2,2905556,5,186,192,378,0
5_2643412,fly-airplane_plane1_city2-2_city3-2,2643412,5,186,192,378,0
5_2840020,fly-airplane_plane1_city2-2_city6-2,2840020,5,186,192,378,0
5_3036628,fly-airplane_plane1_city2-2_city9-2,3036628,5,186,192,378,0
5_2774484,fly-airplane_plane1_city2-2_city5-2,2774484,5,186,192,378,0
5_2512340,fly-airplane_plane1_city2-2_city1-2,2512340,5,186,192,378,0
5_3276258,fly-airplane_plane1_city2-2_city10-2,3276258,5,186,192,378,0
5_2971092,fly-airplane_plane1_city2-2_city8-2,2971092,5,186,192,378,0
5_6210096,fly-airplane_plane1_city9-2_city7-2,6210096,5,186,192,378,0
5_5947952,fly-airplane_plane1_city9-2_city3-2,5947952,5,186,192,378,0
5_6144560,fly-airplane_plane1_city9-2_city6-2,6144560,5,186,192,378,0
5_5882416,fly-airplane_plane1_city9-2_city2-2,5882416,5,186,192,378,0
5_6079024,fly-airplane_plane1_city9-2_city5-2,6079024,5,186,192,378,0
5_5816880,fly-airplane_plane1_city9-2_city1-2,5816880,5,186,192,378,0
5_1134936,fly-airplane_plane1_city9-2_city10-2,1134936,5,186,192,378,0
5_6275632,fly-airplane_plane1_city9-2_city8-2,6275632,5,186,192,378,0
5_2035794,fly-airplane_plane1_city5-2_city7-2,2035794,5,186,192,378,0
5_1773650,fly-airplane_plane1_city5-2_city3-2,1773650,5,186,192,378,0
5_1970258,fly-airplane_plane1_city5-2_city6-2,1970258,5,186,192,378,0
5_1708114,fly-airplane_plane1_city5-2_city2-2,1708114,5,186,192,378,0
5_2166866,fly-airplane_plane1_city5-2_city9-2,2166866,5,186,192,378,0
5_1642578,fly-airplane_plane1_city5-2_city1-2,1642578,5,186,192,378,0
5_4644542,fly-airplane_plane1_city5-2_city10-2,4644542,5,186,192,378,0
5_2101330,fly-airplane_plane1_city5-2_city8-2,2101330,5,186,192,378,0
5_3916903,fly-airplane_plane1_city10-2_city7-2,3916903,5,185,192,377,0
5_3654759,fly-airplane_plane1_city10-2_city3-2,3654759,5,185,192,377,0
5_3851367,fly-airplane_plane1_city10-2_city6-2,3851367,5,185,192,377,0
5_3589223,fly-airplane_plane1_city10-2_city2-2,3589223,5,185,192,377,0
5_4047975,fly-airplane_plane1_city10-2_city9-2,4047975,5,185,192,377,0
5_3785831,fly-airplane_plane1_city10-2_city5-2,3785831,5,185,192,377,0
5_3523687,fly-airplane_plane1_city10-2_city1-2,3523687,5,185,192,377,0
5_3982439,fly-airplane_plane1_city10-2_city8-2,3982439,5,185,192,377,0
5_5188071,unload-airplane_package1_plane1_city3-2,5188071,5,269,291,560,0
5_5384679,unload-airplane_package1_plane1_city6-2,5384679,5,269,291,560,0
5_5122535,unload-airplane_package1_plane1_city2-2,5122535,5,269,291,560,0
5_5581287,unload-airplane_package1_plane1_city9-2,5581287,5,269,291,560,0
5_5319143,unload-airplane_package1_plane1_city5-2,5319143,5,269,291,560,0
5_6629825,unload-airplane_package1_plane1_city10-2,6629825,5,266,290,556,0
5_7677729,unload-airplane_package2_plane1_city10-2,7677729,5,194,227,421,0
5_7196502,unload-airplane_package3_plane1_city3-2,7196502,5,287,300,587,0
5_7393110,unload-airplane_package3_plane1_city6-2,7393110,5,287,300,587,0
5_7130966,unload-airplane_package3_plane1_city2-2,7130966,5,287,300,587,0
5_7589718,unload-airplane_package3_plane1_city9-2,7589718,5,287,300,587,0
5_7327574,unload-airplane_package3_plane1_city5-2,7327574,5,287,300,587,0
5_724656,unload-airplane_package3_plane1_city10-2,724656,5,284,299,583,0
5_4200229,unload-airplane_package4_plane1_city3-2,4200229,5,287,300,587,0
5_4396837,unload-airplane_package4_plane1_city6-2,4396837,5,287,300,587,0
5_4134693,unload-airplane_package4_plane1_city2-2,4134693,5,287,300,587,0
5_4593445,unload-airplane_package4_plane1_city9-2,4593445,5,287,300,587,0
5_4331301,unload-airplane_package4_plane1_city5-2,4331301,5,287,300,587,0
5_1772560,unload-airplane_package4_plane1_city10-2,1772560,5,284,299,583,0
5_200206,load-airplane_package1_plane1_city3-2,200206,5,269,291,560,0
5_331278,load-airplane_package1_plane1_city5-2,331278,5,269,291,560,0
5_1891728,load-airplane_package1_plane1_city10-2,1891728,5,266,290,556,0
5_2939632,load-airplane_package2_plane1_city10-2,2939632,5,194,227,421,0
5_2405245,load-airplane_package3_plane1_city6-2,2405245,5,287,300,587,0
5_2143101,load-airplane_package3_plane1_city2-2,2143101,5,287,300,587,0
5_2601853,load-airplane_package3_plane1_city9-2,2601853,5,287,300,587,0
5_2339709,load-airplane_package3_plane1_city5-2,2339709,5,287,300,587,0
5_3987536,load-airplane_package3_plane1_city10-2,3987536,5,284,299,583,0
5_7409949,load-airplane_package4_plane1_city6-2,7409949,5,287,300,587,0
5_7147805,load-airplane_package4_plane1_city2-2,7147805,5,287,300,587,0
5_7606557,load-airplane_package4_plane1_city9-2,7606557,5,287,300,587,0
5_7344413,load-airplane_package4_plane1_city5-2,7344413,5,287,300,587,0
5_5035440,load-airplane_package4_plane1_city10-2,5035440,5,284,299,583,0
5_4217068,load-airplane_package5_plane1_city3-2,4217068,5,269,291,560,0
5_4413676,load-airplane_package5_plane1_city6-2,4413676,5,269,291,560,0
5_4151532,load-airplane_package5_plane1_city2-2,4151532,5,269,291,560,0
5_4610284,load-airplane_package5_plane1_city9-2,4610284,5,269,291,560,0
5_4348140,load-airplane_package5_plane1_city5-2,4348140,5,269,291,560,0
5_6083344,load-airplane_package5_plane1_city10-2,6083344,5,266,290,556,0
5_1405485,noop_at_plane1_city4-2,1405485,5,175,182,357,0
5_6345090,noop_at_package4_city10-2,6345090,5,127,136,263,0
5_2054777,load-airplane_package4_plane2_city10-2,2054777,5,284,299,583,0
5_4094428,load-airplane_package4_plane4_city10-2,4094428,5,284,299,583,0
5_7866348,load-truck_package4_truck10_city10-2,7866348,5,136,143,279,0
5_3510405,at_package4_city3-2,3510405,5,34,7,41,0
5_4939726,noop_in_package5_plane2,4939726,5,109,127,236,0
5_5411578,unload-airplane_package5_plane2_city3-2,5411578,5,269,291,560,0
5_5608186,unload-airplane_package5_plane2_city6-2,5608186,5,269,291,560,0
5_5346042,unload-airplane_package5_plane2_city2-2,5346042,5,269,291,560,0
5_5804794,unload-airplane_package5_plane2_city9-2,5804794,5,269,291,560,0
5_5542650,unload-airplane_package5_plane2_city5-2,5542650,5,269,291,560,0
5_5280506,unload-airplane_package5_plane2_city1-2,5280506,5,269,291,560,0
5_5739258,unload-airplane_package5_plane2_city8-2,5739258,5,269,291,560,0
5_7840778,unload-airplane_package5_plane2_city10-2,7840778,5,266,290,556,0
5_5018864,noop_airplane_plane2,5018864,5,1,1,2,0
5_4908705,fly-airplane_plane2_city7-2_city3-2,4908705,5,186,192,378,0
5_5105313,fly-airplane_plane2_city7-2_city6-2,5105313,5,186,192,378,0
5_4843169,fly-airplane_plane2_city7-2_city2-2,4843169,5,186,192,378,0
5_5301921,fly-airplane_plane2_city7-2_city9-2,5301921,5,186,192,378,0
5_5039777,fly-airplane_plane2_city7-2_city5-2,5039777,5,186,192,378,0
5_4777633,fly-airplane_plane2_city7-2_city1-2,4777633,5,186,192,378,0
5_7120922,fly-airplane_plane2_city7-2_city10-2,7120922,5,186,192,378,0
5_5236385,fly-airplane_plane2_city7-2_city8-2,5236385,5,186,192,378,0
5_996547,fly-airplane_plane2_city3-2_city7-2,996547,5,186,192,378,0
5_931011,fly-airplane_plane2_city3-2_city6-2,931011,5,186,192,378,0
5_668867,fly-airplane_plane2_city3-2_city2-2,668867,5,186,192,378,0
5_1127619,fly-airplane_plane2_city3-2_city9-2,1127619,5,186,192,378,0
5_865475,fly-airplane_plane2_city3-2_city5-2,865475,5,186,192,378,0
5_603331,fly-airplane_plane2_city3-2_city1-2,603331,5,186,192,378,0
5_2629551,fly-airplane_plane2_city3-2_city10-2,2629551,5,186,192,378,0
5_1062083,fly-airplane_plane2_city3-2_city8-2,1062083,5,186,192,378,0
5_126785,fly-airplane_plane2_city6-2_city7-2,126785,5,186,192,378,0
5_7865618,fly-airplane_plane2_city6-2_city3-2,7865618,5,186,192,378,0
5_7800082,fly-airplane_plane2_city6-2_city2-2,7800082,5,186,192,378,0
5_257857,fly-airplane_plane2_city6-2_city9-2,257857,5,186,192,378,0
5_7996690,fly-airplane_plane2_city6-2_city5-2,7996690,5,186,192,378,0
5_7734546,fly-airplane_plane2_city6-2_city1-2,7734546,5,186,192,378,0
5_3997835,fly-airplane_plane2_city6-2_city10-2,3997835,5,186,192,378,0
5_192321,fly-airplane_plane2_city6-2_city8-2,192321,5,186,192,378,0
5_3953460,fly-airplane_plane2_city2-2_city7-2,3953460,5,186,192,378,0
5_3691316,fly-airplane_plane2_city2-2_city3-2,3691316,5,186,192,378,0
5_3887924,fly-airplane_plane2_city2-2_city6-2,3887924,5,186,192,378,0
5_4084532,fly-airplane_plane2_city2-2_city9-2,4084532,5,186,192,378,0
5_3822388,fly-airplane_plane2_city2-2_city5-2,3822388,5,186,192,378,0
5_3560244,fly-airplane_plane2_city2-2_city1-2,3560244,5,186,192,378,0
5_7507441,fly-airplane_plane2_city2-2_city10-2,7507441,5,186,192,378,0
5_4018996,fly-airplane_plane2_city2-2_city8-2,4018996,5,186,192,378,0
5_7258000,fly-airplane_plane2_city9-2_city7-2,7258000,5,186,192,378,0
5_6995856,fly-airplane_plane2_city9-2_city3-2,6995856,5,186,192,378,0
5_7192464,fly-airplane_plane2_city9-2_city6-2,7192464,5,186,192,378,0
5_6930320,fly-airplane_plane2_city9-2_city2-2,6930320,5,186,192,378,0
5_7126928,fly-airplane_plane2_city9-2_city5-2,7126928,5,186,192,378,0
5_6864784,fly-airplane_plane2_city9-2_city1-2,6864784,5,186,192,378,0
5_5366119,fly-airplane_plane2_city9-2_city10-2,5366119,5,186,192,378,0
5_7323536,fly-airplane_plane2_city9-2_city8-2,7323536,5,186,192,378,0
5_3083698,fly-airplane_plane2_city5-2_city7-2,3083698,5,186,192,378,0
5_2821554,fly-airplane_plane2_city5-2_city3-2,2821554,5,186,192,378,0
5_3018162,fly-airplane_plane2_city5-2_city6-2,3018162,5,186,192,378,0
5_2756018,fly-airplane_plane2_city5-2_city2-2,2756018,5,186,192,378,0
5_3214770,fly-airplane_plane2_city5-2_city9-2,3214770,5,186,192,378,0
5_2690482,fly-airplane_plane2_city5-2_city1-2,2690482,5,186,192,378,0
5_874748,fly-airplane_plane2_city5-2_city10-2,874748,5,186,192,378,0
5_3149234,fly-airplane_plane2_city5-2_city8-2,3149234,5,186,192,378,0
5_6910373,fly-airplane_plane2_city1-2_city7-2,6910373,5,186,192,378,0
5_6648229,fly-airplane_plane2_city1-2_city3-2,6648229,5,186,192,378,0
5_6844837,fly-airplane_plane2_city1-2_city6-2,6844837,5,186,192,378,0
5_6582693,fly-airplane_plane2_city1-2_city2-2,6582693,5,186,192,378,0
5_7041445,fly-airplane_plane2_city1-2_city9-2,7041445,5,186,192,378,0
5_6779301,fly-airplane_plane2_city1-2_city5-2,6779301,5,186,192,378,0
5_4384354,fly-airplane_plane2_city1-2_city10-2,4384354,5,186,192,378,0
5_6975909,fly-airplane_plane2_city1-2_city8-2,6975909,5,186,192,378,0
5_147109,fly-airplane_plane2_city10-2_city7-2,147109,5,185,192,377,0
5_7885942,fly-airplane_plane2_city10-2_city3-2,7885942,5,185,192,377,0
5_81573,fly-airplane_plane2_city10-2_city6-2,81573,5,185,192,377,0
5_7820406,fly-airplane_plane2_city10-2_city2-2,7820406,5,185,192,377,0
5_278181,fly-airplane_plane2_city10-2_city9-2,278181,5,185,192,377,0
5_16037,fly-airplane_plane2_city10-2_city5-2,16037,5,185,192,377,0
5_7754870,fly-airplane_plane2_city10-2_city1-2,7754870,5,185,192,377,0
5_212645,fly-airplane_plane2_city10-2_city8-2,212645,5,185,192,377,0
5_2213936,fly-airplane_plane2_city8-2_city7-2,2213936,5,186,192,378,0
5_1951792,fly-airplane_plane2_city8-2_city3-2,1951792,5,186,192,378,0
5_2148400,fly-airplane_plane2_city8-2_city6-2,2148400,5,186,192,378,0
5_1886256,fly-airplane_plane2_city8-2_city2-2,1886256,5,186,192,378,0
5_2345008,fly-airplane_plane2_city8-2_city9-2,2345008,5,186,192,378,0
5_2082864,fly-airplane_plane2_city8-2_city5-2,2082864,5,186,192,378,0
5_1820720,fly-airplane_plane2_city8-2_city1-2,1820720,5,186,192,378,0
5_2243032,fly-airplane_plane2_city8-2_city10-2,2243032,5,186,192,378,0
5_1394716,unload-airplane_package1_plane2_city3-2,1394716,5,269,291,560,0
5_1591324,unload-airplane_package1_plane2_city6-2,1591324,5,269,291,560,0
5_1329180,unload-airplane_package1_plane2_city2-2,1329180,5,269,291,560,0
5_1787932,unload-airplane_package1_plane2_city9-2,1787932,5,269,291,560,0
5_1525788,unload-airplane_package1_plane2_city5-2,1525788,5,269,291,560,0
5_1263644,unload-airplane_package1_plane2_city1-2,1263644,5,269,291,560,0
5_1722396,unload-airplane_package1_plane2_city8-2,1722396,5,269,291,560,0
5_3649162,unload-airplane_package1_plane2_city10-2,3649162,5,266,290,556,0
5_4697066,unload-airplane_package2_plane2_city10-2,4697066,5,194,227,421,0
5_3403147,unload-airplane_package3_plane2_city3-2,3403147,5,287,300,587,0
5_3599755,unload-airplane_package3_plane2_city6-2,3599755,5,287,300,587,0
5_3337611,unload-airplane_package3_plane2_city2-2,3337611,5,287,300,587,0
5_3796363,unload-airplane_package3_plane2_city9-2,3796363,5,287,300,587,0
5_3534219,unload-airplane_package3_plane2_city5-2,3534219,5,287,300,587,0
5_3272075,unload-airplane_package3_plane2_city1-2,3272075,5,287,300,587,0
5_3730827,unload-airplane_package3_plane2_city8-2,3730827,5,287,300,587,0
5_5744970,unload-airplane_package3_plane2_city10-2,5744970,5,284,299,583,0
5_406874,unload-airplane_package4_plane2_city3-2,406874,5,287,300,587,0
5_603482,unload-airplane_package4_plane2_city6-2,603482,5,287,300,587,0
5_341338,unload-airplane_package4_plane2_city2-2,341338,5,287,300,587,0
5_800090,unload-airplane_package4_plane2_city9-2,800090,5,287,300,587,0
5_537946,unload-airplane_package4_plane2_city5-2,537946,5,287,300,587,0
5_275802,unload-airplane_package4_plane2_city1-2,275802,5,287,300,587,0
5_734554,unload-airplane_package4_plane2_city8-2,734554,5,287,300,587,0
5_6792874,unload-airplane_package4_plane2_city10-2,6792874,5,284,299,583,0
5_4407828,load-airplane_package1_plane2_city3-2,4407828,5,269,291,560,0
5_4538900,load-airplane_package1_plane2_city5-2,4538900,5,269,291,560,0
5_4276756,load-airplane_package1_plane2_city1-2,4276756,5,269,291,560,0
5_4735508,load-airplane_package1_plane2_city8-2,4735508,5,269,291,560,0
5_6912042,load-airplane_package1_plane2_city10-2,6912042,5,266,290,556,0
5_7959946,load-airplane_package2_plane2_city10-2,7959946,5,194,227,421,0
5_6612867,load-airplane_package3_plane2_city6-2,6612867,5,287,300,587,0
5_6350723,load-airplane_package3_plane2_city2-2,6350723,5,287,300,587,0
5_6809475,load-airplane_package3_plane2_city9-2,6809475,5,287,300,587,0
5_6547331,load-airplane_package3_plane2_city5-2,6547331,5,287,300,587,0
5_6285187,load-airplane_package3_plane2_city1-2,6285187,5,287,300,587,0
5_6743939,load-airplane_package3_plane2_city8-2,6743939,5,287,300,587,0
5_1006873,load-airplane_package3_plane2_city10-2,1006873,5,284,299,583,0
5_3616594,load-airplane_package4_plane2_city6-2,3616594,5,287,300,587,0
5_3354450,load-airplane_package4_plane2_city2-2,3354450,5,287,300,587,0
5_3813202,load-airplane_package4_plane2_city9-2,3813202,5,287,300,587,0
5_3551058,load-airplane_package4_plane2_city5-2,3551058,5,287,300,587,0
5_3288914,load-airplane_package4_plane2_city1-2,3288914,5,287,300,587,0
5_3747666,load-airplane_package4_plane2_city8-2,3747666,5,287,300,587,0
5_423713,load-airplane_package5_plane2_city3-2,423713,5,269,291,560,0
5_620321,load-airplane_package5_plane2_city6-2,620321,5,269,291,560,0
5_358177,load-airplane_package5_plane2_city2-2,358177,5,269,291,560,0
5_816929,load-airplane_package5_plane2_city9-2,816929,5,269,291,560,0
5_554785,load-airplane_package5_plane2_city5-2,554785,5,269,291,560,0
5_751393,load-airplane_package5_plane2_city8-2,751393,5,269,291,560,0
5_3102681,load-airplane_package5_plane2_city10-2,3102681,5,266,290,556,0
5_1281200,noop_city_city10,1281200,5,1,1,2,0
5_4939727,noop_in_package5_plane3,4939727,5,125,127,252,0
5_1618223,unload-airplane_package5_plane3_city3-2,1618223,5,285,291,576,0
5_1814831,unload-airplane_package5_plane3_city6-2,1814831,5,285,291,576,0
5_1749295,unload-airplane_package5_plane3_city5-2,1749295,5,285,291,576,0
5_1487151,unload-airplane_package5_plane3_city1-2,1487151,5,285,291,576,0
5_1945903,unload-airplane_package5_plane3_city8-2,1945903,5,285,291,576,0
5_1823615,noop_airport_city7-2,1823615,5,1,1,2,0
5_5956609,fly-airplane_plane3_city7-2_city3-2,5956609,5,186,192,378,0
5_6153217,fly-airplane_plane3_city7-2_city6-2,6153217,5,186,192,378,0
5_5891073,fly-airplane_plane3_city7-2_city2-2,5891073,5,186,192,378,0
5_6349825,fly-airplane_plane3_city7-2_city9-2,6349825,5,186,192,378,0
5_6087681,fly-airplane_plane3_city7-2_city5-2,6087681,5,186,192,378,0
5_5825537,fly-airplane_plane3_city7-2_city1-2,5825537,5,186,192,378,0
5_3351128,fly-airplane_plane3_city7-2_city10-2,3351128,5,186,192,378,0
5_6284289,fly-airplane_plane3_city7-2_city8-2,6284289,5,186,192,378,0
5_2044451,fly-airplane_plane3_city3-2_city7-2,2044451,5,186,192,378,0
5_1174689,fly-airplane_plane3_city6-2_city7-2,1174689,5,186,192,378,0
5_4131602,fly-airplane_plane3_city5-2_city7-2,4131602,5,186,192,378,0
5_7958277,fly-airplane_plane3_city1-2_city7-2,7958277,5,186,192,378,0
5_3261840,fly-airplane_plane3_city8-2_city7-2,3261840,5,186,192,378,0
5_7004513,fly-airplane_plane4_city7-2_city3-2,7004513,5,186,192,378,0
5_7201121,fly-airplane_plane4_city7-2_city6-2,7201121,5,186,192,378,0
5_6938977,fly-airplane_plane4_city7-2_city2-2,6938977,5,186,192,378,0
5_7397729,fly-airplane_plane4_city7-2_city9-2,7397729,5,186,192,378,0
5_7135585,fly-airplane_plane4_city7-2_city5-2,7135585,5,186,192,378,0
5_6873441,fly-airplane_plane4_city7-2_city1-2,6873441,5,186,192,378,0
5_7582311,fly-airplane_plane4_city7-2_city10-2,7582311,5,186,192,378,0
5_7332193,fly-airplane_plane4_city7-2_city8-2,7332193,5,186,192,378,0
5_3092355,fly-airplane_plane4_city3-2_city7-2,3092355,5,186,192,378,0
5_2222593,fly-airplane_plane4_city6-2_city7-2,2222593,5,186,192,378,0
5_1005204,fly-airplane_plane4_city1-2_city7-2,1005204,5,186,192,378,0
5_608498,fly-airplane_plane4_city10-2_city7-2,608498,5,185,192,377,0
5_4309744,fly-airplane_plane4_city8-2_city7-2,4309744,5,186,192,378,0
5_5018865,noop_airplane_plane3,5018865,5,1,1,2,0
5_1978915,fly-airplane_plane3_city3-2_city6-2,1978915,5,186,192,378,0
5_1716771,fly-airplane_plane3_city3-2_city2-2,1716771,5,186,192,378,0
5_2175523,fly-airplane_plane3_city3-2_city9-2,2175523,5,186,192,378,0
5_1913379,fly-airplane_plane3_city3-2_city5-2,1913379,5,186,192,378,0
5_1651235,fly-airplane_plane3_city3-2_city1-2,1651235,5,186,192,378,0
5_6860734,fly-airplane_plane3_city3-2_city10-2,6860734,5,186,192,378,0
5_2109987,fly-airplane_plane3_city3-2_city8-2,2109987,5,186,192,378,0
5_912545,fly-airplane_plane3_city6-2_city3-2,912545,5,186,192,378,0
5_847009,fly-airplane_plane3_city6-2_city2-2,847009,5,186,192,378,0
5_1305761,fly-airplane_plane3_city6-2_city9-2,1305761,5,186,192,378,0
5_1043617,fly-airplane_plane3_city6-2_city5-2,1043617,5,186,192,378,0
5_781473,fly-airplane_plane3_city6-2_city1-2,781473,5,186,192,378,0
5_228041,fly-airplane_plane3_city6-2_city10-2,228041,5,186,192,378,0
5_1240225,fly-airplane_plane3_city6-2_city8-2,1240225,5,186,192,378,0
5_3869458,fly-airplane_plane3_city5-2_city3-2,3869458,5,186,192,378,0
5_4066066,fly-airplane_plane3_city5-2_city6-2,4066066,5,186,192,378,0
5_3803922,fly-airplane_plane3_city5-2_city2-2,3803922,5,186,192,378,0
5_4262674,fly-airplane_plane3_city5-2_city9-2,4262674,5,186,192,378,0
5_3738386,fly-airplane_plane3_city5-2_city1-2,3738386,5,186,192,378,0
5_5105931,fly-airplane_plane3_city5-2_city10-2,5105931,5,186,192,378,0
5_4197138,fly-airplane_plane3_city5-2_city8-2,4197138,5,186,192,378,0
5_7696133,fly-airplane_plane3_city1-2_city3-2,7696133,5,186,192,378,0
5_7892741,fly-airplane_plane3_city1-2_city6-2,7892741,5,186,192,378,0
5_7630597,fly-airplane_plane3_city1-2_city2-2,7630597,5,186,192,378,0
5_88372,fly-airplane_plane3_city1-2_city9-2,88372,5,186,192,378,0
5_7827205,fly-airplane_plane3_city1-2_city5-2,7827205,5,186,192,378,0
5_614560,fly-airplane_plane3_city1-2_city10-2,614560,5,186,192,378,0
5_22836,fly-airplane_plane3_city1-2_city8-2,22836,5,186,192,378,0
5_2999696,fly-airplane_plane3_city8-2_city3-2,2999696,5,186,192,378,0
5_3196304,fly-airplane_plane3_city8-2_city6-2,3196304,5,186,192,378,0
5_2934160,fly-airplane_plane3_city8-2_city2-2,2934160,5,186,192,378,0
5_3392912,fly-airplane_plane3_city8-2_city9-2,3392912,5,186,192,378,0
5_3130768,fly-airplane_plane3_city8-2_city5-2,3130768,5,186,192,378,0
5_2868624,fly-airplane_plane3_city8-2_city1-2,2868624,5,186,192,378,0
5_6474215,fly-airplane_plane3_city8-2_city10-2,6474215,5,186,192,378,0
5_5602338,unload-airplane_package1_plane3_city3-2,5602338,5,285,291,576,0
5_5798946,unload-airplane_package1_plane3_city6-2,5798946,5,285,291,576,0
5_5733410,unload-airplane_package1_plane3_city5-2,5733410,5,285,291,576,0
5_5471266,unload-airplane_package1_plane3_city1-2,5471266,5,285,291,576,0
5_5930018,unload-airplane_package1_plane3_city8-2,5930018,5,285,291,576,0
5_7610769,unload-airplane_package3_plane3_city3-2,7610769,5,287,300,587,0
5_7807377,unload-airplane_package3_plane3_city6-2,7807377,5,287,300,587,0
5_7741841,unload-airplane_package3_plane3_city5-2,7741841,5,287,300,587,0
5_7479697,unload-airplane_package3_plane3_city1-2,7479697,5,287,300,587,0
5_7938449,unload-airplane_package3_plane3_city8-2,7938449,5,287,300,587,0
5_4614496,unload-airplane_package4_plane3_city3-2,4614496,5,287,300,587,0
5_4811104,unload-airplane_package4_plane3_city6-2,4811104,5,287,300,587,0
5_4745568,unload-airplane_package4_plane3_city5-2,4745568,5,287,300,587,0
5_4483424,unload-airplane_package4_plane3_city1-2,4483424,5,287,300,587,0
5_4942176,unload-airplane_package4_plane3_city8-2,4942176,5,287,300,587,0
5_614473,load-airplane_package1_plane3_city3-2,614473,5,269,291,560,0
5_745545,load-airplane_package1_plane3_city5-2,745545,5,269,291,560,0
5_483401,load-airplane_package1_plane3_city1-2,483401,5,269,291,560,0
5_942153,load-airplane_package1_plane3_city8-2,942153,5,269,291,560,0
5_2819512,load-airplane_package3_plane3_city6-2,2819512,5,287,300,587,0
5_2753976,load-airplane_package3_plane3_city5-2,2753976,5,287,300,587,0
5_2491832,load-airplane_package3_plane3_city1-2,2491832,5,287,300,587,0
5_2950584,load-airplane_package3_plane3_city8-2,2950584,5,287,300,587,0
5_7824216,load-airplane_package4_plane3_city6-2,7824216,5,287,300,587,0
5_7758680,load-airplane_package4_plane3_city5-2,7758680,5,287,300,587,0
5_7496536,load-airplane_package4_plane3_city1-2,7496536,5,287,300,587,0
5_7955288,load-airplane_package4_plane3_city8-2,7955288,5,287,300,587,0
5_4631335,load-airplane_package5_plane3_city3-2,4631335,5,269,291,560,0
5_4827943,load-airplane_package5_plane3_city6-2,4827943,5,269,291,560,0
5_4762407,load-airplane_package5_plane3_city5-2,4762407,5,269,291,560,0
5_4959015,load-airplane_package5_plane3_city8-2,4959015,5,269,291,560,0
5_1927947,noop_at_package5_city4-2,1927947,5,109,127,236,0
5_4939728,noop_in_package5_plane4,4939728,5,109,127,236,0
5_5825845,unload-airplane_package5_plane4_city3-2,5825845,5,269,291,560,0
5_6022453,unload-airplane_package5_plane4_city6-2,6022453,5,269,291,560,0
5_5694773,unload-airplane_package5_plane4_city1-2,5694773,5,269,291,560,0
5_6153525,unload-airplane_package5_plane4_city8-2,6153525,5,269,291,560,0
5_1879452,unload-airplane_package5_plane4_city10-2,1879452,5,266,290,556,0
5_4233888,noop_in-city_city9-1_city9,4233888,5,1,1,2,0
5_5018866,noop_airplane_plane4,5018866,5,1,1,2,0
5_3026819,fly-airplane_plane4_city3-2_city6-2,3026819,5,186,192,378,0
5_2764675,fly-airplane_plane4_city3-2_city2-2,2764675,5,186,192,378,0
5_3223427,fly-airplane_plane4_city3-2_city9-2,3223427,5,186,192,378,0
5_2961283,fly-airplane_plane4_city3-2_city5-2,2961283,5,186,192,378,0
5_2699139,fly-airplane_plane4_city3-2_city1-2,2699139,5,186,192,378,0
5_3090940,fly-airplane_plane4_city3-2_city10-2,3090940,5,186,192,378,0
5_3157891,fly-airplane_plane4_city3-2_city8-2,3157891,5,186,192,378,0
5_1960449,fly-airplane_plane4_city6-2_city3-2,1960449,5,186,192,378,0
5_1894913,fly-airplane_plane4_city6-2_city2-2,1894913,5,186,192,378,0
5_2353665,fly-airplane_plane4_city6-2_city9-2,2353665,5,186,192,378,0
5_2091521,fly-airplane_plane4_city6-2_city5-2,2091521,5,186,192,378,0
5_1829377,fly-airplane_plane4_city6-2_city1-2,1829377,5,186,192,378,0
5_4459224,fly-airplane_plane4_city6-2_city10-2,4459224,5,186,192,378,0
5_2288129,fly-airplane_plane4_city6-2_city8-2,2288129,5,186,192,378,0
5_743060,fly-airplane_plane4_city1-2_city3-2,743060,5,186,192,378,0
5_939668,fly-airplane_plane4_city1-2_city6-2,939668,5,186,192,378,0
5_677524,fly-airplane_plane4_city1-2_city2-2,677524,5,186,192,378,0
5_1136276,fly-airplane_plane4_city1-2_city9-2,1136276,5,186,192,378,0
5_874132,fly-airplane_plane4_city1-2_city5-2,874132,5,186,192,378,0
5_4845743,fly-airplane_plane4_city1-2_city10-2,4845743,5,186,192,378,0
5_1070740,fly-airplane_plane4_city1-2_city8-2,1070740,5,186,192,378,0
5_346354,fly-airplane_plane4_city10-2_city3-2,346354,5,185,192,377,0
5_542962,fly-airplane_plane4_city10-2_city6-2,542962,5,185,192,377,0
5_280818,fly-airplane_plane4_city10-2_city2-2,280818,5,185,192,377,0
5_739570,fly-airplane_plane4_city10-2_city9-2,739570,5,185,192,377,0
5_477426,fly-airplane_plane4_city10-2_city5-2,477426,5,185,192,377,0
5_215282,fly-airplane_plane4_city10-2_city1-2,215282,5,185,192,377,0
5_674034,fly-airplane_plane4_city10-2_city8-2,674034,5,185,192,377,0
5_4047600,fly-airplane_plane4_city8-2_city3-2,4047600,5,186,192,378,0
5_4244208,fly-airplane_plane4_city8-2_city6-2,4244208,5,186,192,378,0
5_3982064,fly-airplane_plane4_city8-2_city2-2,3982064,5,186,192,378,0
5_4440816,fly-airplane_plane4_city8-2_city9-2,4440816,5,186,192,378,0
5_4178672,fly-airplane_plane4_city8-2_city5-2,4178672,5,186,192,378,0
5_3916528,fly-airplane_plane4_city8-2_city1-2,3916528,5,186,192,378,0
5_2704421,fly-airplane_plane4_city8-2_city10-2,2704421,5,186,192,378,0
5_1808983,unload-airplane_package1_plane4_city3-2,1808983,5,269,291,560,0
5_2005591,unload-airplane_package1_plane4_city6-2,2005591,5,269,291,560,0
5_1677911,unload-airplane_package1_plane4_city1-2,1677911,5,269,291,560,0
5_2136663,unload-airplane_package1_plane4_city8-2,2136663,5,269,291,560,0
5_5688813,unload-airplane_package1_plane4_city10-2,5688813,5,266,290,556,0
5_6736717,unload-airplane_package2_plane4_city10-2,6736717,5,194,227,421,0
5_3817414,unload-airplane_package3_plane4_city3-2,3817414,5,287,300,587,0
5_4014022,unload-airplane_package3_plane4_city6-2,4014022,5,287,300,587,0
5_3686342,unload-airplane_package3_plane4_city1-2,3686342,5,287,300,587,0
5_4145094,unload-airplane_package3_plane4_city8-2,4145094,5,287,300,587,0
5_7784621,unload-airplane_package3_plane4_city10-2,7784621,5,284,299,583,0
5_821141,unload-airplane_package4_plane4_city3-2,821141,5,287,300,587,0
5_1017749,unload-airplane_package4_plane4_city6-2,1017749,5,287,300,587,0
5_690069,unload-airplane_package4_plane4_city1-2,690069,5,287,300,587,0
5_1148821,unload-airplane_package4_plane4_city8-2,1148821,5,287,300,587,0
5_831548,unload-airplane_package4_plane4_city10-2,831548,5,284,299,583,0
5_4822095,load-airplane_package1_plane4_city3-2,4822095,5,269,291,560,0
5_4691023,load-airplane_package1_plane4_city1-2,4691023,5,269,291,560,0
5_5149775,load-airplane_package1_plane4_city8-2,5149775,5,269,291,560,0
5_950716,load-airplane_package1_plane4_city10-2,950716,5,266,290,556,0
5_1998620,load-airplane_package2_plane4_city10-2,1998620,5,194,227,421,0
5_7027134,load-airplane_package3_plane4_city6-2,7027134,5,287,300,587,0
5_6699454,load-airplane_package3_plane4_city1-2,6699454,5,287,300,587,0
5_7158206,load-airplane_package3_plane4_city8-2,7158206,5,287,300,587,0
5_3046524,load-airplane_package3_plane4_city10-2,3046524,5,284,299,583,0
5_4030861,load-airplane_package4_plane4_city6-2,4030861,5,287,300,587,0
5_3703181,load-airplane_package4_plane4_city1-2,3703181,5,287,300,587,0
5_4161933,load-airplane_package4_plane4_city8-2,4161933,5,287,300,587,0
5_837980,load-airplane_package5_plane4_city3-2,837980,5,269,291,560,0
5_1034588,load-airplane_package5_plane4_city6-2,1034588,5,269,291,560,0
5_1165660,load-airplane_package5_plane4_city8-2,1165660,5,269,291,560,0
5_5142332,load-airplane_package5_plane4_city10-2,5142332,5,266,290,556,0
5_1885288,noop_at_plane3_city5-2,1885288,5,175,182,357,0
5_2650101,noop_at_plane2_city10-2,2650101,5,172,181,353,0
5_565705,at_plane2_city4-2,565705,5,28,20,48,0
5_5809715,noop_at_plane2_city7-2,5809715,5,175,182,357,0
5_5852374,noop_at_package4_city6-2,5852374,5,127,136,263,0
5_4560839,noop_in-city_city2-2_city2,4560839,5,1,1,2,0
5_6728647,drive-truck_truck2_city2-1_city2-2_city2,6728647,5,21,18,39,0
5_3971182,drive-truck_truck2_city2-2_city2-1_city2,3971182,5,20,17,37,0
5_2773648,noop_location_city3-1,2773648,5,1,1,2,0
5_2713825,unload-truck_package3_truck3_city3-1,2713825,5,139,148,287,0
5_5830766,noop_at_plane4_city1-2,5830766,5,175,182,357,0
5_1164949,noop_at_package1_city5-2,1164949,5,109,127,236,0
5_2008582,load-truck_package1_truck5_city5-2,2008582,5,116,133,249,0
5_2962340,noop_at_truck7_city7-1,2962340,5,11,14,25,0
5_5915916,at_truck7_city7-2,5915916,5,4,11,15,0
5_2773649,noop_location_city3-2,2773649,5,1,1,2,0
5_2713826,unload-truck_package3_truck3_city3-2,2713826,5,134,141,275,0
5_7718530,unload-truck_package4_truck3_city3-2,7718530,5,161,143,304,0
5_1463243,load-truck_package1_truck3_city3-2,1463243,5,119,134,253,0
5_5480105,load-truck_package5_truck3_city3-2,5480105,5,119,134,253,0
5_2255627,noop_at_package5_city9-2,2255627,5,109,127,236,0
5_2962341,noop_at_truck7_city7-2,2962341,5,7,7,14,0
5_5915915,at_truck7_city7-1,5915915,5,4,10,14,0
5_6289518,noop_at_plane4_city8-2,6289518,5,175,182,357,0
5_2010292,noop_in-city_city9-2_city9,2010292,5,1,1,2,0
5_6144820,noop_at_truck4_city4-1,6144820,5,12,14,26,0
5_1097419,at_truck4_city4-2,1097419,5,3,11,14,0
5_1561471,noop_airport_city3-2,1561471,5,1,1,2,0
5_1602093,noop_at_plane1_city7-2,1602093,5,175,182,357,0
5_1644752,noop_at_package3_city6-2,1644752,5,127,136,263,0
5_6110934,noop_in_package4_plane1,6110934,5,127,136,263,0
5_6118830,noop_at_truck10_city10-1,6118830,5,14,16,30,0
5_3142669,unload-truck_package2_truck10_city10-1,3142669,5,34,69,103,0
5_7404958,load-truck_package2_truck10_city10-1,7404958,5,34,69,103,0
5_3973470,at_truck10_city10-2,3973470,5,3,13,16,0
5_5547571,noop_at_plane2_city3-2,5547571,5,175,182,357,0
5_6144821,noop_at_truck4_city4-2,6144821,5,4,6,10,0
5_1097418,at_truck4_city4-1,1097418,5,5,10,15,0
5_1623144,noop_at_plane3_city1-2,1623144,5,175,182,357,0
5_5590230,noop_at_package4_city2-2,5590230,5,127,136,263,0
5_4203220,load-truck_package4_truck2_city2-2,4203220,5,137,143,280,0
5_6110935,noop_in_package4_plane2,6110935,5,127,136,263,0
5_6118831,noop_at_truck10_city10-2,6118831,5,6,8,14,0
5_3142670,unload-truck_package2_truck10_city10-2,3142670,5,26,61,87,0
5_7373853,unload-truck_package3_truck10_city10-2,7373853,5,136,143,279,0
5_3604059,unload-truck_package4_truck10_city10-2,3604059,5,158,143,301,0
5_3173776,load-truck_package1_truck10_city10-2,3173776,5,118,135,253,0
5_7404959,load-truck_package2_truck10_city10-2,7404959,5,26,61,87,0
5_3635165,load-truck_package3_truck10_city10-2,3635165,5,136,143,279,0
5_4096554,load-truck_package5_truck10_city10-2,4096554,5,118,135,253,0
5_3973469,at_truck10_city10-1,3973469,5,5,12,17,0
5_902805,noop_at_package1_city1-2,902805,5,109,127,236,0
5_917904,load-truck_package1_truck1_city1-2,917904,5,119,135,254,0
5_2124555,noop_at_package5_city7-2,2124555,5,109,127,236,0
5_7612973,noop_in-city_city6-1_city6,7612973,5,1,1,2,0
5_6110936,noop_in_package4_plane3,6110936,5,127,136,263,0
5_2081896,noop_at_plane3_city8-2,2081896,5,175,182,357,0
5_6048982,noop_at_package4_city9-2,6048982,5,127,136,263,0
5_7286102,noop_at_package1_city10-2,7286102,5,109,127,236,0
5_6110937,noop_in_package4_plane4,6110937,5,127,136,263,0
5_2970256,noop_location_city6-1,2970256,5,1,1,2,0
5_6027374,noop_at_plane4_city4-2,6027374,5,175,182,357,0
5_1361557,noop_at_package1_city8-2,1361557,5,109,127,236,0
5_6827079,load-truck_package1_truck8_city8-2,6827079,5,116,133,249,0
5_7846438,noop_in_package5_truck1,7846438,5,109,127,236,0
5_4176917,unload-truck_package5_truck1_city1-1,4176917,5,123,138,261,0
5_4176918,unload-truck_package5_truck1_city1-2,4176918,5,116,133,249,0
5_2970257,noop_location_city6-2,2970257,5,1,1,2,0
5_1324776,noop_at_package3_city10-2,1324776,5,127,136,263,0
5_3364427,noop_at_package5_city10-2,3364427,5,109,127,236,0
5_1339949,noop_at_plane1_city3-2,1339949,5,175,182,357,0
5_1382608,noop_at_package3_city2-2,1382608,5,127,136,263,0
5_7199493,load-truck_package3_truck2_city2-2,7199493,5,137,143,280,0
5_3405350,noop_in-city_city5-1_city5,3405350,5,1,1,2,0
5_2656144,drive-truck_truck5_city5-1_city5-2_city5,2656144,5,18,17,35,0
5_7899656,drive-truck_truck5_city5-2_city5-1_city5,7899656,5,16,15,31,0
5_5389377,noop_in-city_city6-2_city6,5389377,5,1,1,2,0
5_2417001,noop_at_truck5_city5-1,2417001,5,12,14,26,0
5_5370577,at_truck5_city5-2,5370577,5,3,12,15,0
5_1758079,noop_airport_city6-2,1758079,5,1,1,2,0
5_3822037,noop_in_package2_truck10,3822037,5,19,55,74,0
5_7160436,at_package2_city10-2,7160436,5,16,12,28,0
5_7160435,at_package2_city10-1,7160435,5,8,7,15,0
5_1841360,noop_at_package3_city9-2,1841360,5,127,136,263,0
5_1862411,noop_at_package5_city3-2,1862411,5,109,127,236,0
5_2417002,noop_at_truck5_city5-2,2417002,5,4,6,10,0
5_3259165,unload-truck_package3_truck5_city5-2,3259165,5,134,141,275,0
5_262892,unload-truck_package4_truck5_city5-2,262892,5,158,141,299,0
5_4017013,load-truck_package3_truck5_city5-2,4017013,5,134,141,275,0
5_1020740,load-truck_package4_truck5_city5-2,1020740,5,134,141,275,0
5_6025444,load-truck_package5_truck5_city5-2,6025444,5,116,133,249,0
5_5370576,at_truck5_city5-1,5370576,5,5,10,15,0
5_1819752,noop_at_plane3_city4-2,1819752,5,175,182,357,0
5_5744179,noop_at_plane2_city6-2,5744179,5,175,182,357,0
5_5786838,noop_at_package4_city5-2,5786838,5,127,136,263,0
5_7282143,noop_in_package3_plane1,7282143,5,127,136,263,0
5_2708112,noop_location_city2-1,2708112,5,1,1,2,0
5_4433213,unload-truck_package1_truck2_city2-1,4433213,5,123,138,261,0
5_1099413,noop_at_package1_city4-2,1099413,5,109,127,236,0
5_5599481,noop_at_truck2_city2-1,5599481,5,13,13,26,0
5_1181754,noop_in-city_city5-2_city5,1181754,5,1,1,2,0
5_2708113,noop_location_city2-2,2708113,5,1,1,2,0
5_4433214,unload-truck_package1_truck2_city2-2,4433214,5,116,133,249,0
5_6441645,unload-truck_package3_truck2_city2-2,6441645,5,137,144,281,0
5_3445372,unload-truck_package4_truck2_city2-2,3445372,5,150,144,294,0
5_1206947,load-truck_package5_truck2_city2-2,1206947,5,119,135,254,0
5_7282144,noop_in_package3_plane2,7282144,5,127,136,263,0
5_2190091,noop_at_package5_city8-2,2190091,5,109,127,236,0
5_2842964,load-truck_package5_truck8_city8-2,2842964,5,116,133,249,0
5_7282145,noop_in_package3_plane3,7282145,5,127,136,263,0
5_3166864,noop_location_city9-1,3166864,5,1,1,2,0
5_62686,noop_truck_truck1,62686,5,1,1,2,0
5_85171,drive-truck_truck1_city1-1_city1-2_city1,85171,5,21,18,39,0
5_5328683,drive-truck_truck1_city1-2_city1-1_city1,5328683,5,20,17,37,0
5_2168487,unload-truck_package3_truck1_city1-2,2168487,5,137,144,281,0
5_7173191,unload-truck_package4_truck1_city1-2,7173191,5,150,144,294,0
5_2926335,load-truck_package3_truck1_city1-2,2926335,5,137,143,280,0
5_7931039,load-truck_package4_truck1_city1-2,7931039,5,137,143,280,0
5_5599482,noop_at_truck2_city2-2,5599482,5,7,8,15,0
5_552079,at_truck2_city2-1,552079,5,5,10,15,0
5_6223982,noop_at_plane4_city7-2,6223982,5,175,182,357,0
5_3166865,noop_location_city9-2,3166865,5,1,1,2,0
5_62687,noop_truck_truck2,62687,5,1,1,2,0
5_7282146,noop_in_package3_plane4,7282146,5,127,136,263,0
5_1016670,noop_in_package4_truck1,1016670,5,145,138,283,0
5_4279898,at_truck1_city1-1,4279898,5,5,10,15,0
5_1536557,noop_at_plane1_city6-2,1536557,5,175,182,357,0
5_4109194,noop_in-city_city10-1_city10,4109194,5,1,1,2,0
5_1495935,noop_airport_city2-2,1495935,5,1,1,2,0
5_62688,noop_truck_truck3,62688,5,1,1,2,0
5_1579216,noop_at_package3_city5-2,1579216,5,127,136,263,0
5_1016671,noop_in_package4_truck2,1016671,5,145,138,283,0
5_4530298,noop_in_package1_truck2,4530298,5,109,127,236,0
5_6784435,noop_in-city_city2-1_city2,6784435,5,1,1,2,0
5_4975108,noop_in-city_city4-2_city4,4975108,5,1,1,2,0
5_62689,noop_truck_truck4,62689,5,1,1,2,0
5_45710,noop_truck_truck10,45710,5,1,1,2,0
5_5482035,noop_at_plane2_city2-2,5482035,5,175,182,357,0
5_5524694,noop_at_package4_city1-2,5524694,5,127,136,263,0
5_1016672,noop_in_package4_truck3,1016672,5,156,138,294,0
5_4825237,at_truck3_city3-1,4825237,5,4,10,14,0
5_1954687,noop_airport_city9-2,1954687,5,1,1,2,0
5_62690,noop_truck_truck5,62690,5,1,1,2,0
5_2059019,noop_at_package5_city6-2,2059019,5,109,127,236,0
5_1016673,noop_in_package4_truck4,1016673,5,153,136,289,0
5_4305438,noop_at_package2_city10-1,4305438,5,19,55,74,0
5_1676676,in_package2_truck10,1676676,5,10,3,13,0
5_2016360,noop_at_plane3_city7-2,2016360,5,175,182,357,0
5_62691,noop_truck_truck6,62691,5,1,1,2,0
5_5940787,noop_at_plane2_city9-2,5940787,5,175,182,357,0
5_5983446,noop_at_package4_city8-2,5983446,5,127,136,263,0
5_5839237,load-truck_package4_truck8_city8-2,5839237,5,134,141,275,0
5_1016674,noop_in_package4_truck5,1016674,5,153,136,289,0
5_5961838,noop_at_plane4_city3-2,5961838,5,175,182,357,0
5_2904720,noop_location_city5-1,2904720,5,1,1,2,0
5_62692,noop_truck_truck7,62692,5,1,1,2,0
5_4305439,noop_at_package2_city10-2,4305439,5,19,55,74,0
5_1296021,noop_at_package1_city7-2,1296021,5,109,127,236,0
5_452375,noop_in_package2_plane1,452375,5,181,55,236,0
5_1016675,noop_in_package4_truck6,1016675,5,153,136,289,0
5_1871662,noop_at_truck3_city3-1,1871662,5,11,14,25,0
5_2576812,noop_in-city_city1-1_city1,2576812,5,1,1,2,0
5_2904721,noop_location_city5-2,2904721,5,1,1,2,0
5_62693,noop_truck_truck8,62693,5,1,1,2,0
5_6584618,drive-truck_truck8_city8-1_city8-2_city8,6584618,5,18,17,35,0
5_3827153,drive-truck_truck8_city8-2_city8-1_city8,3827153,5,16,15,31,0
5_76685,unload-truck_package3_truck8_city8-2,76685,5,134,141,275,0
5_5081389,unload-truck_package4_truck8_city8-2,5081389,5,158,141,299,0
5_834533,load-truck_package3_truck8_city8-2,834533,5,134,141,275,0
5_4689752,noop_at_plane4_city10-2,4689752,5,172,181,353,0
5_452376,noop_in_package2_plane2,452376,5,181,55,236,0
5_1016676,noop_in_package4_truck7,1016676,5,127,136,263,0
5_62694,noop_truck_truck9,62694,5,1,1,2,0
5_1871663,noop_at_truck3_city3-2,1871663,5,7,7,14,0
5_1274413,noop_at_plane1_city2-2,1274413,5,175,182,357,0
5_1317072,noop_at_package3_city1-2,1317072,5,127,136,263,0
5_452377,noop_in_package2_plane3,452377,5,197,55,252,0
5_1016677,noop_in_package4_truck8,1016677,5,153,136,289,0
5_2188096,at_truck8_city8-1,2188096,5,5,10,15,0
5_1837095,noop_obj_package1,1837095,5,1,1,2,0
5_452378,noop_in_package2_plane4,452378,5,181,55,236,0
5_1016678,noop_in_package4_truck9,1016678,5,153,136,289,0
5_26265,noop_in-city_city8-1_city8,26265,5,1,1,2,0
5_1692543,noop_airport_city5-2,1692543,5,1,1,2,0
5_1837096,noop_obj_package2,1837096,5,1,1,2,0
5_1733165,noop_at_plane1_city9-2,1733165,5,175,182,357,0
5_1775824,noop_at_package3_city8-2,1775824,5,127,136,263,0
5_1796875,noop_at_package5_city2-2,1796875,5,109,127,236,0
5_2187879,noop_in_package3_truck1,2187879,5,132,138,270,0
5_353216,noop_in-city_city1-2_city1,353216,5,1,1,2,0
5_1837097,noop_obj_package3,1837097,5,1,1,2,0
5_1754216,noop_at_plane3_city3-2,1754216,5,175,182,357,0
5_5678643,noop_at_plane2_city5-2,5678643,5,175,182,357,0
5_5721302,noop_at_package4_city4-2,5721302,5,127,136,263,0
5_2187880,noop_in_package3_truck2,2187880,5,132,138,270,0
5_2642576,noop_location_city1-1,2642576,5,1,1,2,0
5_4005493,noop_city_city1,4005493,5,1,1,2,0
5_1837098,noop_obj_package4,1837098,5,1,1,2,0
5_1033877,noop_at_package1_city3-2,1033877,5,109,127,236,0
5_4236304,noop_in_package4_truck10,4236304,5,153,136,289,0
5_2187881,noop_in_package3_truck3,2187881,5,127,136,263,0
5_2642577,noop_location_city1-2,2642577,5,1,1,2,0
5_4005494,noop_city_city2,4005494,5,1,1,2,0
5_1837099,noop_obj_package5,1837099,5,1,1,2,0
5_2187882,noop_in_package3_truck4,2187882,5,129,136,265,0
5_3819619,noop_in-city_city7-1_city7,3819619,5,1,1,2,0
5_5803646,noop_in-city_city8-2_city8,5803646,5,1,1,2,0
5_3101328,noop_location_city8-1,3101328,5,1,1,2,0
5_4005495,noop_city_city3,4005495,5,1,1,2,0
5_6158446,noop_at_plane4_city6-2,6158446,5,175,182,357,0
5_2187883,noop_in_package3_truck5,2187883,5,129,136,265,0
5_3101329,noop_location_city8-2,3101329,5,1,1,2,0
5_4005496,noop_city_city4,4005496,5,1,1,2,0
5_2187884,noop_in_package3_truck6,2187884,5,129,136,265,0
5_1623584,noop_in_package1_plane1,1623584,5,109,127,236,0
5_7235498,noop_at_truck8_city8-1,7235498,5,12,14,26,0
5_2188097,at_truck8_city8-2,2188097,5,3,12,15,0
5_1430399,noop_airport_city1-2,1430399,5,1,1,2,0
5_6333557,noop_airport_city10-2,6333557,5,1,1,2,0
5_4613021,noop_location_city10-1,4613021,5,1,1,2,0
5_4005497,noop_city_city5,4005497,5,1,1,2,0
5_1471021,noop_at_plane1_city5-2,1471021,5,175,182,357,0
5_1513680,noop_at_package3_city4-2,1513680,5,127,136,263,0
5_2187885,noop_in_package3_truck7,2187885,5,132,138,270,0
5_1623585,noop_in_package1_plane2,1623585,5,109,127,236,0
5_4613022,noop_location_city10-2,4613022,5,1,1,2,0
5_4005498,noop_city_city6,4005498,5,1,1,2,0
5_7235499,noop_at_truck8_city8-2,7235499,5,4,6,10,0
5_5416499,noop_at_plane2_city1-2,5416499,5,175,182,357,0
5_5917909,noop_at_package4_city7-1,5917909,5,134,143,277,0
5_28682,noop_in_package3_truck10,28682,5,131,136,267,0
5_2187886,noop_in_package3_truck8,2187886,5,129,136,265,0
5_1623586,noop_in_package1_plane3,1623586,5,125,127,252,0
5_1326323,noop_at_truck1_city1-1,1326323,5,13,13,26,0
5_1596023,noop_in-city_city7-2_city7,1596023,5,1,1,2,0
5_1889151,noop_airport_city8-2,1889151,5,1,1,2,0
5_4005499,noop_city_city7,4005499,5,1,1,2,0
5_1993483,noop_at_package5_city5-2,1993483,5,109,127,236,0
5_2187887,noop_in_package3_truck9,2187887,5,129,136,265,0
5_1623587,noop_in_package1_plane4,1623587,5,109,127,236,0
5_5917910,noop_at_package4_city7-2,5917910,5,127,136,263,0
5_4005500,noop_city_city8,4005500,5,1,1,2,0
5_1326324,noop_at_truck1_city1-2,1326324,5,7,8,15,0
5_1950824,noop_at_plane3_city6-2,1950824,5,175,182,357,0
5_5875251,noop_at_plane2_city8-2,5875251,5,175,182,357,0
5_5630764,noop_at_plane1_city10-2,5630764,5,172,181,353,0
5_6497299,city_city8,6497299,5,1,3,4,0
5_6195675,in-city_city5-1_city5,6195675,5,1,3,4,0
5_7104561,city_city10,7104561,5,1,3,4,0
4_4536050,unload-truck_package4_truck6_city6-2,4536050,4,4,155,159,0
3_5040037,in_package4_truck6,5040037,3,0,1,1,0
4_462350,load-airplane_package1_plane1_city7-2,462350,4,4,266,270,0
3_7151637,at_package1_city7-2,7151637,3,0,5,5,0
4_4538900,load-airplane_package1_plane2_city5-2,4538900,4,4,266,270,0
3_7020565,at_package1_city5-2,7020565,3,0,5,5,0
5_585448,airport_city8-2,585448,5,1,73,74,0
5_6497300,city_city9,6497300,5,1,3,4,0
4_483401,load-airplane_package1_plane3_city1-2,483401,4,4,266,270,0
3_6758421,at_package1_city1-2,6758421,3,0,5,5,0
4_5024551,load-airplane_package5_plane3_city9-2,5024551,4,4,266,270,0
3_110266,at_package5_city9-2,110266,3,0,5,5,0
4_5736401,load-truck_package1_truck4_city4-2,5736401,4,4,113,117,0
3_6955029,at_package1_city4-2,6955029,3,0,5,5,0
5_552685,in_package1_truck4,552685,5,1,28,29,0
4_7286102,noop_at_package1_city10-2,7286102,4,0,109,109,0
3_2140122,at_package1_city10-2,2140122,3,0,5,5,0
4_969052,load-airplane_package5_plane4_city5-2,969052,4,4,266,270,0
3_7849099,at_package5_city5-2,7849099,3,0,5,5,0
4_1716403,unload-airplane_package2_plane3_city10-2,1716403,4,4,207,211,0
3_4475739,in_package2_plane3,4475739,3,0,1,1,0
4_7373853,unload-truck_package3_truck10_city10-2,7373853,4,4,133,137,0
3_5884298,in_package3_truck10,5884298,3,0,1,1,0
4_942153,load-airplane_package1_plane3_city8-2,942153,4,4,266,270,0
3_7217173,at_package1_city8-2,7217173,3,0,5,5,0
4_5018703,load-airplane_package1_plane4_city6-2,5018703,4,4,266,270,0
3_7086101,at_package1_city6-2,7086101,3,0,5,5,0
4_4236304,noop_in_package4_truck10,4236304,4,0,153,153,0
3_2090943,in_package4_truck10,2090943,3,0,1,1,0
5_3972079,in-city_city5-2_city5,3972079,5,1,3,4,0
5_1988052,in-city_city4-1_city4,1988052,5,1,3,4,0
4_3804504,unload-truck_package3_truck7_city7-2,3804504,4,4,134,138,0
3_6211247,in_package3_truck7,6211247,3,0,1,1,0
4_4282604,load-airplane_package5_plane1_city4-2,4282604,4,4,266,270,0
3_7783563,at_package5_city4-2,7783563,3,0,5,5,0
4_917904,load-truck_package1_truck1_city1-2,917904,4,5,116,121,0
5_552682,in_package1_truck1,552682,5,1,28,29,0
4_4096554,load-truck_package5_truck10_city10-2,4096554,4,4,115,119,0
3_6219424,at_package5_city10-2,6219424,3,0,5,5,0
5_6298565,in_package5_truck10,6298565,5,1,27,28,0
4_2124555,noop_at_package5_city7-2,2124555,4,0,109,109,0
3_7980171,at_package5_city7-2,7980171,3,0,5,5,0
4_902805,noop_at_package1_city1-2,902805,4,1,109,110,0
4_5480105,load-truck_package5_truck3_city3-2,5480105,4,4,116,120,0
3_7718027,at_package5_city3-2,7718027,3,0,5,5,0
5_3868825,in_package5_truck3,3868825,5,1,28,29,0
5_5263322,location_city6-1,5263322,5,1,9,10,0
4_200206,load-airplane_package1_plane1_city3-2,200206,4,4,266,270,0
3_6889493,at_package1_city3-2,6889493,3,0,5,5,0
4_4276756,load-airplane_package1_plane2_city1-2,4276756,4,5,266,271,0
5_625646,airport_city10-2,625646,5,1,73,74,0
5_5263323,location_city6-2,5263323,5,1,52,53,0
4_1361557,noop_at_package1_city8-2,1361557,4,1,109,110,0
5_323304,airport_city4-2,323304,5,1,73,74,0
4_685857,load-airplane_package5_plane2_city7-2,685857,4,5,266,271,0
4_4762407,load-airplane_package5_plane3_city5-2,4762407,4,5,266,271,0
5_7765433,in-city_city4-2_city4,7765433,5,1,3,4,0
4_4735508,load-airplane_package1_plane2_city8-2,4735508,4,5,266,271,0
4_5917909,noop_at_package4_city7-1,5917909,4,0,134,134,0
3_3772548,at_package4_city7-1,3772548,3,0,1,1,0
4_3604059,unload-truck_package4_truck10_city10-2,3604059,4,5,155,160,0
4_680009,load-airplane_package1_plane3_city4-2,680009,4,5,266,271,0
5_1230283,truck_truck10,1230283,5,1,21,22,0
4_1165660,load-airplane_package5_plane4_city8-2,1165660,4,4,266,270,0
3_44730,at_package5_city8-2,44730,3,0,5,5,0
4_3099260,load-truck_package1_truck9_city9-2,3099260,4,4,113,117,0
3_7282709,at_package1_city9-2,7282709,3,0,5,5,0
5_552690,in_package1_truck9,552690,5,1,28,29,0
4_1862411,noop_at_package5_city3-2,1862411,4,1,109,110,0
4_3990711,unload-truck_package4_truck4_city4-2,3990711,4,4,155,159,0
3_5040035,in_package4_truck4,5040035,3,0,1,1,0
4_5215311,load-airplane_package1_plane4_city9-2,5215311,4,5,266,271,0
4_5191061,load-truck_package1_truck2_city2-1,5191061,4,4,120,124,0
3_6823956,at_package1_city2-1,6823956,3,0,1,1,0
5_5367137,in-city_city1-1_city1,5367137,5,1,3,4,0
5_5001178,location_city2-1,5001178,5,1,10,11,0
4_4479212,load-airplane_package5_plane1_city7-2,4479212,4,5,266,271,0
5_5001179,location_city2-2,5001179,5,1,52,53,0
4_1099413,noop_at_package1_city4-2,1099413,4,1,109,110,0
5_3715160,airplane_plane1,3715160,5,1,191,192,0
4_423713,load-airplane_package5_plane2_city3-2,423713,4,5,266,271,0
5_5459930,location_city9-1,5459930,5,1,9,10,0
5_3715161,airplane_plane2,3715161,5,1,191,192,0
4_396814,load-airplane_package1_plane1_city6-2,396814,4,5,266,271,0
4_4473364,load-airplane_package1_plane2_city4-2,4473364,4,5,266,271,0
4_2842964,load-truck_package5_truck8_city8-2,2842964,4,5,113,118,0
5_3868830,in_package5_truck8,3868830,5,1,27,28,0
5_2816590,in-city_city8-1_city8,2816590,5,1,3,4,0
5_5459931,location_city9-2,5459931,5,1,52,53,0
5_3715162,airplane_plane3,3715162,5,1,191,192,0
5_519912,airport_city7-2,519912,5,1,73,74,0
4_3259165,unload-truck_package3_truck5_city5-2,3259165,4,4,131,135,0
3_6211245,in_package3_truck5,6211245,3,0,1,1,0
4_4959015,load-airplane_package5_plane3_city8-2,4959015,4,5,266,271,0
4_4934765,load-truck_package5_truck1_city1-1,4934765,4,4,120,124,0
3_7586954,at_package5_city1-1,7586954,3,0,1,1,0
5_3143541,in-city_city1-2_city1,3143541,5,1,3,4,0
5_3715163,airplane_plane4,3715163,5,1,191,192,0
4_4697066,unload-airplane_package2_plane2_city10-2,4697066,4,4,191,195,0
3_4475738,in_package2_plane2,4475738,3,0,1,1,0
4_950716,load-airplane_package1_plane4_city10-2,950716,4,5,263,268,0
4_903516,load-airplane_package5_plane4_city4-2,903516,4,5,266,271,0
4_6736717,unload-airplane_package2_plane4_city10-2,6736717,4,4,191,195,0
3_4475740,in_package2_plane4,4475740,3,0,1,1,0
4_876617,load-airplane_package1_plane3_city7-2,876617,4,5,266,271,0
4_4953167,load-airplane_package1_plane4_city5-2,4953167,4,5,266,271,0
4_4217068,load-airplane_package5_plane1_city3-2,4217068,4,5,266,271,0
4_122018,load-airplane_package5_plane3_city10-2,122018,4,5,263,268,0
5_6609944,in-city_city7-1_city7,6609944,5,1,3,4,0
4_2059019,noop_at_package5_city6-2,2059019,4,0,109,109,0
3_7914635,at_package5_city6-2,7914635,3,0,5,5,0
5_5197786,location_city5-1,5197786,5,1,9,10,0
4_1016670,noop_in_package4_truck1,1016670,4,0,145,145,0
3_5040032,in_package4_truck1,5040032,3,0,1,1,0
4_1353570,unload-truck_package4_truck9_city9-2,1353570,4,4,155,159,0
3_5040040,in_package4_truck9,5040040,3,0,1,1,0
5_7566596,location_city10-1,7566596,5,1,11,12,0
5_5197787,location_city5-2,5197787,5,1,52,53,0
4_1296021,noop_at_package1_city7-2,1296021,4,1,109,110,0
4_1016671,noop_in_package4_truck2,1016671,4,0,145,145,0
3_5040033,in_package4_truck2,5040033,3,0,1,1,0
5_257768,airport_city3-2,257768,5,1,73,74,0
4_620321,load-airplane_package5_plane2_city6-2,620321,4,5,266,271,0
4_4696871,load-airplane_package5_plane3_city4-2,4696871,4,5,266,271,0
4_2553921,load-truck_package1_truck7_city7-2,2553921,4,5,116,121,0
5_552688,in_package1_truck7,552688,5,1,29,30,0
5_7566597,location_city10-2,7566597,5,1,53,54,0
4_1016672,noop_in_package4_truck3,1016672,4,0,156,156,0
3_5040034,in_package4_truck3,5040034,3,0,1,1,0
4_3445372,unload-truck_package4_truck2_city2-2,3445372,4,5,147,152,0
4_593422,load-airplane_package1_plane1_city9-2,593422,4,5,266,271,0
4_4669972,load-airplane_package1_plane2_city7-2,4669972,4,5,266,271,0
4_7116122,load-truck_package5_truck9_city9-2,7116122,4,5,113,118,0
5_3868831,in_package5_truck9,3868831,5,1,28,29,0
5_4386348,in-city_city7-2_city7,4386348,5,1,3,4,0
4_1016673,noop_in_package4_truck4,1016673,4,1,153,154,0
5_2402321,in-city_city6-1_city6,2402321,5,1,3,4,0
4_7532323,unload-truck_package3_truck6_city6-2,7532323,4,4,131,135,0
3_6211246,in_package3_truck6,6211246,3,0,1,1,0
4_614473,load-airplane_package1_plane3_city3-2,614473,4,5,266,271,0
4_4691023,load-airplane_package1_plane4_city1-2,4691023,4,5,266,271,0
4_3471673,load-truck_package3_truck3_city3-1,3471673,4,4,136,140,0
3_7303759,at_package3_city3-1,7303759,3,0,1,1,0
4_1016674,noop_in_package4_truck5,1016674,4,0,153,153,0
3_5040036,in_package4_truck5,5040036,3,0,1,1,0
4_1100124,load-airplane_package5_plane4_city7-2,1100124,4,5,266,271,0
4_1796875,noop_at_package5_city2-2,1796875,4,0,109,109,0
3_7652491,at_package5_city2-2,7652491,3,0,5,5,0
4_1016675,noop_in_package4_truck6,1016675,4,1,153,154,0
4_452375,noop_in_package2_plane1,452375,4,0,181,181,0
3_4475737,in_package2_plane1,4475737,3,0,1,1,0
4_5149775,load-airplane_package1_plane4_city8-2,5149775,4,5,266,271,0
4_2297625,load-truck_package5_truck6_city6-2,2297625,4,5,113,118,0
5_3868828,in_package5_truck6,3868828,5,1,28,29,0
5_4935642,location_city1-1,4935642,5,1,10,11,0
4_452376,noop_in_package2_plane2,452376,4,1,181,182,0
4_4413676,load-airplane_package5_plane1_city6-2,4413676,4,5,266,271,0
4_3173776,load-truck_package1_truck10_city10-2,3173776,4,5,115,120,0
5_5470031,in_package1_truck10,5470031,5,1,28,29,0
5_4935643,location_city1-2,4935643,5,1,52,53,0
4_1033877,noop_at_package1_city3-2,1033877,4,1,109,110,0
4_1016677,noop_in_package4_truck8,1016677,4,0,153,153,0
3_5040039,in_package4_truck8,5040039,3,0,1,1,0
4_452377,noop_in_package2_plane3,452377,4,1,197,198,0
5_178725,in-city_city6-2_city6,178725,5,1,3,4,0
4_3364427,noop_at_package5_city10-2,3364427,4,1,109,110,0
4_2255627,noop_at_package5_city9-2,2255627,4,1,109,110,0
4_358177,load-airplane_package5_plane2_city2-2,358177,4,5,266,271,0
5_5394394,location_city8-1,5394394,5,1,9,10,0
4_1016678,noop_in_package4_truck9,1016678,4,1,153,154,0
4_452378,noop_in_package2_plane4,452378,4,1,181,182,0
4_331278,load-airplane_package1_plane1_city5-2,331278,4,5,266,271,0
4_1891728,load-airplane_package1_plane1_city10-2,1891728,4,5,263,268,0
4_4407828,load-airplane_package1_plane2_city3-2,4407828,4,5,266,271,0
4_1566078,load-truck_package4_truck7_city7-1,1566078,4,5,136,141,0
5_5394395,location_city8-2,5394395,5,1,52,53,0
4_2187879,noop_in_package3_truck1,2187879,4,0,132,132,0
3_6211241,in_package3_truck1,6211241,3,0,1,1,0
5_454376,airport_city6-2,454376,5,1,73,74,0
4_7677729,unload-airplane_package2_plane1_city10-2,7677729,4,5,191,196,0
4_3931379,load-airplane_package1_plane3_city10-2,3931379,4,5,263,268,0
4_816929,load-airplane_package5_plane2_city9-2,816929,4,5,266,271,0
4_4893479,load-airplane_package5_plane3_city7-2,4893479,4,5,266,271,0
4_6827079,load-truck_package1_truck8_city8-2,6827079,4,5,113,118,0
5_552689,in_package1_truck8,552689,5,1,28,29,0
4_2187880,noop_in_package3_truck2,2187880,4,0,132,132,0
3_6211242,in_package3_truck2,6211242,3,0,1,1,0
4_7718530,unload-truck_package4_truck3_city3-2,7718530,4,5,158,163,0
4_837980,load-airplane_package5_plane4_city3-2,837980,4,5,266,271,0
5_5781406,in-city_city3-1_city3,5781406,5,1,3,4,0
4_811081,load-airplane_package1_plane3_city6-2,811081,4,5,266,271,0
4_4887631,load-airplane_package1_plane4_city4-2,4887631,4,5,266,271,0
4_3102681,load-airplane_package5_plane2_city10-2,3102681,4,5,263,268,0
4_28682,noop_in_package3_truck10,28682,4,1,131,132,0
4_2187882,noop_in_package3_truck4,2187882,4,0,129,129,0
3_6211244,in_package3_truck4,6211244,3,0,1,1,0
4_4151532,load-airplane_package5_plane1_city2-2,4151532,4,5,266,271,0
4_5142332,load-airplane_package5_plane4_city10-2,5142332,4,5,263,268,0
4_2008582,load-truck_package1_truck5_city5-2,2008582,4,5,113,118,0
5_552686,in_package1_truck5,552686,5,1,28,29,0
4_1993483,noop_at_package5_city5-2,1993483,4,1,109,110,0
4_2187883,noop_in_package3_truck5,2187883,4,1,129,130,0
4_6570783,load-truck_package5_truck7_city7-2,6570783,4,5,116,121,0
5_3868829,in_package5_truck7,3868829,5,1,29,30,0
4_2187884,noop_in_package3_truck6,2187884,4,1,129,130,0
5_5132250,location_city4-1,5132250,5,1,9,10,0
4_6986984,unload-truck_package3_truck4_city4-2,6986984,4,5,131,136,0
4_69134,load-airplane_package1_plane1_city1-2,69134,4,5,266,271,0
4_4610284,load-airplane_package5_plane1_city9-2,4610284,4,5,266,271,0
4_2187885,noop_in_package3_truck7,2187885,4,1,132,133,0
5_1573783,in-city_city2-1_city2,1573783,5,1,3,4,0
5_192232,airport_city2-2,192232,5,1,73,74,0
5_3557810,in-city_city3-2_city3,3557810,5,1,3,4,0
5_5132251,location_city4-2,5132251,5,1,52,53,0
4_1230485,noop_at_package1_city6-2,1230485,4,1,109,110,0
5_7347850,in-city_city10-2_city10,7347850,5,1,3,4,0
4_76685,unload-truck_package3_truck8_city8-2,76685,4,4,131,135,0
3_6211248,in_package3_truck8,6211248,3,0,1,1,0
4_554785,load-airplane_package5_plane2_city5-2,554785,4,5,266,271,0
4_4631335,load-airplane_package5_plane3_city3-2,4631335,4,5,266,271,0
4_2187886,noop_in_package3_truck8,2187886,4,1,129,130,0
5_2661380,truck_truck1,2661380,5,1,19,20,0
4_527886,load-airplane_package1_plane1_city8-2,527886,4,5,266,271,0
4_4604436,load-airplane_package1_plane2_city6-2,4604436,4,5,266,271,0
4_1752286,load-truck_package5_truck4_city4-2,1752286,4,5,113,118,0
5_3868826,in_package5_truck4,3868826,5,1,28,29,0
4_2187887,noop_in_package3_truck9,2187887,4,0,129,129,0
3_6211249,in_package3_truck9,6211249,3,0,1,1,0
5_650984,airport_city9-2,650984,5,1,73,74,0
5_2661381,truck_truck2,2661381,5,1,19,20,0
4_2168487,unload-truck_package3_truck1_city1-2,2168487,4,5,134,139,0
5_2661382,truck_truck3,2661382,5,1,18,19,0
5_7024213,in-city_city9-1_city9,7024213,5,1,3,4,0
4_1731338,noop_at_package5_city1-1,1731338,4,1,118,119,0
4_1034588,load-airplane_package5_plane4_city6-2,1034588,4,5,266,271,0
5_2661383,truck_truck4,2661383,5,1,18,19,0
5_7351164,in-city_city2-2_city2,7351164,5,1,3,4,0
4_5081389,unload-truck_package4_truck8_city8-2,5081389,4,5,155,160,0
4_1007689,load-airplane_package1_plane3_city9-2,1007689,4,5,266,271,0
4_5084239,load-airplane_package1_plane4_city7-2,5084239,4,5,266,271,0
5_2661384,truck_truck5,2661384,5,1,18,19,0
4_968340,noop_at_package1_city2-1,968340,4,1,118,119,0
4_4348140,load-airplane_package5_plane1_city5-2,4348140,4,5,266,271,0
4_6281740,load-truck_package1_truck6_city6-2,6281740,4,5,113,118,0
5_552687,in_package1_truck6,552687,5,1,28,29,0
5_2661385,truck_truck6,2661385,5,1,18,19,0
4_2190091,noop_at_package5_city8-2,2190091,4,1,109,110,0
4_7173191,unload-truck_package4_truck1_city1-2,7173191,4,5,147,152,0
5_2661386,truck_truck7,2661386,5,1,18,19,0
5_4800617,in-city_city9-2_city9,4800617,5,1,3,4,0
5_5328858,location_city7-1,5328858,5,1,9,10,0
4_262892,unload-truck_package4_truck5_city5-2,262892,4,5,155,160,0
4_265742,load-airplane_package1_plane1_city4-2,265742,4,5,266,271,0
4_6912042,load-airplane_package1_plane2_city10-2,6912042,4,5,263,268,0
5_6497292,city_city1,6497292,5,1,3,4,0
5_388840,airport_city5-2,388840,5,1,73,74,0
5_2661387,truck_truck8,2661387,5,1,18,19,0
5_5328859,location_city7-2,5328859,5,1,52,53,0
4_1448143,noop_at_package3_city3-1,1448143,4,1,134,135,0
4_1427093,noop_at_package1_city9-2,1427093,4,1,109,110,0
4_4349843,unload-truck_package3_truck9_city9-2,4349843,4,5,131,136,0
4_751393,load-airplane_package5_plane2_city8-2,751393,4,5,266,271,0
4_4827943,load-airplane_package5_plane3_city6-2,4827943,4,5,266,271,0
4_1463243,load-truck_package1_truck3_city3-2,1463243,4,5,116,121,0
5_552684,in_package1_truck3,552684,5,1,29,30,0
5_6497293,city_city2,6497293,5,1,3,4,0
5_2661388,truck_truck9,2661388,5,1,18,19,0
5_518082,in-city_city10-1_city10,518082,5,1,3,4,0
4_4801044,load-airplane_package1_plane2_city9-2,4801044,4,5,266,271,0
4_6083344,load-airplane_package5_plane1_city10-2,6083344,4,5,263,268,0
4_772444,load-airplane_package5_plane4_city2-2,772444,4,5,266,271,0
4_6025444,load-truck_package5_truck5_city5-2,6025444,4,5,113,118,0
5_3868827,in_package5_truck5,3868827,5,1,27,28,0
5_6497294,city_city3,6497294,5,1,3,4,0
5_4435789,obj_package1,4435789,5,1,112,113,0
4_6441645,unload-truck_package3_truck2_city2-2,6441645,4,5,134,139,0
4_745545,load-airplane_package1_plane3_city5-2,745545,4,5,266,271,0
4_4822095,load-airplane_package1_plane4_city3-2,4822095,4,5,266,271,0
5_6497295,city_city4,6497295,5,1,3,4,0
5_592994,in-city_city8-2_city8,592994,5,1,3,4,0
5_4435790,obj_package2,4435790,5,1,94,95,0
4_1231196,load-airplane_package5_plane4_city9-2,1231196,4,5,266,271,0
5_6497296,city_city5,6497296,5,1,3,4,0
5_4435791,obj_package3,4435791,5,1,121,122,0
4_1927947,noop_at_package5_city4-2,1927947,4,1,109,110,0
4_1206947,load-truck_package5_truck2_city2-2,1206947,4,5,116,121,0
5_3868824,in_package5_truck2,3868824,5,1,28,29,0
5_6497297,city_city6,6497297,5,1,3,4,0
5_4435792,obj_package4,4435792,5,1,121,122,0
5_5066714,location_city3-1,5066714,5,1,9,10,0
4_4544748,load-airplane_package5_plane1_city8-2,4544748,4,5,266,271,0
5_6497298,city_city7,6497298,5,1,3,4,0
5_126696,airport_city1-2,126696,5,1,73,74,0
5_4435793,obj_package5,4435793,5,1,112,113,0
5_5066715,location_city3-2,5066715,5,1,52,53,0
4_1164949,noop_at_package1_city5-2,1164949,4,1,109,110,0
4_489249,load-airplane_package5_plane2_city4-2,489249,4,5,266,271,0
4_4565799,load-airplane_package5_plane3_city2-2,4565799,4,5,266,271,0
6_7670415,noop_at_plane3_city10-2,7670415,6,181,190,371,0
6_4181684,fly-airplane_plane3_city10-2_city4-2,4181684,6,194,201,395,0
6_4378292,fly-airplane_plane3_city10-2_city7-2,4378292,6,194,201,395,0
6_4116148,fly-airplane_plane3_city10-2_city3-2,4116148,6,194,201,395,0
6_4312756,fly-airplane_plane3_city10-2_city6-2,4312756,6,194,201,395,0
6_4050612,fly-airplane_plane3_city10-2_city2-2,4050612,6,194,201,395,0
6_4509364,fly-airplane_plane3_city10-2_city9-2,4509364,6,194,201,395,0
6_4247220,fly-airplane_plane3_city10-2_city5-2,4247220,6,194,201,395,0
6_3985076,fly-airplane_plane3_city10-2_city1-2,3985076,6,194,201,395,0
6_4443828,fly-airplane_plane3_city10-2_city8-2,4443828,6,194,201,395,0
6_668499,unload-airplane_package1_plane3_city10-2,668499,6,293,308,601,0
6_1716403,unload-airplane_package2_plane3_city10-2,1716403,6,230,281,511,0
6_2764307,unload-airplane_package3_plane3_city10-2,2764307,6,302,326,628,0
6_3812211,unload-airplane_package4_plane3_city10-2,3812211,6,302,326,628,0
6_4860115,unload-airplane_package5_plane3_city10-2,4860115,6,293,308,601,0
6_3931379,load-airplane_package1_plane3_city10-2,3931379,6,293,308,601,0
6_4979283,load-airplane_package2_plane3_city10-2,4979283,6,230,281,511,0
6_6027187,load-airplane_package3_plane3_city10-2,6027187,6,302,326,628,0
6_7075091,load-airplane_package4_plane3_city10-2,7075091,6,302,326,628,0
6_122018,load-airplane_package5_plane3_city10-2,122018,6,293,308,601,0
6_4773327,at_plane3_city4-2,4773327,6,27,28,55,0
6_5035471,at_plane3_city8-2,5035471,6,27,28,55,0
6_4576719,at_plane3_city1-2,4576719,6,27,28,55,0
6_4838863,at_plane3_city5-2,4838863,6,27,28,55,0
6_5101007,at_plane3_city9-2,5101007,6,27,19,46,0
6_4642255,at_plane3_city2-2,4642255,6,27,18,45,0
6_4969935,at_plane3_city7-2,4969935,6,27,28,55,0
6_4707791,at_plane3_city3-2,4707791,6,27,28,55,0
6_4904399,at_plane3_city6-2,4904399,6,27,28,55,0
6_5896302,noop_at_plane4_city2-2,5896302,6,182,190,372,0
6_5852660,fly-airplane_plane4_city2-2_city4-2,5852660,6,194,201,395,0
6_6049268,fly-airplane_plane4_city2-2_city7-2,6049268,6,194,201,395,0
6_5787124,fly-airplane_plane4_city2-2_city3-2,5787124,6,194,201,395,0
6_5983732,fly-airplane_plane4_city2-2_city6-2,5983732,6,194,201,395,0
6_6180340,fly-airplane_plane4_city2-2_city9-2,6180340,6,194,201,395,0
6_5918196,fly-airplane_plane4_city2-2_city5-2,5918196,6,194,201,395,0
6_7968830,fly-airplane_plane4_city2-2_city10-2,7968830,6,194,201,395,0
6_5656052,fly-airplane_plane4_city2-2_city1-2,5656052,6,194,201,395,0
6_6114804,fly-airplane_plane4_city2-2_city8-2,6114804,6,194,201,395,0
6_1743447,unload-airplane_package1_plane4_city2-2,1743447,6,294,308,602,0
6_6748151,unload-airplane_package2_plane4_city2-2,6748151,6,230,281,511,0
6_3751878,unload-airplane_package3_plane4_city2-2,3751878,6,303,326,629,0
6_755605,unload-airplane_package4_plane4_city2-2,755605,6,303,326,629,0
6_5760309,unload-airplane_package5_plane4_city2-2,5760309,6,294,308,602,0
6_4756559,load-airplane_package1_plane4_city2-2,4756559,6,294,308,602,0
6_6764990,load-airplane_package3_plane4_city2-2,6764990,6,303,326,629,0
6_3768717,load-airplane_package4_plane4_city2-2,3768717,6,303,326,629,0
6_772444,load-airplane_package5_plane4_city2-2,772444,6,294,308,602,0
6_1176580,at_plane4_city7-2,1176580,6,27,28,55,0
6_979972,at_plane4_city4-2,979972,6,27,28,55,0
6_1242116,at_plane4_city8-2,1242116,6,27,28,55,0
6_783364,at_plane4_city1-2,783364,6,27,28,55,0
6_1045508,at_plane4_city5-2,1045508,6,27,18,45,0
6_1307652,at_plane4_city9-2,1307652,6,27,17,44,0
6_914436,at_plane4_city3-2,914436,6,27,28,55,0
6_712137,at_plane4_city10-2,712137,6,27,28,55,0
6_1111044,at_plane4_city6-2,1111044,6,27,28,55,0
6_4005501,noop_city_city9,4005501,6,1,1,2,0
6_5227117,drive-truck_truck9_city9-1_city9-2_city9,5227117,6,22,20,42,0
6_2469652,drive-truck_truck9_city9-2_city9-1_city9,2469652,6,20,22,42,0
6_2839184,noop_location_city4-1,2839184,6,1,1,2,0
6_4013645,drive-truck_truck4_city4-1_city4-2_city4,4013645,6,22,20,42,0
6_1256180,drive-truck_truck4_city4-2_city4-1_city4,1256180,6,20,22,42,0
6_6986983,unload-truck_package3_truck4_city4-1,6986983,6,151,165,316,0
6_3990710,unload-truck_package4_truck4_city4-1,3990710,6,151,165,316,0
6_2937985,noop_in-city_city10-2_city10,2937985,6,1,1,2,0
6_7656764,drive-truck_truck10_city10-1_city10-2_city10,7656764,6,26,23,49,0
6_1874900,drive-truck_truck10_city10-2_city10-1_city10,1874900,6,24,25,49,0
6_2839185,noop_location_city4-2,2839185,6,1,1,2,0
6_5253607,unload-airplane_package1_plane1_city4-2,5253607,6,294,308,602,0
6_1460252,unload-airplane_package1_plane2_city4-2,1460252,6,294,308,602,0
6_5667874,unload-airplane_package1_plane3_city4-2,5667874,6,294,308,602,0
6_1874519,unload-airplane_package1_plane4_city4-2,1874519,6,294,308,602,0
6_2257334,unload-airplane_package2_plane1_city4-2,2257334,6,230,281,511,0
6_6464956,unload-airplane_package2_plane2_city4-2,6464956,6,230,281,511,0
6_2671601,unload-airplane_package2_plane3_city4-2,2671601,6,230,281,511,0
6_6879223,unload-airplane_package2_plane4_city4-2,6879223,6,230,281,511,0
6_7262038,unload-airplane_package3_plane1_city4-2,7262038,6,303,326,629,0
6_3468683,unload-airplane_package3_plane2_city4-2,3468683,6,303,326,629,0
6_7676305,unload-airplane_package3_plane3_city4-2,7676305,6,303,326,629,0
6_3882950,unload-airplane_package3_plane4_city4-2,3882950,6,303,326,629,0
6_4265765,unload-airplane_package4_plane1_city4-2,4265765,6,303,326,629,0
6_472410,unload-airplane_package4_plane2_city4-2,472410,6,303,326,629,0
6_4680032,unload-airplane_package4_plane3_city4-2,4680032,6,303,326,629,0
6_886677,unload-airplane_package4_plane4_city4-2,886677,6,303,326,629,0
6_1269492,unload-airplane_package5_plane1_city4-2,1269492,6,294,308,602,0
6_5477114,unload-airplane_package5_plane2_city4-2,5477114,6,294,308,602,0
6_1683759,unload-airplane_package5_plane3_city4-2,1683759,6,294,308,602,0
6_5891381,unload-airplane_package5_plane4_city4-2,5891381,6,294,308,602,0
6_4978553,unload-truck_package1_truck4_city4-2,4978553,6,136,147,283,0
6_6986984,unload-truck_package3_truck4_city4-2,6986984,6,144,163,307,0
6_3990711,unload-truck_package4_truck4_city4-2,3990711,6,144,163,307,0
6_994438,unload-truck_package5_truck4_city4-2,994438,6,136,147,283,0
6_265742,load-airplane_package1_plane1_city4-2,265742,6,294,308,602,0
6_4473364,load-airplane_package1_plane2_city4-2,4473364,6,294,308,602,0
6_680009,load-airplane_package1_plane3_city4-2,680009,6,294,308,602,0
6_4887631,load-airplane_package1_plane4_city4-2,4887631,6,294,308,602,0
6_2274173,load-airplane_package3_plane1_city4-2,2274173,6,303,326,629,0
6_6481795,load-airplane_package3_plane2_city4-2,6481795,6,303,326,629,0
6_2688440,load-airplane_package3_plane3_city4-2,2688440,6,303,326,629,0
6_6896062,load-airplane_package3_plane4_city4-2,6896062,6,303,326,629,0
6_7278877,load-airplane_package4_plane1_city4-2,7278877,6,303,326,629,0
6_3485522,load-airplane_package4_plane2_city4-2,3485522,6,303,326,629,0
6_7693144,load-airplane_package4_plane3_city4-2,7693144,6,303,326,629,0
6_3899789,load-airplane_package4_plane4_city4-2,3899789,6,303,326,629,0
6_4282604,load-airplane_package5_plane1_city4-2,4282604,6,294,308,602,0
6_489249,load-airplane_package5_plane2_city4-2,489249,6,294,308,602,0
6_4696871,load-airplane_package5_plane3_city4-2,4696871,6,294,308,602,0
6_903516,load-airplane_package5_plane4_city4-2,903516,6,294,308,602,0
6_5736401,load-truck_package1_truck4_city4-2,5736401,6,136,147,283,0
6_7744832,load-truck_package3_truck4_city4-2,7744832,6,144,163,307,0
6_4748559,load-truck_package4_truck4_city4-2,4748559,6,144,163,307,0
6_1752286,load-truck_package5_truck4_city4-2,1752286,6,136,147,283,0
6_1230485,noop_at_package1_city6-2,1230485,6,127,136,263,0
6_396814,load-airplane_package1_plane1_city6-2,396814,6,294,308,602,0
6_4604436,load-airplane_package1_plane2_city6-2,4604436,6,294,308,602,0
6_811081,load-airplane_package1_plane3_city6-2,811081,6,294,308,602,0
6_5018703,load-airplane_package1_plane4_city6-2,5018703,6,294,308,602,0
6_6281740,load-truck_package1_truck6_city6-2,6281740,6,136,147,283,0
6_552690,in_package1_truck9,552690,6,27,28,55,0
6_552689,in_package1_truck8,552689,6,27,28,55,0
6_552688,in_package1_truck7,552688,6,28,27,55,0
6_552687,in_package1_truck6,552687,6,27,28,55,0
6_552686,in_package1_truck5,552686,6,27,28,55,0
6_552685,in_package1_truck4,552685,6,27,28,55,0
6_552684,in_package1_truck3,552684,6,28,27,55,0
6_552682,in_package1_truck1,552682,6,28,28,56,0
6_5470031,in_package1_truck10,5470031,6,27,28,55,0
6_6955029,at_package1_city4-2,6955029,6,34,29,63,0
6_7217173,at_package1_city8-2,7217173,6,34,29,63,0
6_2140122,at_package1_city10-2,2140122,6,34,29,63,0
6_6758421,at_package1_city1-2,6758421,6,34,29,63,0
6_7020565,at_package1_city5-2,7020565,6,34,29,63,0
6_7282709,at_package1_city9-2,7282709,6,34,29,63,0
6_6823957,at_package1_city2-2,6823957,6,34,29,63,0
6_6823956,at_package1_city2-1,6823956,6,29,24,53,0
6_552683,in_package1_truck2,552683,6,28,26,54,0
6_7151637,at_package1_city7-2,7151637,6,34,29,63,0
6_6889493,at_package1_city3-2,6889493,6,34,29,63,0
6_5646946,in_package1_plane1,5646946,6,44,34,78,0
6_5646947,in_package1_plane2,5646947,6,44,34,78,0
6_5646948,in_package1_plane3,5646948,6,44,34,78,0
6_5646949,in_package1_plane4,5646949,6,44,34,78,0
6_1208877,noop_at_plane1_city1-2,1208877,6,182,190,372,0
6_5665861,fly-airplane_plane1_city1-2_city4-2,5665861,6,194,201,395,0
6_5862469,fly-airplane_plane1_city1-2_city7-2,5862469,6,194,201,395,0
6_5600325,fly-airplane_plane1_city1-2_city3-2,5600325,6,194,201,395,0
6_5796933,fly-airplane_plane1_city1-2_city6-2,5796933,6,194,201,395,0
6_5534789,fly-airplane_plane1_city1-2_city2-2,5534789,6,194,201,395,0
6_5993541,fly-airplane_plane1_city1-2_city9-2,5993541,6,194,201,395,0
6_5731397,fly-airplane_plane1_city1-2_city5-2,5731397,6,194,201,395,0
6_153171,fly-airplane_plane1_city1-2_city10-2,153171,6,194,201,395,0
6_5928005,fly-airplane_plane1_city1-2_city8-2,5928005,6,194,201,395,0
6_5056999,unload-airplane_package1_plane1_city1-2,5056999,6,294,308,602,0
6_2060726,unload-airplane_package2_plane1_city1-2,2060726,6,230,281,511,0
6_7065430,unload-airplane_package3_plane1_city1-2,7065430,6,303,326,629,0
6_4069157,unload-airplane_package4_plane1_city1-2,4069157,6,303,326,629,0
6_1072884,unload-airplane_package5_plane1_city1-2,1072884,6,294,308,602,0
6_69134,load-airplane_package1_plane1_city1-2,69134,6,294,308,602,0
6_2077565,load-airplane_package3_plane1_city1-2,2077565,6,303,326,629,0
6_7082269,load-airplane_package4_plane1_city1-2,7082269,6,303,326,629,0
6_4085996,load-airplane_package5_plane1_city1-2,4085996,6,294,308,602,0
6_4490132,at_plane1_city6-2,4490132,6,27,28,55,0
6_4293524,at_plane1_city3-2,4293524,6,27,28,55,0
6_4555668,at_plane1_city7-2,4555668,6,27,28,55,0
6_4359060,at_plane1_city4-2,4359060,6,27,28,55,0
6_4621204,at_plane1_city8-2,4621204,6,27,17,44,0
6_4227988,at_plane1_city2-2,4227988,6,27,28,55,0
6_4686740,at_plane1_city9-2,4686740,6,27,28,55,0
6_4424596,at_plane1_city5-2,4424596,6,27,28,55,0
6_1653149,at_plane1_city10-2,1653149,6,27,28,55,0
6_6355054,noop_at_plane4_city9-2,6355054,6,182,190,372,0
6_1156223,fly-airplane_plane4_city9-2_city4-2,1156223,6,194,201,395,0
6_1352831,fly-airplane_plane4_city9-2_city7-2,1352831,6,194,201,395,0
6_1090687,fly-airplane_plane4_city9-2_city3-2,1090687,6,194,201,395,0
6_1287295,fly-airplane_plane4_city9-2_city6-2,1287295,6,194,201,395,0
6_1025151,fly-airplane_plane4_city9-2_city2-2,1025151,6,194,201,395,0
6_1221759,fly-airplane_plane4_city9-2_city5-2,1221759,6,194,201,395,0
6_5827508,fly-airplane_plane4_city9-2_city10-2,5827508,6,194,201,395,0
6_959615,fly-airplane_plane4_city9-2_city1-2,959615,6,194,201,395,0
6_1418367,fly-airplane_plane4_city9-2_city8-2,1418367,6,194,201,395,0
6_2202199,unload-airplane_package1_plane4_city9-2,2202199,6,294,308,602,0
6_7206903,unload-airplane_package2_plane4_city9-2,7206903,6,230,281,511,0
6_4210630,unload-airplane_package3_plane4_city9-2,4210630,6,303,326,629,0
6_1214357,unload-airplane_package4_plane4_city9-2,1214357,6,303,326,629,0
6_6219061,unload-airplane_package5_plane4_city9-2,6219061,6,294,308,602,0
6_5215311,load-airplane_package1_plane4_city9-2,5215311,6,294,308,602,0
6_7223742,load-airplane_package3_plane4_city9-2,7223742,6,303,326,629,0
6_4227469,load-airplane_package4_plane4_city9-2,4227469,6,303,326,629,0
6_1231196,load-airplane_package5_plane4_city9-2,1231196,6,294,308,602,0
6_848900,at_plane4_city2-2,848900,6,27,9,36,0
6_7198704,noop_in-city_city4-1_city4,7198704,6,1,1,2,0
6_1710288,noop_at_package3_city7-2,1710288,6,136,154,290,0
6_2470781,load-airplane_package3_plane1_city7-2,2470781,6,303,326,629,0
6_6678403,load-airplane_package3_plane2_city7-2,6678403,6,303,326,629,0
6_2885048,load-airplane_package3_plane3_city7-2,2885048,6,303,326,629,0
6_7092670,load-airplane_package3_plane4_city7-2,7092670,6,303,326,629,0
6_4562352,load-truck_package3_truck7_city7-2,4562352,6,145,162,307,0
6_3304531,in_package3_plane4,3304531,6,44,43,87,0
6_3304530,in_package3_plane3,3304530,6,44,43,87,0
6_3304529,in_package3_plane2,3304529,6,44,43,87,0
6_3304528,in_package3_plane1,3304528,6,44,43,87,0
6_7696976,at_package3_city9-2,7696976,6,34,38,72,0
6_7238224,at_package3_city2-2,7238224,6,34,38,72,0
6_4179773,at_package3_city10-2,4179773,6,34,38,72,0
6_7500368,at_package3_city6-2,7500368,6,34,38,72,0
6_7303760,at_package3_city3-2,7303760,6,34,38,72,0
6_7303759,at_package3_city3-1,7303759,6,29,34,63,0
6_7434832,at_package3_city5-2,7434832,6,34,38,72,0
6_7172688,at_package3_city1-2,7172688,6,34,38,72,0
6_7631440,at_package3_city8-2,7631440,6,34,38,72,0
6_6211241,in_package3_truck1,6211241,6,28,35,63,0
6_6211242,in_package3_truck2,6211242,6,28,35,63,0
6_6211243,in_package3_truck3,6211243,6,28,35,63,0
6_6211244,in_package3_truck4,6211244,6,27,35,62,0
6_6211245,in_package3_truck5,6211245,6,27,35,62,0
6_6211246,in_package3_truck6,6211246,6,27,35,62,0
6_7369296,at_package3_city4-2,7369296,6,34,38,72,0
6_6211247,in_package3_truck7,6211247,6,28,35,63,0
6_5884298,in_package3_truck10,5884298,6,27,35,62,0
6_6211248,in_package3_truck8,6211248,6,27,35,62,0
6_6211249,in_package3_truck9,6211249,6,27,35,62,0
6_1667629,noop_at_plane1_city8-2,1667629,6,182,190,372,0
6_969424,fly-airplane_plane1_city8-2_city4-2,969424,6,194,201,395,0
6_1166032,fly-airplane_plane1_city8-2_city7-2,1166032,6,194,201,395,0
6_903888,fly-airplane_plane1_city8-2_city3-2,903888,6,194,201,395,0
6_1100496,fly-airplane_plane1_city8-2_city6-2,1100496,6,194,201,395,0
6_838352,fly-airplane_plane1_city8-2_city2-2,838352,6,194,201,395,0
6_1297104,fly-airplane_plane1_city8-2_city9-2,1297104,6,194,201,395,0
6_1034960,fly-airplane_plane1_city8-2_city5-2,1034960,6,194,201,395,0
6_6012826,fly-airplane_plane1_city8-2_city10-2,6012826,6,194,201,395,0
6_772816,fly-airplane_plane1_city8-2_city1-2,772816,6,194,201,395,0
6_5515751,unload-airplane_package1_plane1_city8-2,5515751,6,294,308,602,0
6_2519478,unload-airplane_package2_plane1_city8-2,2519478,6,230,281,511,0
6_7524182,unload-airplane_package3_plane1_city8-2,7524182,6,303,326,629,0
6_4527909,unload-airplane_package4_plane1_city8-2,4527909,6,303,326,629,0
6_1531636,unload-airplane_package5_plane1_city8-2,1531636,6,294,308,602,0
6_527886,load-airplane_package1_plane1_city8-2,527886,6,294,308,602,0
6_2536317,load-airplane_package3_plane1_city8-2,2536317,6,303,326,629,0
6_7541021,load-airplane_package4_plane1_city8-2,7541021,6,303,326,629,0
6_4544748,load-airplane_package5_plane1_city8-2,4544748,6,294,308,602,0
6_4162452,at_plane1_city1-2,4162452,6,27,9,36,0
6_1627007,noop_airport_city4-2,1627007,6,1,1,2,0
6_4992707,fly-airplane_plane1_city4-2_city7-2,4992707,6,194,201,395,0
6_4730563,fly-airplane_plane1_city4-2_city3-2,4730563,6,194,201,395,0
6_4927171,fly-airplane_plane1_city4-2_city6-2,4927171,6,194,201,395,0
6_4665027,fly-airplane_plane1_city4-2_city2-2,4665027,6,194,201,395,0
6_5123779,fly-airplane_plane1_city4-2_city9-2,5123779,6,194,201,395,0
6_4861635,fly-airplane_plane1_city4-2_city5-2,4861635,6,194,201,395,0
6_1521455,fly-airplane_plane1_city4-2_city10-2,1521455,6,194,201,395,0
6_4599491,fly-airplane_plane1_city4-2_city1-2,4599491,6,194,201,395,0
6_5058243,fly-airplane_plane1_city4-2_city8-2,5058243,6,194,201,395,0
6_3926337,fly-airplane_plane1_city7-2_city4-2,3926337,6,194,201,395,0
6_7753012,fly-airplane_plane1_city3-2_city4-2,7753012,6,194,201,395,0
6_6883250,fly-airplane_plane1_city6-2_city4-2,6883250,6,194,201,395,0
6_2708948,fly-airplane_plane1_city2-2_city4-2,2708948,6,194,201,395,0
6_6013488,fly-airplane_plane1_city9-2_city4-2,6013488,6,194,201,395,0
6_1839186,fly-airplane_plane1_city5-2_city4-2,1839186,6,194,201,395,0
6_3720295,fly-airplane_plane1_city10-2_city4-2,3720295,6,194,201,395,0
6_6040611,fly-airplane_plane2_city4-2_city7-2,6040611,6,194,201,395,0
6_5778467,fly-airplane_plane2_city4-2_city3-2,5778467,6,194,201,395,0
6_5975075,fly-airplane_plane2_city4-2_city6-2,5975075,6,194,201,395,0
6_5712931,fly-airplane_plane2_city4-2_city2-2,5712931,6,194,201,395,0
6_6171683,fly-airplane_plane2_city4-2_city9-2,6171683,6,194,201,395,0
6_5909539,fly-airplane_plane2_city4-2_city5-2,5909539,6,194,201,395,0
6_5752638,fly-airplane_plane2_city4-2_city10-2,5752638,6,194,201,395,0
6_5647395,fly-airplane_plane2_city4-2_city1-2,5647395,6,194,201,395,0
6_6106147,fly-airplane_plane2_city4-2_city8-2,6106147,6,194,201,395,0
6_4974241,fly-airplane_plane2_city7-2_city4-2,4974241,6,194,201,395,0
6_799939,fly-airplane_plane2_city3-2_city4-2,799939,6,194,201,395,0
6_7931154,fly-airplane_plane2_city6-2_city4-2,7931154,6,194,201,395,0
6_3756852,fly-airplane_plane2_city2-2_city4-2,3756852,6,194,201,395,0
6_7061392,fly-airplane_plane2_city9-2_city4-2,7061392,6,194,201,395,0
6_2887090,fly-airplane_plane2_city5-2_city4-2,2887090,6,194,201,395,0
6_7951478,fly-airplane_plane2_city10-2_city4-2,7951478,6,194,201,395,0
6_6713765,fly-airplane_plane2_city1-2_city4-2,6713765,6,194,201,395,0
6_2017328,fly-airplane_plane2_city8-2_city4-2,2017328,6,194,201,395,0
6_7088515,fly-airplane_plane3_city4-2_city7-2,7088515,6,194,201,395,0
6_6826371,fly-airplane_plane3_city4-2_city3-2,6826371,6,194,201,395,0
6_7022979,fly-airplane_plane3_city4-2_city6-2,7022979,6,194,201,395,0
6_6760835,fly-airplane_plane3_city4-2_city2-2,6760835,6,194,201,395,0
6_7219587,fly-airplane_plane3_city4-2_city9-2,7219587,6,194,201,395,0
6_6957443,fly-airplane_plane3_city4-2_city5-2,6957443,6,194,201,395,0
6_1982844,fly-airplane_plane3_city4-2_city10-2,1982844,6,194,201,395,0
6_6695299,fly-airplane_plane3_city4-2_city1-2,6695299,6,194,201,395,0
6_7154051,fly-airplane_plane3_city4-2_city8-2,7154051,6,194,201,395,0
6_6022145,fly-airplane_plane3_city7-2_city4-2,6022145,6,194,201,395,0
6_1847843,fly-airplane_plane3_city3-2_city4-2,1847843,6,194,201,395,0
6_978081,fly-airplane_plane3_city6-2_city4-2,978081,6,194,201,395,0
6_4804756,fly-airplane_plane3_city2-2_city4-2,4804756,6,194,201,395,0
6_108319,fly-airplane_plane3_city9-2_city4-2,108319,6,194,201,395,0
6_3934994,fly-airplane_plane3_city5-2_city4-2,3934994,6,194,201,395,0
6_7761669,fly-airplane_plane3_city1-2_city4-2,7761669,6,194,201,395,0
6_3065232,fly-airplane_plane3_city8-2_city4-2,3065232,6,194,201,395,0
6_135442,fly-airplane_plane4_city4-2_city7-2,135442,6,194,201,395,0
6_7874275,fly-airplane_plane4_city4-2_city3-2,7874275,6,194,201,395,0
6_69906,fly-airplane_plane4_city4-2_city6-2,69906,6,194,201,395,0
6_7808739,fly-airplane_plane4_city4-2_city2-2,7808739,6,194,201,395,0
6_266514,fly-airplane_plane4_city4-2_city9-2,266514,6,194,201,395,0
6_4370,fly-airplane_plane4_city4-2_city5-2,4370,6,194,201,395,0
6_6214027,fly-airplane_plane4_city4-2_city10-2,6214027,6,194,201,395,0
6_7743203,fly-airplane_plane4_city4-2_city1-2,7743203,6,194,201,395,0
6_200978,fly-airplane_plane4_city4-2_city8-2,200978,6,194,201,395,0
6_7070049,fly-airplane_plane4_city7-2_city4-2,7070049,6,194,201,395,0
6_2895747,fly-airplane_plane4_city3-2_city4-2,2895747,6,194,201,395,0
6_2025985,fly-airplane_plane4_city6-2_city4-2,2025985,6,194,201,395,0
6_4982898,fly-airplane_plane4_city5-2_city4-2,4982898,6,194,201,395,0
6_411890,fly-airplane_plane4_city10-2_city4-2,411890,6,194,201,395,0
6_808596,fly-airplane_plane4_city1-2_city4-2,808596,6,194,201,395,0
6_4113136,fly-airplane_plane4_city8-2_city4-2,4113136,6,194,201,395,0
6_3507679,noop_at_truck9_city9-1,3507679,6,14,13,27,0
6_4349842,unload-truck_package3_truck9_city9-1,4349842,6,151,165,316,0
6_1353569,unload-truck_package4_truck9_city9-1,1353569,6,151,165,316,0
6_3868831,in_package5_truck9,3868831,6,27,28,55,0
6_6461255,at_truck9_city9-2,6461255,6,3,4,7,0
6_1731338,noop_at_package5_city1-1,1731338,6,135,136,271,0
6_4934765,load-truck_package5_truck1_city1-1,4934765,6,145,147,292,0
6_5040032,in_package4_truck1,5040032,6,28,35,63,0
6_44730,at_package5_city8-2,44730,6,34,29,63,0
6_3868830,in_package5_truck8,3868830,6,27,27,54,0
6_3868829,in_package5_truck7,3868829,6,28,27,55,0
6_3868828,in_package5_truck6,3868828,6,27,28,55,0
6_7718027,at_package5_city3-2,7718027,6,34,29,63,0
6_3868827,in_package5_truck5,3868827,6,27,28,55,0
6_3868826,in_package5_truck4,3868826,6,27,28,55,0
6_3868825,in_package5_truck3,3868825,6,28,27,55,0
6_6219424,at_package5_city10-2,6219424,6,34,29,63,0
6_3868824,in_package5_truck2,3868824,6,28,27,55,0
6_3868823,in_package5_truck1,3868823,6,28,26,54,0
6_7980171,at_package5_city7-2,7980171,6,34,29,63,0
6_110266,at_package5_city9-2,110266,6,34,29,63,0
6_6298565,in_package5_truck10,6298565,6,27,27,54,0
6_7783563,at_package5_city4-2,7783563,6,34,29,63,0
6_962113,in_package5_plane4,962113,6,44,34,78,0
6_962112,in_package5_plane3,962112,6,44,34,78,0
6_962111,in_package5_plane2,962111,6,44,34,78,0
6_962110,in_package5_plane1,962110,6,44,34,78,0
6_7586955,at_package5_city1-2,7586955,6,34,28,62,0
6_7914635,at_package5_city6-2,7914635,6,34,29,63,0
6_7652491,at_package5_city2-2,7652491,6,34,29,63,0
6_7849099,at_package5_city5-2,7849099,6,34,29,63,0
6_5655766,noop_at_package4_city3-2,5655766,6,136,154,290,0
6_7213341,load-airplane_package4_plane1_city3-2,7213341,6,303,326,629,0
6_3419986,load-airplane_package4_plane2_city3-2,3419986,6,303,326,629,0
6_7627608,load-airplane_package4_plane3_city3-2,7627608,6,303,326,629,0
6_3834253,load-airplane_package4_plane4_city3-2,3834253,6,303,326,629,0
6_475401,load-truck_package4_truck3_city3-2,475401,6,145,162,307,0
6_3641477,at_package4_city5-2,3641477,6,34,38,72,0
6_2133322,in_package4_plane4,2133322,6,44,43,87,0
6_2133321,in_package4_plane3,2133321,6,44,43,87,0
6_3903621,at_package4_city9-2,3903621,6,34,38,72,0
6_2133320,in_package4_plane2,2133320,6,44,43,87,0
6_2133319,in_package4_plane1,2133319,6,44,43,87,0
6_3444869,at_package4_city2-2,3444869,6,34,38,72,0
6_3707013,at_package4_city6-2,3707013,6,34,38,72,0
6_1199110,at_package4_city10-2,1199110,6,34,38,72,0
6_3379333,at_package4_city1-2,3379333,6,34,38,72,0
6_5040033,in_package4_truck2,5040033,6,28,35,63,0
6_5040034,in_package4_truck3,5040034,6,28,35,63,0
6_5040035,in_package4_truck4,5040035,6,27,35,62,0
6_3838085,at_package4_city8-2,3838085,6,34,38,72,0
6_5040036,in_package4_truck5,5040036,6,27,35,62,0
6_5040037,in_package4_truck6,5040037,6,27,35,62,0
6_5040038,in_package4_truck7,5040038,6,28,35,63,0
6_5040039,in_package4_truck8,5040039,6,27,35,62,0
6_5040040,in_package4_truck9,5040040,6,27,35,62,0
6_3575941,at_package4_city4-2,3575941,6,34,38,72,0
6_2090943,in_package4_truck10,2090943,6,27,35,62,0
6_3772548,at_package4_city7-1,3772548,6,29,34,63,0
6_3772549,at_package4_city7-2,3772549,6,34,38,72,0
6_5613107,noop_at_plane2_city4-2,5613107,6,182,190,372,0
6_696777,at_plane2_city6-2,696777,6,27,28,55,0
6_500169,at_plane2_city3-2,500169,6,27,28,55,0
6_6673463,at_plane2_city10-2,6673463,6,27,27,54,0
6_762313,at_plane2_city7-2,762313,6,27,28,55,0
6_434633,at_plane2_city2-2,434633,6,27,28,55,0
6_893385,at_plane2_city9-2,893385,6,27,28,55,0
6_631241,at_plane2_city5-2,631241,6,27,28,55,0
6_369097,at_plane2_city1-2,369097,6,27,28,55,0
6_827849,at_plane2_city8-2,827849,6,27,28,55,0
6_1688680,noop_at_plane3_city2-2,1688680,6,182,190,372,0
6_5001364,fly-airplane_plane3_city2-2_city7-2,5001364,6,194,201,395,0
6_4739220,fly-airplane_plane3_city2-2_city3-2,4739220,6,194,201,395,0
6_4935828,fly-airplane_plane3_city2-2_city6-2,4935828,6,194,201,395,0
6_5132436,fly-airplane_plane3_city2-2_city9-2,5132436,6,194,201,395,0
6_4870292,fly-airplane_plane3_city2-2_city5-2,4870292,6,194,201,395,0
6_3737647,fly-airplane_plane3_city2-2_city10-2,3737647,6,194,201,395,0
6_4608148,fly-airplane_plane3_city2-2_city1-2,4608148,6,194,201,395,0
6_5066900,fly-airplane_plane3_city2-2_city8-2,5066900,6,194,201,395,0
6_5536802,unload-airplane_package1_plane3_city2-2,5536802,6,294,308,602,0
6_2540529,unload-airplane_package2_plane3_city2-2,2540529,6,230,281,511,0
6_7545233,unload-airplane_package3_plane3_city2-2,7545233,6,303,326,629,0
6_4548960,unload-airplane_package4_plane3_city2-2,4548960,6,303,326,629,0
6_1552687,unload-airplane_package5_plane3_city2-2,1552687,6,294,308,602,0
6_548937,load-airplane_package1_plane3_city2-2,548937,6,294,308,602,0
6_2557368,load-airplane_package3_plane3_city2-2,2557368,6,303,326,629,0
6_7562072,load-airplane_package4_plane3_city2-2,7562072,6,303,326,629,0
6_4565799,load-airplane_package5_plane3_city2-2,4565799,6,294,308,602,0
6_3692800,at_plane3_city10-2,3692800,6,27,9,36,0
6_3507680,noop_at_truck9_city9-2,3507680,6,6,12,18,0
6_2341412,unload-truck_package1_truck9_city9-2,2341412,6,136,147,283,0
6_4349843,unload-truck_package3_truck9_city9-2,4349843,6,144,163,307,0
6_1353570,unload-truck_package4_truck9_city9-2,1353570,6,144,163,307,0
6_6358274,unload-truck_package5_truck9_city9-2,6358274,6,136,147,283,0
6_3099260,load-truck_package1_truck9_city9-2,3099260,6,136,147,283,0
6_5107691,load-truck_package3_truck9_city9-2,5107691,6,144,163,307,0
6_2111418,load-truck_package4_truck9_city9-2,2111418,6,144,163,307,0
6_7116122,load-truck_package5_truck9_city9-2,7116122,6,136,147,283,0
6_6461254,at_truck9_city9-1,6461254,6,5,1,6,0
6_1731339,noop_at_package5_city1-2,1731339,6,127,136,263,0
6_292641,load-airplane_package5_plane2_city1-2,292641,6,294,308,602,0
6_4500263,load-airplane_package5_plane3_city1-2,4500263,6,294,308,602,0
6_706908,load-airplane_package5_plane4_city1-2,706908,6,294,308,602,0
6_4934766,load-truck_package5_truck1_city1-2,4934766,6,136,147,283,0
6_7586954,at_package5_city1-1,7586954,6,29,3,32,0
6_2991081,noop_in-city_city3-1_city3,2991081,6,1,1,2,0
6_5371146,drive-truck_truck3_city3-1_city3-2_city3,5371146,6,23,20,43,0
6_2613681,drive-truck_truck3_city3-2_city3-1_city3,2613681,6,21,21,42,0
6_968340,noop_at_package1_city2-1,968340,6,135,136,271,0
6_5191061,load-truck_package1_truck2_city2-1,5191061,6,145,147,292,0
6_7086101,at_package1_city6-2,7086101,6,34,5,39,0
6_2147432,noop_at_plane3_city9-2,2147432,6,182,190,372,0
6_304927,fly-airplane_plane3_city9-2_city7-2,304927,6,194,201,395,0
6_42783,fly-airplane_plane3_city9-2_city3-2,42783,6,194,201,395,0
6_239391,fly-airplane_plane3_city9-2_city6-2,239391,6,194,201,395,0
6_7978224,fly-airplane_plane3_city9-2_city2-2,7978224,6,194,201,395,0
6_173855,fly-airplane_plane3_city9-2_city5-2,173855,6,194,201,395,0
6_1596325,fly-airplane_plane3_city9-2_city10-2,1596325,6,194,201,395,0
6_7912688,fly-airplane_plane3_city9-2_city1-2,7912688,6,194,201,395,0
6_370463,fly-airplane_plane3_city9-2_city8-2,370463,6,194,201,395,0
6_5995554,unload-airplane_package1_plane3_city9-2,5995554,6,294,308,602,0
6_2999281,unload-airplane_package2_plane3_city9-2,2999281,6,230,281,511,0
6_3008,unload-airplane_package3_plane3_city9-2,3008,6,303,326,629,0
6_5007712,unload-airplane_package4_plane3_city9-2,5007712,6,303,326,629,0
6_2011439,unload-airplane_package5_plane3_city9-2,2011439,6,294,308,602,0
6_1007689,load-airplane_package1_plane3_city9-2,1007689,6,294,308,602,0
6_3016120,load-airplane_package3_plane3_city9-2,3016120,6,303,326,629,0
6_19847,load-airplane_package4_plane3_city9-2,19847,6,303,326,629,0
6_5024551,load-airplane_package5_plane3_city9-2,5024551,6,294,308,602,0
6_6690159,noop_at_truck6_city6-1,6690159,6,14,13,27,0
6_1298643,drive-truck_truck6_city6-1_city6-2_city6,1298643,6,22,20,42,0
6_7532322,unload-truck_package3_truck6_city6-1,7532322,6,151,165,316,0
6_4536049,unload-truck_package4_truck6_city6-1,4536049,6,151,165,316,0
6_1642758,at_truck6_city6-2,1642758,6,3,4,7,0
6_968341,noop_at_package1_city2-2,968341,6,127,136,263,0
6_134670,load-airplane_package1_plane1_city2-2,134670,6,294,308,602,0
6_4342292,load-airplane_package1_plane2_city2-2,4342292,6,294,308,602,0
6_5191062,load-truck_package1_truck2_city2-2,5191062,6,136,147,283,0
6_6092910,noop_at_plane4_city5-2,6092910,6,182,190,372,0
6_5179506,fly-airplane_plane4_city5-2_city7-2,5179506,6,194,201,395,0
6_4917362,fly-airplane_plane4_city5-2_city3-2,4917362,6,194,201,395,0
6_5113970,fly-airplane_plane4_city5-2_city6-2,5113970,6,194,201,395,0
6_4851826,fly-airplane_plane4_city5-2_city2-2,4851826,6,194,201,395,0
6_5310578,fly-airplane_plane4_city5-2_city9-2,5310578,6,194,201,395,0
6_1336137,fly-airplane_plane4_city5-2_city10-2,1336137,6,194,201,395,0
6_4786290,fly-airplane_plane4_city5-2_city1-2,4786290,6,194,201,395,0
6_5245042,fly-airplane_plane4_city5-2_city8-2,5245042,6,194,201,395,0
6_1940055,unload-airplane_package1_plane4_city5-2,1940055,6,294,308,602,0
6_6944759,unload-airplane_package2_plane4_city5-2,6944759,6,230,281,511,0
6_3948486,unload-airplane_package3_plane4_city5-2,3948486,6,303,326,629,0
6_952213,unload-airplane_package4_plane4_city5-2,952213,6,303,326,629,0
6_5956917,unload-airplane_package5_plane4_city5-2,5956917,6,294,308,602,0
6_4953167,load-airplane_package1_plane4_city5-2,4953167,6,294,308,602,0
6_6961598,load-airplane_package3_plane4_city5-2,6961598,6,303,326,629,0
6_3965325,load-airplane_package4_plane4_city5-2,3965325,6,303,326,629,0
6_969052,load-airplane_package5_plane4_city5-2,969052,6,294,308,602,0
6_6690160,noop_at_truck6_city6-2,6690160,6,6,12,18,0
6_6542155,drive-truck_truck6_city6-2_city6-1_city6,6542155,6,20,22,42,0
6_5523892,unload-truck_package1_truck6_city6-2,5523892,6,136,147,283,0
6_7532323,unload-truck_package3_truck6_city6-2,7532323,6,144,163,307,0
6_4536050,unload-truck_package4_truck6_city6-2,4536050,6,144,163,307,0
6_1539777,unload-truck_package5_truck6_city6-2,1539777,6,136,147,283,0
6_289194,load-truck_package3_truck6_city6-2,289194,6,144,163,307,0
6_5293898,load-truck_package4_truck6_city6-2,5293898,6,144,163,307,0
6_2297625,load-truck_package5_truck6_city6-2,2297625,6,136,147,283,0
6_1642757,at_truck6_city6-1,1642757,6,5,1,6,0
6_3035792,noop_location_city7-1,3035792,6,1,1,2,0
6_7942119,drive-truck_truck7_city7-1_city7-2_city7,7942119,6,23,20,43,0
6_5184654,drive-truck_truck7_city7-2_city7-1_city7,5184654,6,21,21,42,0
6_3804503,unload-truck_package3_truck7_city7-1,3804503,6,153,165,318,0
6_808230,unload-truck_package4_truck7_city7-1,808230,6,151,165,316,0
6_1566078,load-truck_package4_truck7_city7-1,1566078,6,153,165,318,0
6_3035793,noop_location_city7-2,3035793,6,1,1,2,0
6_5450215,unload-airplane_package1_plane1_city7-2,5450215,6,294,308,602,0
6_1656860,unload-airplane_package1_plane2_city7-2,1656860,6,294,308,602,0
6_5864482,unload-airplane_package1_plane3_city7-2,5864482,6,294,308,602,0
6_2071127,unload-airplane_package1_plane4_city7-2,2071127,6,294,308,602,0
6_2453942,unload-airplane_package2_plane1_city7-2,2453942,6,230,281,511,0
6_6661564,unload-airplane_package2_plane2_city7-2,6661564,6,230,281,511,0
6_2868209,unload-airplane_package2_plane3_city7-2,2868209,6,230,281,511,0
6_7075831,unload-airplane_package2_plane4_city7-2,7075831,6,230,281,511,0
6_7458646,unload-airplane_package3_plane1_city7-2,7458646,6,303,326,629,0
6_3665291,unload-airplane_package3_plane2_city7-2,3665291,6,303,326,629,0
6_7872913,unload-airplane_package3_plane3_city7-2,7872913,6,303,326,629,0
6_4079558,unload-airplane_package3_plane4_city7-2,4079558,6,303,326,629,0
6_4462373,unload-airplane_package4_plane1_city7-2,4462373,6,303,326,629,0
6_669018,unload-airplane_package4_plane2_city7-2,669018,6,303,326,629,0
6_4876640,unload-airplane_package4_plane3_city7-2,4876640,6,303,326,629,0
6_1083285,unload-airplane_package4_plane4_city7-2,1083285,6,303,326,629,0
6_1466100,unload-airplane_package5_plane1_city7-2,1466100,6,294,308,602,0
6_5673722,unload-airplane_package5_plane2_city7-2,5673722,6,294,308,602,0
6_1880367,unload-airplane_package5_plane3_city7-2,1880367,6,294,308,602,0
6_6087989,unload-airplane_package5_plane4_city7-2,6087989,6,294,308,602,0
6_1796073,unload-truck_package1_truck7_city7-2,1796073,6,138,146,284,0
6_3804504,unload-truck_package3_truck7_city7-2,3804504,6,146,162,308,0
6_808231,unload-truck_package4_truck7_city7-2,808231,6,144,163,307,0
6_5812935,unload-truck_package5_truck7_city7-2,5812935,6,138,146,284,0
6_462350,load-airplane_package1_plane1_city7-2,462350,6,294,308,602,0
6_4669972,load-airplane_package1_plane2_city7-2,4669972,6,294,308,602,0
6_876617,load-airplane_package1_plane3_city7-2,876617,6,294,308,602,0
6_5084239,load-airplane_package1_plane4_city7-2,5084239,6,294,308,602,0
6_7475485,load-airplane_package4_plane1_city7-2,7475485,6,303,326,629,0
6_3682130,load-airplane_package4_plane2_city7-2,3682130,6,303,326,629,0
6_7889752,load-airplane_package4_plane3_city7-2,7889752,6,303,326,629,0
6_4096397,load-airplane_package4_plane4_city7-2,4096397,6,303,326,629,0
6_4479212,load-airplane_package5_plane1_city7-2,4479212,6,294,308,602,0
6_685857,load-airplane_package5_plane2_city7-2,685857,6,294,308,602,0
6_4893479,load-airplane_package5_plane3_city7-2,4893479,6,294,308,602,0
6_1100124,load-airplane_package5_plane4_city7-2,1100124,6,294,308,602,0
6_2553921,load-truck_package1_truck7_city7-2,2553921,6,137,146,283,0
6_1566079,load-truck_package4_truck7_city7-2,1566079,6,144,163,307,0
6_6570783,load-truck_package5_truck7_city7-2,6570783,6,137,146,283,0
6_1448143,noop_at_package3_city3-1,1448143,6,143,154,297,0
6_3471673,load-truck_package3_truck3_city3-1,3471673,6,153,165,318,0
6_7565904,at_package3_city7-2,7565904,6,34,37,71,0
6_1427093,noop_at_package1_city9-2,1427093,6,127,136,263,0
6_593422,load-airplane_package1_plane1_city9-2,593422,6,294,308,602,0
6_4801044,load-airplane_package1_plane2_city9-2,4801044,6,294,308,602,0
6_6345090,noop_at_package4_city10-2,6345090,6,136,154,290,0
6_5035440,load-airplane_package4_plane1_city10-2,5035440,6,302,326,628,0
6_2054777,load-airplane_package4_plane2_city10-2,2054777,6,302,326,628,0
6_4094428,load-airplane_package4_plane4_city10-2,4094428,6,302,326,628,0
6_7866348,load-truck_package4_truck10_city10-2,7866348,6,146,165,311,0
6_3510405,at_package4_city3-2,3510405,6,34,37,71,0
6_1405485,noop_at_plane1_city4-2,1405485,6,182,190,372,0
6_5018863,noop_airplane_plane1,5018863,6,1,1,2,0
6_3860801,fly-airplane_plane1_city7-2_city3-2,3860801,6,194,201,395,0
6_4057409,fly-airplane_plane1_city7-2_city6-2,4057409,6,194,201,395,0
6_3795265,fly-airplane_plane1_city7-2_city2-2,3795265,6,194,201,395,0
6_4254017,fly-airplane_plane1_city7-2_city9-2,4254017,6,194,201,395,0
6_3991873,fly-airplane_plane1_city7-2_city5-2,3991873,6,194,201,395,0
6_2889739,fly-airplane_plane1_city7-2_city10-2,2889739,6,194,201,395,0
6_3729729,fly-airplane_plane1_city7-2_city1-2,3729729,6,194,201,395,0
6_4188481,fly-airplane_plane1_city7-2_city8-2,4188481,6,194,201,395,0
6_7949620,fly-airplane_plane1_city3-2_city7-2,7949620,6,194,201,395,0
6_7884084,fly-airplane_plane1_city3-2_city6-2,7884084,6,194,201,395,0
6_7621940,fly-airplane_plane1_city3-2_city2-2,7621940,6,194,201,395,0
6_79715,fly-airplane_plane1_city3-2_city9-2,79715,6,194,201,395,0
6_7818548,fly-airplane_plane1_city3-2_city5-2,7818548,6,194,201,395,0
6_6399345,fly-airplane_plane1_city3-2_city10-2,6399345,6,194,201,395,0
6_7556404,fly-airplane_plane1_city3-2_city1-2,7556404,6,194,201,395,0
6_14179,fly-airplane_plane1_city3-2_city8-2,14179,6,194,201,395,0
6_7079858,fly-airplane_plane1_city6-2_city7-2,7079858,6,194,201,395,0
6_6817714,fly-airplane_plane1_city6-2_city3-2,6817714,6,194,201,395,0
6_6752178,fly-airplane_plane1_city6-2_city2-2,6752178,6,194,201,395,0
6_7210930,fly-airplane_plane1_city6-2_city9-2,7210930,6,194,201,395,0
6_6948786,fly-airplane_plane1_city6-2_city5-2,6948786,6,194,201,395,0
6_7767629,fly-airplane_plane1_city6-2_city10-2,7767629,6,194,201,395,0
6_6686642,fly-airplane_plane1_city6-2_city1-2,6686642,6,194,201,395,0
6_7145394,fly-airplane_plane1_city6-2_city8-2,7145394,6,194,201,395,0
6_2905556,fly-airplane_plane1_city2-2_city7-2,2905556,6,194,201,395,0
6_2643412,fly-airplane_plane1_city2-2_city3-2,2643412,6,194,201,395,0
6_2840020,fly-airplane_plane1_city2-2_city6-2,2840020,6,194,201,395,0
6_3036628,fly-airplane_plane1_city2-2_city9-2,3036628,6,194,201,395,0
6_2774484,fly-airplane_plane1_city2-2_city5-2,2774484,6,194,201,395,0
6_3276258,fly-airplane_plane1_city2-2_city10-2,3276258,6,194,201,395,0
6_2512340,fly-airplane_plane1_city2-2_city1-2,2512340,6,194,201,395,0
6_2971092,fly-airplane_plane1_city2-2_city8-2,2971092,6,194,201,395,0
6_6210096,fly-airplane_plane1_city9-2_city7-2,6210096,6,194,201,395,0
6_5947952,fly-airplane_plane1_city9-2_city3-2,5947952,6,194,201,395,0
6_6144560,fly-airplane_plane1_city9-2_city6-2,6144560,6,194,201,395,0
6_5882416,fly-airplane_plane1_city9-2_city2-2,5882416,6,194,201,395,0
6_6079024,fly-airplane_plane1_city9-2_city5-2,6079024,6,194,201,395,0
6_1134936,fly-airplane_plane1_city9-2_city10-2,1134936,6,194,201,395,0
6_5816880,fly-airplane_plane1_city9-2_city1-2,5816880,6,194,201,395,0
6_6275632,fly-airplane_plane1_city9-2_city8-2,6275632,6,194,201,395,0
6_2035794,fly-airplane_plane1_city5-2_city7-2,2035794,6,194,201,395,0
6_1773650,fly-airplane_plane1_city5-2_city3-2,1773650,6,194,201,395,0
6_1970258,fly-airplane_plane1_city5-2_city6-2,1970258,6,194,201,395,0
6_1708114,fly-airplane_plane1_city5-2_city2-2,1708114,6,194,201,395,0
6_2166866,fly-airplane_plane1_city5-2_city9-2,2166866,6,194,201,395,0
6_4644542,fly-airplane_plane1_city5-2_city10-2,4644542,6,194,201,395,0
6_1642578,fly-airplane_plane1_city5-2_city1-2,1642578,6,194,201,395,0
6_2101330,fly-airplane_plane1_city5-2_city8-2,2101330,6,194,201,395,0
6_3916903,fly-airplane_plane1_city10-2_city7-2,3916903,6,194,201,395,0
6_3654759,fly-airplane_plane1_city10-2_city3-2,3654759,6,194,201,395,0
6_3851367,fly-airplane_plane1_city10-2_city6-2,3851367,6,194,201,395,0
6_3589223,fly-airplane_plane1_city10-2_city2-2,3589223,6,194,201,395,0
6_4047975,fly-airplane_plane1_city10-2_city9-2,4047975,6,194,201,395,0
6_3785831,fly-airplane_plane1_city10-2_city5-2,3785831,6,194,201,395,0
6_3523687,fly-airplane_plane1_city10-2_city1-2,3523687,6,194,201,395,0
6_3982439,fly-airplane_plane1_city10-2_city8-2,3982439,6,194,201,395,0
6_5188071,unload-airplane_package1_plane1_city3-2,5188071,6,294,308,602,0
6_5384679,unload-airplane_package1_plane1_city6-2,5384679,6,294,308,602,0
6_5122535,unload-airplane_package1_plane1_city2-2,5122535,6,294,308,602,0
6_5581287,unload-airplane_package1_plane1_city9-2,5581287,6,294,308,602,0
6_5319143,unload-airplane_package1_plane1_city5-2,5319143,6,294,308,602,0
6_6629825,unload-airplane_package1_plane1_city10-2,6629825,6,293,308,601,0
6_2191798,unload-airplane_package2_plane1_city3-2,2191798,6,230,281,511,0
6_2388406,unload-airplane_package2_plane1_city6-2,2388406,6,230,281,511,0
6_2126262,unload-airplane_package2_plane1_city2-2,2126262,6,230,281,511,0
6_2585014,unload-airplane_package2_plane1_city9-2,2585014,6,230,281,511,0
6_2322870,unload-airplane_package2_plane1_city5-2,2322870,6,230,281,511,0
6_7677729,unload-airplane_package2_plane1_city10-2,7677729,6,230,281,511,0
6_7196502,unload-airplane_package3_plane1_city3-2,7196502,6,303,326,629,0
6_7393110,unload-airplane_package3_plane1_city6-2,7393110,6,303,326,629,0
6_7130966,unload-airplane_package3_plane1_city2-2,7130966,6,303,326,629,0
6_7589718,unload-airplane_package3_plane1_city9-2,7589718,6,303,326,629,0
6_7327574,unload-airplane_package3_plane1_city5-2,7327574,6,303,326,629,0
6_724656,unload-airplane_package3_plane1_city10-2,724656,6,302,326,628,0
6_4200229,unload-airplane_package4_plane1_city3-2,4200229,6,303,326,629,0
6_4396837,unload-airplane_package4_plane1_city6-2,4396837,6,303,326,629,0
6_4134693,unload-airplane_package4_plane1_city2-2,4134693,6,303,326,629,0
6_4593445,unload-airplane_package4_plane1_city9-2,4593445,6,303,326,629,0
6_4331301,unload-airplane_package4_plane1_city5-2,4331301,6,303,326,629,0
6_1772560,unload-airplane_package4_plane1_city10-2,1772560,6,302,326,628,0
6_1203956,unload-airplane_package5_plane1_city3-2,1203956,6,294,308,602,0
6_1400564,unload-airplane_package5_plane1_city6-2,1400564,6,294,308,602,0
6_1138420,unload-airplane_package5_plane1_city2-2,1138420,6,294,308,602,0
6_1597172,unload-airplane_package5_plane1_city9-2,1597172,6,294,308,602,0
6_1335028,unload-airplane_package5_plane1_city5-2,1335028,6,294,308,602,0
6_2820464,unload-airplane_package5_plane1_city10-2,2820464,6,293,308,601,0
6_200206,load-airplane_package1_plane1_city3-2,200206,6,294,308,602,0
6_331278,load-airplane_package1_plane1_city5-2,331278,6,294,308,602,0
6_1891728,load-airplane_package1_plane1_city10-2,1891728,6,293,308,601,0
6_2939632,load-airplane_package2_plane1_city10-2,2939632,6,230,281,511,0
6_2208637,load-airplane_package3_plane1_city3-2,2208637,6,303,326,629,0
6_2405245,load-airplane_package3_plane1_city6-2,2405245,6,303,326,629,0
6_2143101,load-airplane_package3_plane1_city2-2,2143101,6,303,326,629,0
6_2601853,load-airplane_package3_plane1_city9-2,2601853,6,303,326,629,0
6_2339709,load-airplane_package3_plane1_city5-2,2339709,6,303,326,629,0
6_3987536,load-airplane_package3_plane1_city10-2,3987536,6,302,326,628,0
6_7409949,load-airplane_package4_plane1_city6-2,7409949,6,303,326,629,0
6_7147805,load-airplane_package4_plane1_city2-2,7147805,6,303,326,629,0
6_7606557,load-airplane_package4_plane1_city9-2,7606557,6,303,326,629,0
6_7344413,load-airplane_package4_plane1_city5-2,7344413,6,303,326,629,0
6_4217068,load-airplane_package5_plane1_city3-2,4217068,6,294,308,602,0
6_4413676,load-airplane_package5_plane1_city6-2,4413676,6,294,308,602,0
6_4151532,load-airplane_package5_plane1_city2-2,4151532,6,294,308,602,0
6_4610284,load-airplane_package5_plane1_city9-2,4610284,6,294,308,602,0
6_4348140,load-airplane_package5_plane1_city5-2,4348140,6,294,308,602,0
6_6083344,load-airplane_package5_plane1_city10-2,6083344,6,293,308,601,0
6_767485,noop_in-city_city3-2_city3,767485,6,1,1,2,0
6_1448144,noop_at_package3_city3-2,1448144,6,136,154,290,0
6_6416259,load-airplane_package3_plane2_city3-2,6416259,6,303,326,629,0
6_2622904,load-airplane_package3_plane3_city3-2,2622904,6,303,326,629,0
6_6830526,load-airplane_package3_plane4_city3-2,6830526,6,303,326,629,0
6_3471674,load-truck_package3_truck3_city3-2,3471674,6,144,163,307,0
6_4939725,noop_in_package5_plane1,4939725,6,127,136,263,0
6_1281200,noop_city_city10,1281200,6,1,1,2,0
6_5018864,noop_airplane_plane2,5018864,6,1,1,2,0
6_4908705,fly-airplane_plane2_city7-2_city3-2,4908705,6,194,201,395,0
6_5105313,fly-airplane_plane2_city7-2_city6-2,5105313,6,194,201,395,0
6_4843169,fly-airplane_plane2_city7-2_city2-2,4843169,6,194,201,395,0
6_5301921,fly-airplane_plane2_city7-2_city9-2,5301921,6,194,201,395,0
6_5039777,fly-airplane_plane2_city7-2_city5-2,5039777,6,194,201,395,0
6_7120922,fly-airplane_plane2_city7-2_city10-2,7120922,6,194,201,395,0
6_4777633,fly-airplane_plane2_city7-2_city1-2,4777633,6,194,201,395,0
6_5236385,fly-airplane_plane2_city7-2_city8-2,5236385,6,194,201,395,0
6_996547,fly-airplane_plane2_city3-2_city7-2,996547,6,194,201,395,0
6_931011,fly-airplane_plane2_city3-2_city6-2,931011,6,194,201,395,0
6_668867,fly-airplane_plane2_city3-2_city2-2,668867,6,194,201,395,0
6_1127619,fly-airplane_plane2_city3-2_city9-2,1127619,6,194,201,395,0
6_865475,fly-airplane_plane2_city3-2_city5-2,865475,6,194,201,395,0
6_2629551,fly-airplane_plane2_city3-2_city10-2,2629551,6,194,201,395,0
6_603331,fly-airplane_plane2_city3-2_city1-2,603331,6,194,201,395,0
6_1062083,fly-airplane_plane2_city3-2_city8-2,1062083,6,194,201,395,0
6_126785,fly-airplane_plane2_city6-2_city7-2,126785,6,194,201,395,0
6_7865618,fly-airplane_plane2_city6-2_city3-2,7865618,6,194,201,395,0
6_7800082,fly-airplane_plane2_city6-2_city2-2,7800082,6,194,201,395,0
6_257857,fly-airplane_plane2_city6-2_city9-2,257857,6,194,201,395,0
6_7996690,fly-airplane_plane2_city6-2_city5-2,7996690,6,194,201,395,0
6_3997835,fly-airplane_plane2_city6-2_city10-2,3997835,6,194,201,395,0
6_7734546,fly-airplane_plane2_city6-2_city1-2,7734546,6,194,201,395,0
6_192321,fly-airplane_plane2_city6-2_city8-2,192321,6,194,201,395,0
6_3953460,fly-airplane_plane2_city2-2_city7-2,3953460,6,194,201,395,0
6_3691316,fly-airplane_plane2_city2-2_city3-2,3691316,6,194,201,395,0
6_3887924,fly-airplane_plane2_city2-2_city6-2,3887924,6,194,201,395,0
6_4084532,fly-airplane_plane2_city2-2_city9-2,4084532,6,194,201,395,0
6_3822388,fly-airplane_plane2_city2-2_city5-2,3822388,6,194,201,395,0
6_7507441,fly-airplane_plane2_city2-2_city10-2,7507441,6,194,201,395,0
6_3560244,fly-airplane_plane2_city2-2_city1-2,3560244,6,194,201,395,0
6_4018996,fly-airplane_plane2_city2-2_city8-2,4018996,6,194,201,395,0
6_7258000,fly-airplane_plane2_city9-2_city7-2,7258000,6,194,201,395,0
6_6995856,fly-airplane_plane2_city9-2_city3-2,6995856,6,194,201,395,0
6_7192464,fly-airplane_plane2_city9-2_city6-2,7192464,6,194,201,395,0
6_6930320,fly-airplane_plane2_city9-2_city2-2,6930320,6,194,201,395,0
6_7126928,fly-airplane_plane2_city9-2_city5-2,7126928,6,194,201,395,0
6_5366119,fly-airplane_plane2_city9-2_city10-2,5366119,6,194,201,395,0
6_6864784,fly-airplane_plane2_city9-2_city1-2,6864784,6,194,201,395,0
6_7323536,fly-airplane_plane2_city9-2_city8-2,7323536,6,194,201,395,0
6_3083698,fly-airplane_plane2_city5-2_city7-2,3083698,6,194,201,395,0
6_2821554,fly-airplane_plane2_city5-2_city3-2,2821554,6,194,201,395,0
6_3018162,fly-airplane_plane2_city5-2_city6-2,3018162,6,194,201,395,0
6_2756018,fly-airplane_plane2_city5-2_city2-2,2756018,6,194,201,395,0
6_3214770,fly-airplane_plane2_city5-2_city9-2,3214770,6,194,201,395,0
6_874748,fly-airplane_plane2_city5-2_city10-2,874748,6,194,201,395,0
6_2690482,fly-airplane_plane2_city5-2_city1-2,2690482,6,194,201,395,0
6_3149234,fly-airplane_plane2_city5-2_city8-2,3149234,6,194,201,395,0
6_147109,fly-airplane_plane2_city10-2_city7-2,147109,6,194,201,395,0
6_7885942,fly-airplane_plane2_city10-2_city3-2,7885942,6,194,201,395,0
6_81573,fly-airplane_plane2_city10-2_city6-2,81573,6,194,201,395,0
6_7820406,fly-airplane_plane2_city10-2_city2-2,7820406,6,194,201,395,0
6_278181,fly-airplane_plane2_city10-2_city9-2,278181,6,194,201,395,0
6_16037,fly-airplane_plane2_city10-2_city5-2,16037,6,194,201,395,0
6_7754870,fly-airplane_plane2_city10-2_city1-2,7754870,6,194,201,395,0
6_212645,fly-airplane_plane2_city10-2_city8-2,212645,6,194,201,395,0
6_6910373,fly-airplane_plane2_city1-2_city7-2,6910373,6,194,201,395,0
6_6648229,fly-airplane_plane2_city1-2_city3-2,6648229,6,194,201,395,0
6_6844837,fly-airplane_plane2_city1-2_city6-2,6844837,6,194,201,395,0
6_6582693,fly-airplane_plane2_city1-2_city2-2,6582693,6,194,201,395,0
6_7041445,fly-airplane_plane2_city1-2_city9-2,7041445,6,194,201,395,0
6_6779301,fly-airplane_plane2_city1-2_city5-2,6779301,6,194,201,395,0
6_4384354,fly-airplane_plane2_city1-2_city10-2,4384354,6,194,201,395,0
6_6975909,fly-airplane_plane2_city1-2_city8-2,6975909,6,194,201,395,0
6_2213936,fly-airplane_plane2_city8-2_city7-2,2213936,6,194,201,395,0
6_1951792,fly-airplane_plane2_city8-2_city3-2,1951792,6,194,201,395,0
6_2148400,fly-airplane_plane2_city8-2_city6-2,2148400,6,194,201,395,0
6_1886256,fly-airplane_plane2_city8-2_city2-2,1886256,6,194,201,395,0
6_2345008,fly-airplane_plane2_city8-2_city9-2,2345008,6,194,201,395,0
6_2082864,fly-airplane_plane2_city8-2_city5-2,2082864,6,194,201,395,0
6_2243032,fly-airplane_plane2_city8-2_city10-2,2243032,6,194,201,395,0
6_1820720,fly-airplane_plane2_city8-2_city1-2,1820720,6,194,201,395,0
6_1394716,unload-airplane_package1_plane2_city3-2,1394716,6,294,308,602,0
6_1591324,unload-airplane_package1_plane2_city6-2,1591324,6,294,308,602,0
6_1329180,unload-airplane_package1_plane2_city2-2,1329180,6,294,308,602,0
6_1787932,unload-airplane_package1_plane2_city9-2,1787932,6,294,308,602,0
6_1525788,unload-airplane_package1_plane2_city5-2,1525788,6,294,308,602,0
6_1263644,unload-airplane_package1_plane2_city1-2,1263644,6,294,308,602,0
6_1722396,unload-airplane_package1_plane2_city8-2,1722396,6,294,308,602,0
6_3649162,unload-airplane_package1_plane2_city10-2,3649162,6,293,308,601,0
6_6399420,unload-airplane_package2_plane2_city3-2,6399420,6,230,281,511,0
6_6596028,unload-airplane_package2_plane2_city6-2,6596028,6,230,281,511,0
6_6333884,unload-airplane_package2_plane2_city2-2,6333884,6,230,281,511,0
6_6792636,unload-airplane_package2_plane2_city9-2,6792636,6,230,281,511,0
6_6530492,unload-airplane_package2_plane2_city5-2,6530492,6,230,281,511,0
6_6268348,unload-airplane_package2_plane2_city1-2,6268348,6,230,281,511,0
6_6727100,unload-airplane_package2_plane2_city8-2,6727100,6,230,281,511,0
6_4697066,unload-airplane_package2_plane2_city10-2,4697066,6,230,281,511,0
6_3403147,unload-airplane_package3_plane2_city3-2,3403147,6,303,326,629,0
6_3599755,unload-airplane_package3_plane2_city6-2,3599755,6,303,326,629,0
6_3337611,unload-airplane_package3_plane2_city2-2,3337611,6,303,326,629,0
6_3796363,unload-airplane_package3_plane2_city9-2,3796363,6,303,326,629,0
6_3534219,unload-airplane_package3_plane2_city5-2,3534219,6,303,326,629,0
6_3272075,unload-airplane_package3_plane2_city1-2,3272075,6,303,326,629,0
6_3730827,unload-airplane_package3_plane2_city8-2,3730827,6,303,326,629,0
6_5744970,unload-airplane_package3_plane2_city10-2,5744970,6,302,326,628,0
6_406874,unload-airplane_package4_plane2_city3-2,406874,6,303,326,629,0
6_603482,unload-airplane_package4_plane2_city6-2,603482,6,303,326,629,0
6_341338,unload-airplane_package4_plane2_city2-2,341338,6,303,326,629,0
6_800090,unload-airplane_package4_plane2_city9-2,800090,6,303,326,629,0
6_537946,unload-airplane_package4_plane2_city5-2,537946,6,303,326,629,0
6_275802,unload-airplane_package4_plane2_city1-2,275802,6,303,326,629,0
6_734554,unload-airplane_package4_plane2_city8-2,734554,6,303,326,629,0
6_6792874,unload-airplane_package4_plane2_city10-2,6792874,6,302,326,628,0
6_5411578,unload-airplane_package5_plane2_city3-2,5411578,6,294,308,602,0
6_5608186,unload-airplane_package5_plane2_city6-2,5608186,6,294,308,602,0
6_5346042,unload-airplane_package5_plane2_city2-2,5346042,6,294,308,602,0
6_5804794,unload-airplane_package5_plane2_city9-2,5804794,6,294,308,602,0
6_5542650,unload-airplane_package5_plane2_city5-2,5542650,6,294,308,602,0
6_5280506,unload-airplane_package5_plane2_city1-2,5280506,6,294,308,602,0
6_5739258,unload-airplane_package5_plane2_city8-2,5739258,6,294,308,602,0
6_7840778,unload-airplane_package5_plane2_city10-2,7840778,6,293,308,601,0
6_4407828,load-airplane_package1_plane2_city3-2,4407828,6,294,308,602,0
6_4538900,load-airplane_package1_plane2_city5-2,4538900,6,294,308,602,0
6_4276756,load-airplane_package1_plane2_city1-2,4276756,6,294,308,602,0
6_4735508,load-airplane_package1_plane2_city8-2,4735508,6,294,308,602,0
6_6912042,load-airplane_package1_plane2_city10-2,6912042,6,293,308,601,0
6_7959946,load-airplane_package2_plane2_city10-2,7959946,6,230,281,511,0
6_6612867,load-airplane_package3_plane2_city6-2,6612867,6,303,326,629,0
6_6350723,load-airplane_package3_plane2_city2-2,6350723,6,303,326,629,0
6_6809475,load-airplane_package3_plane2_city9-2,6809475,6,303,326,629,0
6_6547331,load-airplane_package3_plane2_city5-2,6547331,6,303,326,629,0
6_6285187,load-airplane_package3_plane2_city1-2,6285187,6,303,326,629,0
6_6743939,load-airplane_package3_plane2_city8-2,6743939,6,303,326,629,0
6_1006873,load-airplane_package3_plane2_city10-2,1006873,6,302,326,628,0
6_3616594,load-airplane_package4_plane2_city6-2,3616594,6,303,326,629,0
6_3354450,load-airplane_package4_plane2_city2-2,3354450,6,303,326,629,0
6_3813202,load-airplane_package4_plane2_city9-2,3813202,6,303,326,629,0
6_3551058,load-airplane_package4_plane2_city5-2,3551058,6,303,326,629,0
6_3288914,load-airplane_package4_plane2_city1-2,3288914,6,303,326,629,0
6_3747666,load-airplane_package4_plane2_city8-2,3747666,6,303,326,629,0
6_423713,load-airplane_package5_plane2_city3-2,423713,6,294,308,602,0
6_620321,load-airplane_package5_plane2_city6-2,620321,6,294,308,602,0
6_358177,load-airplane_package5_plane2_city2-2,358177,6,294,308,602,0
6_816929,load-airplane_package5_plane2_city9-2,816929,6,294,308,602,0
6_554785,load-airplane_package5_plane2_city5-2,554785,6,294,308,602,0
6_751393,load-airplane_package5_plane2_city8-2,751393,6,294,308,602,0
6_3102681,load-airplane_package5_plane2_city10-2,3102681,6,293,308,601,0
6_4939726,noop_in_package5_plane2,4939726,6,127,136,263,0
6_5018865,noop_airplane_plane3,5018865,6,1,1,2,0
6_5956609,fly-airplane_plane3_city7-2_city3-2,5956609,6,194,201,395,0
6_6153217,fly-airplane_plane3_city7-2_city6-2,6153217,6,194,201,395,0
6_5891073,fly-airplane_plane3_city7-2_city2-2,5891073,6,194,201,395,0
6_6349825,fly-airplane_plane3_city7-2_city9-2,6349825,6,194,201,395,0
6_6087681,fly-airplane_plane3_city7-2_city5-2,6087681,6,194,201,395,0
6_3351128,fly-airplane_plane3_city7-2_city10-2,3351128,6,194,201,395,0
6_5825537,fly-airplane_plane3_city7-2_city1-2,5825537,6,194,201,395,0
6_6284289,fly-airplane_plane3_city7-2_city8-2,6284289,6,194,201,395,0
6_2044451,fly-airplane_plane3_city3-2_city7-2,2044451,6,194,201,395,0
6_1978915,fly-airplane_plane3_city3-2_city6-2,1978915,6,194,201,395,0
6_1716771,fly-airplane_plane3_city3-2_city2-2,1716771,6,194,201,395,0
6_2175523,fly-airplane_plane3_city3-2_city9-2,2175523,6,194,201,395,0
6_1913379,fly-airplane_plane3_city3-2_city5-2,1913379,6,194,201,395,0
6_6860734,fly-airplane_plane3_city3-2_city10-2,6860734,6,194,201,395,0
6_1651235,fly-airplane_plane3_city3-2_city1-2,1651235,6,194,201,395,0
6_2109987,fly-airplane_plane3_city3-2_city8-2,2109987,6,194,201,395,0
6_1174689,fly-airplane_plane3_city6-2_city7-2,1174689,6,194,201,395,0
6_912545,fly-airplane_plane3_city6-2_city3-2,912545,6,194,201,395,0
6_847009,fly-airplane_plane3_city6-2_city2-2,847009,6,194,201,395,0
6_1305761,fly-airplane_plane3_city6-2_city9-2,1305761,6,194,201,395,0
6_1043617,fly-airplane_plane3_city6-2_city5-2,1043617,6,194,201,395,0
6_228041,fly-airplane_plane3_city6-2_city10-2,228041,6,194,201,395,0
6_781473,fly-airplane_plane3_city6-2_city1-2,781473,6,194,201,395,0
6_1240225,fly-airplane_plane3_city6-2_city8-2,1240225,6,194,201,395,0
6_4131602,fly-airplane_plane3_city5-2_city7-2,4131602,6,194,201,395,0
6_3869458,fly-airplane_plane3_city5-2_city3-2,3869458,6,194,201,395,0
6_4066066,fly-airplane_plane3_city5-2_city6-2,4066066,6,194,201,395,0
6_3803922,fly-airplane_plane3_city5-2_city2-2,3803922,6,194,201,395,0
6_4262674,fly-airplane_plane3_city5-2_city9-2,4262674,6,194,201,395,0
6_5105931,fly-airplane_plane3_city5-2_city10-2,5105931,6,194,201,395,0
6_3738386,fly-airplane_plane3_city5-2_city1-2,3738386,6,194,201,395,0
6_4197138,fly-airplane_plane3_city5-2_city8-2,4197138,6,194,201,395,0
6_7958277,fly-airplane_plane3_city1-2_city7-2,7958277,6,194,201,395,0
6_7696133,fly-airplane_plane3_city1-2_city3-2,7696133,6,194,201,395,0
6_7892741,fly-airplane_plane3_city1-2_city6-2,7892741,6,194,201,395,0
6_7630597,fly-airplane_plane3_city1-2_city2-2,7630597,6,194,201,395,0
6_88372,fly-airplane_plane3_city1-2_city9-2,88372,6,194,201,395,0
6_7827205,fly-airplane_plane3_city1-2_city5-2,7827205,6,194,201,395,0
6_614560,fly-airplane_plane3_city1-2_city10-2,614560,6,194,201,395,0
6_22836,fly-airplane_plane3_city1-2_city8-2,22836,6,194,201,395,0
6_3261840,fly-airplane_plane3_city8-2_city7-2,3261840,6,194,201,395,0
6_2999696,fly-airplane_plane3_city8-2_city3-2,2999696,6,194,201,395,0
6_3196304,fly-airplane_plane3_city8-2_city6-2,3196304,6,194,201,395,0
6_2934160,fly-airplane_plane3_city8-2_city2-2,2934160,6,194,201,395,0
6_3392912,fly-airplane_plane3_city8-2_city9-2,3392912,6,194,201,395,0
6_3130768,fly-airplane_plane3_city8-2_city5-2,3130768,6,194,201,395,0
6_6474215,fly-airplane_plane3_city8-2_city10-2,6474215,6,194,201,395,0
6_2868624,fly-airplane_plane3_city8-2_city1-2,2868624,6,194,201,395,0
6_5602338,unload-airplane_package1_plane3_city3-2,5602338,6,294,308,602,0
6_5798946,unload-airplane_package1_plane3_city6-2,5798946,6,294,308,602,0
6_5733410,unload-airplane_package1_plane3_city5-2,5733410,6,294,308,602,0
6_5471266,unload-airplane_package1_plane3_city1-2,5471266,6,294,308,602,0
6_5930018,unload-airplane_package1_plane3_city8-2,5930018,6,294,308,602,0
6_2606065,unload-airplane_package2_plane3_city3-2,2606065,6,230,281,511,0
6_2802673,unload-airplane_package2_plane3_city6-2,2802673,6,230,281,511,0
6_2737137,unload-airplane_package2_plane3_city5-2,2737137,6,230,281,511,0
6_2474993,unload-airplane_package2_plane3_city1-2,2474993,6,230,281,511,0
6_2933745,unload-airplane_package2_plane3_city8-2,2933745,6,230,281,511,0
6_7610769,unload-airplane_package3_plane3_city3-2,7610769,6,303,326,629,0
6_7807377,unload-airplane_package3_plane3_city6-2,7807377,6,303,326,629,0
6_7741841,unload-airplane_package3_plane3_city5-2,7741841,6,303,326,629,0
6_7479697,unload-airplane_package3_plane3_city1-2,7479697,6,303,326,629,0
6_7938449,unload-airplane_package3_plane3_city8-2,7938449,6,303,326,629,0
6_4614496,unload-airplane_package4_plane3_city3-2,4614496,6,303,326,629,0
6_4811104,unload-airplane_package4_plane3_city6-2,4811104,6,303,326,629,0
6_4745568,unload-airplane_package4_plane3_city5-2,4745568,6,303,326,629,0
6_4483424,unload-airplane_package4_plane3_city1-2,4483424,6,303,326,629,0
6_4942176,unload-airplane_package4_plane3_city8-2,4942176,6,303,326,629,0
6_1618223,unload-airplane_package5_plane3_city3-2,1618223,6,294,308,602,0
6_1814831,unload-airplane_package5_plane3_city6-2,1814831,6,294,308,602,0
6_1749295,unload-airplane_package5_plane3_city5-2,1749295,6,294,308,602,0
6_1487151,unload-airplane_package5_plane3_city1-2,1487151,6,294,308,602,0
6_1945903,unload-airplane_package5_plane3_city8-2,1945903,6,294,308,602,0
6_614473,load-airplane_package1_plane3_city3-2,614473,6,294,308,602,0
6_745545,load-airplane_package1_plane3_city5-2,745545,6,294,308,602,0
6_483401,load-airplane_package1_plane3_city1-2,483401,6,294,308,602,0
6_942153,load-airplane_package1_plane3_city8-2,942153,6,294,308,602,0
6_2819512,load-airplane_package3_plane3_city6-2,2819512,6,303,326,629,0
6_2753976,load-airplane_package3_plane3_city5-2,2753976,6,303,326,629,0
6_2491832,load-airplane_package3_plane3_city1-2,2491832,6,303,326,629,0
6_2950584,load-airplane_package3_plane3_city8-2,2950584,6,303,326,629,0
6_7824216,load-airplane_package4_plane3_city6-2,7824216,6,303,326,629,0
6_7758680,load-airplane_package4_plane3_city5-2,7758680,6,303,326,629,0
6_7496536,load-airplane_package4_plane3_city1-2,7496536,6,303,326,629,0
6_7955288,load-airplane_package4_plane3_city8-2,7955288,6,303,326,629,0
6_4631335,load-airplane_package5_plane3_city3-2,4631335,6,294,308,602,0
6_4827943,load-airplane_package5_plane3_city6-2,4827943,6,294,308,602,0
6_4762407,load-airplane_package5_plane3_city5-2,4762407,6,294,308,602,0
6_4959015,load-airplane_package5_plane3_city8-2,4959015,6,294,308,602,0
6_1823615,noop_airport_city7-2,1823615,6,1,1,2,0
6_7004513,fly-airplane_plane4_city7-2_city3-2,7004513,6,194,201,395,0
6_7201121,fly-airplane_plane4_city7-2_city6-2,7201121,6,194,201,395,0
6_6938977,fly-airplane_plane4_city7-2_city2-2,6938977,6,194,201,395,0
6_7397729,fly-airplane_plane4_city7-2_city9-2,7397729,6,194,201,395,0
6_7135585,fly-airplane_plane4_city7-2_city5-2,7135585,6,194,201,395,0
6_7582311,fly-airplane_plane4_city7-2_city10-2,7582311,6,194,201,395,0
6_6873441,fly-airplane_plane4_city7-2_city1-2,6873441,6,194,201,395,0
6_7332193,fly-airplane_plane4_city7-2_city8-2,7332193,6,194,201,395,0
6_3092355,fly-airplane_plane4_city3-2_city7-2,3092355,6,194,201,395,0
6_2222593,fly-airplane_plane4_city6-2_city7-2,2222593,6,194,201,395,0
6_608498,fly-airplane_plane4_city10-2_city7-2,608498,6,194,201,395,0
6_1005204,fly-airplane_plane4_city1-2_city7-2,1005204,6,194,201,395,0
6_4309744,fly-airplane_plane4_city8-2_city7-2,4309744,6,194,201,395,0
6_4939727,noop_in_package5_plane3,4939727,6,127,136,263,0
6_5852374,noop_at_package4_city6-2,5852374,6,136,154,290,0
6_4030861,load-airplane_package4_plane4_city6-2,4030861,6,303,326,629,0
6_5809715,noop_at_plane2_city7-2,5809715,6,182,190,372,0
6_565705,at_plane2_city4-2,565705,6,27,19,46,0
6_2650101,noop_at_plane2_city10-2,2650101,6,181,190,371,0
6_1885288,noop_at_plane3_city5-2,1885288,6,182,190,372,0
6_5018866,noop_airplane_plane4,5018866,6,1,1,2,0
6_3026819,fly-airplane_plane4_city3-2_city6-2,3026819,6,194,201,395,0
6_2764675,fly-airplane_plane4_city3-2_city2-2,2764675,6,194,201,395,0
6_3223427,fly-airplane_plane4_city3-2_city9-2,3223427,6,194,201,395,0
6_2961283,fly-airplane_plane4_city3-2_city5-2,2961283,6,194,201,395,0
6_3090940,fly-airplane_plane4_city3-2_city10-2,3090940,6,194,201,395,0
6_2699139,fly-airplane_plane4_city3-2_city1-2,2699139,6,194,201,395,0
6_3157891,fly-airplane_plane4_city3-2_city8-2,3157891,6,194,201,395,0
6_1960449,fly-airplane_plane4_city6-2_city3-2,1960449,6,194,201,395,0
6_1894913,fly-airplane_plane4_city6-2_city2-2,1894913,6,194,201,395,0
6_2353665,fly-airplane_plane4_city6-2_city9-2,2353665,6,194,201,395,0
6_2091521,fly-airplane_plane4_city6-2_city5-2,2091521,6,194,201,395,0
6_4459224,fly-airplane_plane4_city6-2_city10-2,4459224,6,194,201,395,0
6_1829377,fly-airplane_plane4_city6-2_city1-2,1829377,6,194,201,395,0
6_2288129,fly-airplane_plane4_city6-2_city8-2,2288129,6,194,201,395,0
6_346354,fly-airplane_plane4_city10-2_city3-2,346354,6,194,201,395,0
6_542962,fly-airplane_plane4_city10-2_city6-2,542962,6,194,201,395,0
6_280818,fly-airplane_plane4_city10-2_city2-2,280818,6,194,201,395,0
6_739570,fly-airplane_plane4_city10-2_city9-2,739570,6,194,201,395,0
6_477426,fly-airplane_plane4_city10-2_city5-2,477426,6,194,201,395,0
6_215282,fly-airplane_plane4_city10-2_city1-2,215282,6,194,201,395,0
6_674034,fly-airplane_plane4_city10-2_city8-2,674034,6,194,201,395,0
6_743060,fly-airplane_plane4_city1-2_city3-2,743060,6,194,201,395,0
6_939668,fly-airplane_plane4_city1-2_city6-2,939668,6,194,201,395,0
6_677524,fly-airplane_plane4_city1-2_city2-2,677524,6,194,201,395,0
6_1136276,fly-airplane_plane4_city1-2_city9-2,1136276,6,194,201,395,0
6_874132,fly-airplane_plane4_city1-2_city5-2,874132,6,194,201,395,0
6_4845743,fly-airplane_plane4_city1-2_city10-2,4845743,6,194,201,395,0
6_1070740,fly-airplane_plane4_city1-2_city8-2,1070740,6,194,201,395,0
6_4047600,fly-airplane_plane4_city8-2_city3-2,4047600,6,194,201,395,0
6_4244208,fly-airplane_plane4_city8-2_city6-2,4244208,6,194,201,395,0
6_3982064,fly-airplane_plane4_city8-2_city2-2,3982064,6,194,201,395,0
6_4440816,fly-airplane_plane4_city8-2_city9-2,4440816,6,194,201,395,0
6_4178672,fly-airplane_plane4_city8-2_city5-2,4178672,6,194,201,395,0
6_2704421,fly-airplane_plane4_city8-2_city10-2,2704421,6,194,201,395,0
6_3916528,fly-airplane_plane4_city8-2_city1-2,3916528,6,194,201,395,0
6_1808983,unload-airplane_package1_plane4_city3-2,1808983,6,294,308,602,0
6_2005591,unload-airplane_package1_plane4_city6-2,2005591,6,294,308,602,0
6_1677911,unload-airplane_package1_plane4_city1-2,1677911,6,294,308,602,0
6_2136663,unload-airplane_package1_plane4_city8-2,2136663,6,294,308,602,0
6_5688813,unload-airplane_package1_plane4_city10-2,5688813,6,293,308,601,0
6_6813687,unload-airplane_package2_plane4_city3-2,6813687,6,230,281,511,0
6_7010295,unload-airplane_package2_plane4_city6-2,7010295,6,230,281,511,0
6_6682615,unload-airplane_package2_plane4_city1-2,6682615,6,230,281,511,0
6_7141367,unload-airplane_package2_plane4_city8-2,7141367,6,230,281,511,0
6_6736717,unload-airplane_package2_plane4_city10-2,6736717,6,230,281,511,0
6_3817414,unload-airplane_package3_plane4_city3-2,3817414,6,303,326,629,0
6_4014022,unload-airplane_package3_plane4_city6-2,4014022,6,303,326,629,0
6_3686342,unload-airplane_package3_plane4_city1-2,3686342,6,303,326,629,0
6_4145094,unload-airplane_package3_plane4_city8-2,4145094,6,303,326,629,0
6_7784621,unload-airplane_package3_plane4_city10-2,7784621,6,302,326,628,0
6_821141,unload-airplane_package4_plane4_city3-2,821141,6,303,326,629,0
6_1017749,unload-airplane_package4_plane4_city6-2,1017749,6,303,326,629,0
6_690069,unload-airplane_package4_plane4_city1-2,690069,6,303,326,629,0
6_1148821,unload-airplane_package4_plane4_city8-2,1148821,6,303,326,629,0
6_831548,unload-airplane_package4_plane4_city10-2,831548,6,302,326,628,0
6_5825845,unload-airplane_package5_plane4_city3-2,5825845,6,294,308,602,0
6_6022453,unload-airplane_package5_plane4_city6-2,6022453,6,294,308,602,0
6_5694773,unload-airplane_package5_plane4_city1-2,5694773,6,294,308,602,0
6_6153525,unload-airplane_package5_plane4_city8-2,6153525,6,294,308,602,0
6_1879452,unload-airplane_package5_plane4_city10-2,1879452,6,293,308,601,0
6_4822095,load-airplane_package1_plane4_city3-2,4822095,6,294,308,602,0
6_4691023,load-airplane_package1_plane4_city1-2,4691023,6,294,308,602,0
6_5149775,load-airplane_package1_plane4_city8-2,5149775,6,294,308,602,0
6_950716,load-airplane_package1_plane4_city10-2,950716,6,293,308,601,0
6_1998620,load-airplane_package2_plane4_city10-2,1998620,6,230,281,511,0
6_7027134,load-airplane_package3_plane4_city6-2,7027134,6,303,326,629,0
6_6699454,load-airplane_package3_plane4_city1-2,6699454,6,303,326,629,0
6_7158206,load-airplane_package3_plane4_city8-2,7158206,6,303,326,629,0
6_3046524,load-airplane_package3_plane4_city10-2,3046524,6,302,326,628,0
6_3703181,load-airplane_package4_plane4_city1-2,3703181,6,303,326,629,0
6_4161933,load-airplane_package4_plane4_city8-2,4161933,6,303,326,629,0
6_837980,load-airplane_package5_plane4_city3-2,837980,6,294,308,602,0
6_1034588,load-airplane_package5_plane4_city6-2,1034588,6,294,308,602,0
6_1165660,load-airplane_package5_plane4_city8-2,1165660,6,294,308,602,0
6_5142332,load-airplane_package5_plane4_city10-2,5142332,6,293,308,601,0
6_4233888,noop_in-city_city9-1_city9,4233888,6,1,1,2,0
6_4939728,noop_in_package5_plane4,4939728,6,127,136,263,0
6_1927947,noop_at_package5_city4-2,1927947,6,127,136,263,0
6_5830766,noop_at_plane4_city1-2,5830766,6,182,190,372,0
6_2773648,noop_location_city3-1,2773648,6,1,1,2,0
6_2713825,unload-truck_package3_truck3_city3-1,2713825,6,151,165,316,0
6_7718529,unload-truck_package4_truck3_city3-1,7718529,6,153,165,318,0
6_4560839,noop_in-city_city2-2_city2,4560839,6,1,1,2,0
6_6728647,drive-truck_truck2_city2-1_city2-2_city2,6728647,6,23,21,44,0
6_3971182,drive-truck_truck2_city2-2_city2-1_city2,3971182,6,22,23,45,0
6_442949,noop_in_package5_truck10,442949,6,133,140,273,0
6_7835242,unload-truck_package5_truck10_city10-2,7835242,6,138,149,287,0
6_3973469,at_truck10_city10-1,3973469,6,5,4,9,0
6_2773649,noop_location_city3-2,2773649,6,1,1,2,0
6_705395,unload-truck_package1_truck3_city3-2,705395,6,138,146,284,0
6_2713826,unload-truck_package3_truck3_city3-2,2713826,6,144,163,307,0
6_7718530,unload-truck_package4_truck3_city3-2,7718530,6,146,162,308,0
6_4722257,unload-truck_package5_truck3_city3-2,4722257,6,138,146,284,0
6_1463243,load-truck_package1_truck3_city3-2,1463243,6,137,146,283,0
6_5480105,load-truck_package5_truck3_city3-2,5480105,6,137,146,283,0
6_2962340,noop_at_truck7_city7-1,2962340,6,14,13,27,0
6_5915916,at_truck7_city7-2,5915916,6,3,11,14,0
6_1164949,noop_at_package1_city5-2,1164949,6,127,136,263,0
6_2008582,load-truck_package1_truck5_city5-2,2008582,6,136,147,283,0
6_6289518,noop_at_plane4_city8-2,6289518,6,182,190,372,0
6_2962341,noop_at_truck7_city7-2,2962341,6,7,11,18,0
6_5915915,at_truck7_city7-1,5915915,6,5,8,13,0
6_2255627,noop_at_package5_city9-2,2255627,6,127,136,263,0
6_2010292,noop_in-city_city9-2_city9,2010292,6,1,1,2,0
6_1644752,noop_at_package3_city6-2,1644752,6,136,154,290,0
6_1602093,noop_at_plane1_city7-2,1602093,6,182,190,372,0
6_1561471,noop_airport_city3-2,1561471,6,1,1,2,0
6_6144820,noop_at_truck4_city4-1,6144820,6,14,13,27,0
6_1097419,at_truck4_city4-2,1097419,6,3,12,15,0
6_5590230,noop_at_package4_city2-2,5590230,6,136,154,290,0
6_4203220,load-truck_package4_truck2_city2-2,4203220,6,146,164,310,0
6_1623144,noop_at_plane3_city1-2,1623144,6,182,190,372,0
6_6144821,noop_at_truck4_city4-2,6144821,6,6,12,18,0
6_1097418,at_truck4_city4-1,1097418,6,5,7,12,0
6_5547571,noop_at_plane2_city3-2,5547571,6,182,190,372,0
6_6118830,noop_at_truck10_city10-1,6118830,6,16,14,30,0
6_3142669,unload-truck_package2_truck10_city10-1,3142669,6,72,121,193,0
6_7373852,unload-truck_package3_truck10_city10-1,7373852,6,153,166,319,0
6_3604058,unload-truck_package4_truck10_city10-1,3604058,6,153,166,319,0
6_7404958,load-truck_package2_truck10_city10-1,7404958,6,72,121,193,0
6_3973470,at_truck10_city10-2,3973470,6,3,5,8,0
6_6110934,noop_in_package4_plane1,6110934,6,136,154,290,0
6_6118831,noop_at_truck10_city10-2,6118831,6,8,14,22,0
6_6912464,unload-truck_package1_truck10_city10-2,6912464,6,138,149,287,0
6_3142670,unload-truck_package2_truck10_city10-2,3142670,6,64,121,185,0
6_7373853,unload-truck_package3_truck10_city10-2,7373853,6,146,165,311,0
6_3604059,unload-truck_package4_truck10_city10-2,3604059,6,146,165,311,0
6_3173776,load-truck_package1_truck10_city10-2,3173776,6,138,149,287,0
6_7404959,load-truck_package2_truck10_city10-2,7404959,6,64,121,185,0
6_3635165,load-truck_package3_truck10_city10-2,3635165,6,146,165,311,0
6_4096554,load-truck_package5_truck10_city10-2,4096554,6,138,149,287,0
6_6110935,noop_in_package4_plane2,6110935,6,136,154,290,0
6_6048982,noop_at_package4_city9-2,6048982,6,136,154,290,0
6_2081896,noop_at_plane3_city8-2,2081896,6,182,190,372,0
6_6110936,noop_in_package4_plane3,6110936,6,136,154,290,0
6_7612973,noop_in-city_city6-1_city6,7612973,6,1,1,2,0
6_2124555,noop_at_package5_city7-2,2124555,6,127,136,263,0
6_902805,noop_at_package1_city1-2,902805,6,127,136,263,0
6_917904,load-truck_package1_truck1_city1-2,917904,6,138,148,286,0
6_6027374,noop_at_plane4_city4-2,6027374,6,182,190,372,0
6_2970256,noop_location_city6-1,2970256,6,1,1,2,0
6_6110937,noop_in_package4_plane4,6110937,6,136,154,290,0
6_7286102,noop_at_package1_city10-2,7286102,6,127,136,263,0
6_1324776,noop_at_package3_city10-2,1324776,6,136,154,290,0
6_2970257,noop_location_city6-2,2970257,6,1,1,2,0
6_7846438,noop_in_package5_truck1,7846438,6,127,136,263,0
6_4176917,unload-truck_package5_truck1_city1-1,4176917,6,141,147,288,0
6_4176918,unload-truck_package5_truck1_city1-2,4176918,6,136,147,283,0
6_1361557,noop_at_package1_city8-2,1361557,6,127,136,263,0
6_6827079,load-truck_package1_truck8_city8-2,6827079,6,136,147,283,0
6_7846439,noop_in_package5_truck2,7846439,6,134,140,274,0
6_449099,unload-truck_package5_truck2_city2-2,449099,6,139,148,287,0
6_552079,at_truck2_city2-1,552079,6,4,9,13,0
6_1382608,noop_at_package3_city2-2,1382608,6,136,154,290,0
6_7199493,load-truck_package3_truck2_city2-2,7199493,6,146,164,310,0
6_1339949,noop_at_plane1_city3-2,1339949,6,182,190,372,0
6_3364427,noop_at_package5_city10-2,3364427,6,127,136,263,0
6_7846440,noop_in_package5_truck3,7846440,6,133,138,271,0
6_4825237,at_truck3_city3-1,4825237,6,5,8,13,0
6_5389377,noop_in-city_city6-2_city6,5389377,6,1,1,2,0
6_3405350,noop_in-city_city5-1_city5,3405350,6,1,1,2,0
6_2656144,drive-truck_truck5_city5-1_city5-2_city5,2656144,6,22,20,42,0
6_7899656,drive-truck_truck5_city5-2_city5-1_city5,7899656,6,20,22,42,0
6_7846441,noop_in_package5_truck4,7846441,6,131,140,271,0
6_1841360,noop_at_package3_city9-2,1841360,6,136,154,290,0
6_3822037,noop_in_package2_truck10,3822037,6,55,109,164,0
6_7160435,at_package2_city10-1,7160435,6,8,16,24,0
6_7160436,at_package2_city10-2,7160436,6,16,20,36,0
6_4475737,in_package2_plane1,4475737,6,17,25,42,0
6_4475738,in_package2_plane2,4475738,6,17,25,42,0
6_4475739,in_package2_plane3,4475739,6,17,25,42,0
6_4475740,in_package2_plane4,4475740,6,17,25,42,0
6_1758079,noop_airport_city6-2,1758079,6,1,1,2,0
6_2417001,noop_at_truck5_city5-1,2417001,6,14,13,27,0
6_3259164,unload-truck_package3_truck5_city5-1,3259164,6,151,165,316,0
6_262891,unload-truck_package4_truck5_city5-1,262891,6,151,165,316,0
6_5370577,at_truck5_city5-2,5370577,6,3,5,8,0
6_7846442,noop_in_package5_truck5,7846442,6,131,140,271,0
6_5267596,unload-truck_package5_truck5_city5-2,5267596,6,136,147,283,0
6_5370576,at_truck5_city5-1,5370576,6,5,3,8,0
6_5786838,noop_at_package4_city5-2,5786838,6,136,154,290,0
6_1020740,load-truck_package4_truck5_city5-2,1020740,6,144,163,307,0
6_5744179,noop_at_plane2_city6-2,5744179,6,182,190,372,0
6_1819752,noop_at_plane3_city4-2,1819752,6,182,190,372,0
6_2417002,noop_at_truck5_city5-2,2417002,6,6,12,18,0
6_1250734,unload-truck_package1_truck5_city5-2,1250734,6,136,147,283,0
6_3259165,unload-truck_package3_truck5_city5-2,3259165,6,144,163,307,0
6_262892,unload-truck_package4_truck5_city5-2,262892,6,144,163,307,0
6_4017013,load-truck_package3_truck5_city5-2,4017013,6,144,163,307,0
6_6025444,load-truck_package5_truck5_city5-2,6025444,6,136,147,283,0
6_1862411,noop_at_package5_city3-2,1862411,6,127,136,263,0
6_7846443,noop_in_package5_truck6,7846443,6,131,140,271,0
6_2708112,noop_location_city2-1,2708112,6,1,1,2,0
6_4433213,unload-truck_package1_truck2_city2-1,4433213,6,141,147,288,0
6_6441644,unload-truck_package3_truck2_city2-1,6441644,6,152,165,317,0
6_3445371,unload-truck_package4_truck2_city2-1,3445371,6,152,165,317,0
6_7282143,noop_in_package3_plane1,7282143,6,136,154,290,0
6_7846444,noop_in_package5_truck7,7846444,6,133,138,271,0
6_7282144,noop_in_package3_plane2,7282144,6,136,154,290,0
6_2708113,noop_location_city2-2,2708113,6,1,1,2,0
6_4433214,unload-truck_package1_truck2_city2-2,4433214,6,136,147,283,0
6_6441645,unload-truck_package3_truck2_city2-2,6441645,6,147,164,311,0
6_3445372,unload-truck_package4_truck2_city2-2,3445372,6,147,164,311,0
6_1206947,load-truck_package5_truck2_city2-2,1206947,6,138,148,286,0
6_1181754,noop_in-city_city5-2_city5,1181754,6,1,1,2,0
6_5599481,noop_at_truck2_city2-1,5599481,6,13,13,26,0
6_552080,at_truck2_city2-2,552080,6,3,12,15,0
6_1099413,noop_at_package1_city4-2,1099413,6,127,136,263,0
6_7846445,noop_in_package5_truck8,7846445,6,131,140,271,0
6_2085116,unload-truck_package5_truck8_city8-2,2085116,6,136,147,283,0
6_2188096,at_truck8_city8-1,2188096,6,5,8,13,0
6_6223982,noop_at_plane4_city7-2,6223982,6,182,190,372,0
6_5599482,noop_at_truck2_city2-2,5599482,6,8,13,21,0
6_62686,noop_truck_truck1,62686,6,1,1,2,0
6_85171,drive-truck_truck1_city1-1_city1-2_city1,85171,6,23,21,44,0
6_5328683,drive-truck_truck1_city1-2_city1-1_city1,5328683,6,22,23,45,0
6_160056,unload-truck_package1_truck1_city1-2,160056,6,139,148,287,0
6_2168486,unload-truck_package3_truck1_city1-1,2168486,6,152,165,317,0
6_2168487,unload-truck_package3_truck1_city1-2,2168487,6,147,164,311,0
6_7173190,unload-truck_package4_truck1_city1-1,7173190,6,152,165,317,0
6_7173191,unload-truck_package4_truck1_city1-2,7173191,6,147,164,311,0
6_2926335,load-truck_package3_truck1_city1-2,2926335,6,146,164,310,0
6_7931039,load-truck_package4_truck1_city1-2,7931039,6,146,164,310,0
6_3166864,noop_location_city9-1,3166864,6,1,1,2,0
6_7282145,noop_in_package3_plane3,7282145,6,136,154,290,0
6_2190091,noop_at_package5_city8-2,2190091,6,127,136,263,0
6_2842964,load-truck_package5_truck8_city8-2,2842964,6,136,147,283,0
6_7615392,noop_in_package1_truck10,7615392,6,133,140,273,0
6_7846446,noop_in_package5_truck9,7846446,6,131,140,271,0
6_7282146,noop_in_package3_plane4,7282146,6,136,154,290,0
6_62687,noop_truck_truck2,62687,6,1,1,2,0
6_3166865,noop_location_city9-2,3166865,6,1,1,2,0
6_4530297,noop_in_package1_truck1,4530297,6,134,140,274,0
6_4279898,at_truck1_city1-1,4279898,6,4,9,13,0
6_1579216,noop_at_package3_city5-2,1579216,6,136,154,290,0
6_62688,noop_truck_truck3,62688,6,1,1,2,0
6_1495935,noop_airport_city2-2,1495935,6,1,1,2,0
6_4109194,noop_in-city_city10-1_city10,4109194,6,1,1,2,0
6_1536557,noop_at_plane1_city6-2,1536557,6,182,190,372,0
6_1016670,noop_in_package4_truck1,1016670,6,138,154,292,0
6_5524694,noop_at_package4_city1-2,5524694,6,136,154,290,0
6_5482035,noop_at_plane2_city2-2,5482035,6,182,190,372,0
6_45710,noop_truck_truck10,45710,6,1,1,2,0
6_62689,noop_truck_truck4,62689,6,1,1,2,0
6_4975108,noop_in-city_city4-2_city4,4975108,6,1,1,2,0
6_6784435,noop_in-city_city2-1_city2,6784435,6,1,1,2,0
6_4530298,noop_in_package1_truck2,4530298,6,127,136,263,0
6_1016671,noop_in_package4_truck2,1016671,6,138,154,292,0
6_4530299,noop_in_package1_truck3,4530299,6,133,138,271,0
6_62690,noop_truck_truck5,62690,6,1,1,2,0
6_1954687,noop_airport_city9-2,1954687,6,1,1,2,0
6_1016672,noop_in_package4_truck3,1016672,6,138,154,292,0
6_4530300,noop_in_package1_truck4,4530300,6,131,140,271,0
6_5983446,noop_at_package4_city8-2,5983446,6,136,154,290,0
6_5839237,load-truck_package4_truck8_city8-2,5839237,6,144,163,307,0
6_5940787,noop_at_plane2_city9-2,5940787,6,182,190,372,0
6_62691,noop_truck_truck6,62691,6,1,1,2,0
6_2016360,noop_at_plane3_city7-2,2016360,6,182,190,372,0
6_4305438,noop_at_package2_city10-1,4305438,6,55,109,164,0
6_1676676,in_package2_truck10,1676676,6,10,17,27,0
6_1016673,noop_in_package4_truck4,1016673,6,136,154,290,0
6_2059019,noop_at_package5_city6-2,2059019,6,127,136,263,0
6_4530301,noop_in_package1_truck5,4530301,6,131,140,271,0
6_4305439,noop_at_package2_city10-2,4305439,6,55,109,164,0
6_62692,noop_truck_truck7,62692,6,1,1,2,0
6_2904720,noop_location_city5-1,2904720,6,1,1,2,0
6_5961838,noop_at_plane4_city3-2,5961838,6,182,190,372,0
6_1016674,noop_in_package4_truck5,1016674,6,136,154,290,0
6_4530302,noop_in_package1_truck6,4530302,6,131,140,271,0
6_4689752,noop_at_plane4_city10-2,4689752,6,181,190,371,0
6_62693,noop_truck_truck8,62693,6,1,1,2,0
6_6584618,drive-truck_truck8_city8-1_city8-2_city8,6584618,6,22,20,42,0
6_3827153,drive-truck_truck8_city8-2_city8-1_city8,3827153,6,20,22,42,0
6_6069231,unload-truck_package1_truck8_city8-2,6069231,6,136,147,283,0
6_76684,unload-truck_package3_truck8_city8-1,76684,6,151,165,316,0
6_76685,unload-truck_package3_truck8_city8-2,76685,6,144,163,307,0
6_5081388,unload-truck_package4_truck8_city8-1,5081388,6,151,165,316,0
6_5081389,unload-truck_package4_truck8_city8-2,5081389,6,144,163,307,0
6_834533,load-truck_package3_truck8_city8-2,834533,6,144,163,307,0
6_2904721,noop_location_city5-2,2904721,6,1,1,2,0
6_2576812,noop_in-city_city1-1_city1,2576812,6,1,1,2,0
6_1871662,noop_at_truck3_city3-1,1871662,6,14,13,27,0
6_4825238,at_truck3_city3-2,4825238,6,3,11,14,0
6_1016675,noop_in_package4_truck6,1016675,6,136,154,290,0
6_452375,noop_in_package2_plane1,452375,6,55,109,164,0
6_1296021,noop_at_package1_city7-2,1296021,6,127,136,263,0
6_4530303,noop_in_package1_truck7,4530303,6,133,138,271,0
6_1317072,noop_at_package3_city1-2,1317072,6,136,154,290,0
6_1274413,noop_at_plane1_city2-2,1274413,6,182,190,372,0
6_1871663,noop_at_truck3_city3-2,1871663,6,7,11,18,0
6_62694,noop_truck_truck9,62694,6,1,1,2,0
6_1016676,noop_in_package4_truck7,1016676,6,136,154,290,0
6_452376,noop_in_package2_plane2,452376,6,55,109,164,0
6_4530304,noop_in_package1_truck8,4530304,6,131,140,271,0
6_1837095,noop_obj_package1,1837095,6,1,1,2,0
6_1016677,noop_in_package4_truck8,1016677,6,136,154,290,0
6_452377,noop_in_package2_plane3,452377,6,55,109,164,0
6_4530305,noop_in_package1_truck9,4530305,6,131,140,271,0
6_1775824,noop_at_package3_city8-2,1775824,6,136,154,290,0
6_1733165,noop_at_plane1_city9-2,1733165,6,182,190,372,0
6_1837096,noop_obj_package2,1837096,6,1,1,2,0
6_1692543,noop_airport_city5-2,1692543,6,1,1,2,0
6_26265,noop_in-city_city8-1_city8,26265,6,1,1,2,0
6_1016678,noop_in_package4_truck9,1016678,6,136,154,290,0
6_452378,noop_in_package2_plane4,452378,6,55,109,164,0
6_5721302,noop_at_package4_city4-2,5721302,6,136,154,290,0
6_5678643,noop_at_plane2_city5-2,5678643,6,182,190,372,0
6_1754216,noop_at_plane3_city3-2,1754216,6,182,190,372,0
6_1837097,noop_obj_package3,1837097,6,1,1,2,0
6_353216,noop_in-city_city1-2_city1,353216,6,1,1,2,0
6_2187879,noop_in_package3_truck1,2187879,6,138,154,292,0
6_1796875,noop_at_package5_city2-2,1796875,6,127,136,263,0
6_1837098,noop_obj_package4,1837098,6,1,1,2,0
6_4005493,noop_city_city1,4005493,6,1,1,2,0
6_2642576,noop_location_city1-1,2642576,6,1,1,2,0
6_2187880,noop_in_package3_truck2,2187880,6,138,154,292,0
6_1837099,noop_obj_package5,1837099,6,1,1,2,0
6_4005494,noop_city_city2,4005494,6,1,1,2,0
6_2642577,noop_location_city1-2,2642577,6,1,1,2,0
6_2187881,noop_in_package3_truck3,2187881,6,136,154,290,0
6_4236304,noop_in_package4_truck10,4236304,6,136,154,290,0
6_1033877,noop_at_package1_city3-2,1033877,6,127,136,263,0
6_6158446,noop_at_plane4_city6-2,6158446,6,182,190,372,0
6_4005495,noop_city_city3,4005495,6,1,1,2,0
6_3101328,noop_location_city8-1,3101328,6,1,1,2,0
6_5803646,noop_in-city_city8-2_city8,5803646,6,1,1,2,0
6_3819619,noop_in-city_city7-1_city7,3819619,6,1,1,2,0
6_2187882,noop_in_package3_truck4,2187882,6,136,154,290,0
6_4005496,noop_city_city4,4005496,6,1,1,2,0
6_3101329,noop_location_city8-2,3101329,6,1,1,2,0
6_2187883,noop_in_package3_truck5,2187883,6,136,154,290,0
6_1513680,noop_at_package3_city4-2,1513680,6,136,154,290,0
6_1471021,noop_at_plane1_city5-2,1471021,6,182,190,372,0
6_4005497,noop_city_city5,4005497,6,1,1,2,0
6_4613021,noop_location_city10-1,4613021,6,1,1,2,0
6_6333557,noop_airport_city10-2,6333557,6,1,1,2,0
6_1430399,noop_airport_city1-2,1430399,6,1,1,2,0
6_7235498,noop_at_truck8_city8-1,7235498,6,14,13,27,0
6_2188097,at_truck8_city8-2,2188097,6,3,12,15,0
6_1623584,noop_in_package1_plane1,1623584,6,127,136,263,0
6_2187884,noop_in_package3_truck6,2187884,6,136,154,290,0
6_5416499,noop_at_plane2_city1-2,5416499,6,182,190,372,0
6_7235499,noop_at_truck8_city8-2,7235499,6,6,12,18,0
6_4005498,noop_city_city6,4005498,6,1,1,2,0
6_4613022,noop_location_city10-2,4613022,6,1,1,2,0
6_1623585,noop_in_package1_plane2,1623585,6,127,136,263,0
6_2187885,noop_in_package3_truck7,2187885,6,138,154,292,0
6_4005499,noop_city_city7,4005499,6,1,1,2,0
6_1889151,noop_airport_city8-2,1889151,6,1,1,2,0
6_1596023,noop_in-city_city7-2_city7,1596023,6,1,1,2,0
6_1326323,noop_at_truck1_city1-1,1326323,6,13,13,26,0
6_4279899,at_truck1_city1-2,4279899,6,3,12,15,0
6_1623586,noop_in_package1_plane3,1623586,6,127,136,263,0
6_2187886,noop_in_package3_truck8,2187886,6,136,154,290,0
6_28682,noop_in_package3_truck10,28682,6,136,154,290,0
6_5917909,noop_at_package4_city7-1,5917909,6,143,154,297,0
6_5630764,noop_at_plane1_city10-2,5630764,6,181,190,371,0
6_5875251,noop_at_plane2_city8-2,5875251,6,182,190,372,0
6_1950824,noop_at_plane3_city6-2,1950824,6,182,190,372,0
6_1326324,noop_at_truck1_city1-2,1326324,6,8,13,21,0
6_4005500,noop_city_city8,4005500,6,1,1,2,0
6_5917910,noop_at_package4_city7-2,5917910,6,136,154,290,0
6_1623587,noop_in_package1_plane4,1623587,6,127,136,263,0
6_2187887,noop_in_package3_truck9,2187887,6,136,154,290,0
6_1993483,noop_at_package5_city5-2,1993483,6,127,136,263,0
6_6497299,city_city8,6497299,6,1,2,3,0
5_4530300,noop_in_package1_truck4,4530300,5,0,131,131,0
4_552685,in_package1_truck4,552685,4,0,1,1,0
6_6195675,in-city_city5-1_city5,6195675,6,1,0,1,0
6_7104561,city_city10,7104561,6,1,2,3,0
5_6727100,unload-airplane_package2_plane2_city8-2,6727100,5,5,227,232,0
6_3423818,at_package2_city8-2,3423818,6,4,19,23,0
6_585448,airport_city8-2,585448,6,1,72,73,0
5_4530301,noop_in_package1_truck5,4530301,5,0,131,131,0
4_552686,in_package1_truck5,552686,4,0,1,1,0
6_6497300,city_city9,6497300,6,1,0,1,0
5_2671601,unload-airplane_package2_plane3_city4-2,2671601,5,5,227,232,0
6_3161674,at_package2_city4-2,3161674,6,4,20,24,0
5_6748151,unload-airplane_package2_plane4_city2-2,6748151,5,5,227,232,0
6_3030602,at_package2_city2-2,3030602,6,4,1,5,0
5_4530302,noop_in_package1_truck6,4530302,5,0,131,131,0
4_552687,in_package1_truck6,552687,4,0,1,1,0
5_7373852,unload-truck_package3_truck10_city10-1,7373852,5,5,150,155,0
6_4179772,at_package3_city10-1,4179772,6,1,37,38,0
5_4530303,noop_in_package1_truck7,4530303,5,0,133,133,0
4_552688,in_package1_truck7,552688,4,0,1,1,0
5_7206903,unload-airplane_package2_plane4_city9-2,7206903,5,5,227,232,0
6_3489354,at_package2_city9-2,3489354,6,4,15,19,0
5_4978553,unload-truck_package1_truck4_city4-2,4978553,5,5,133,138,0
5_3804503,unload-truck_package3_truck7_city7-1,3804503,5,5,150,155,0
6_7565903,at_package3_city7-1,7565903,6,1,1,2,0
5_4530304,noop_in_package1_truck8,4530304,5,0,131,131,0
4_552689,in_package1_truck8,552689,4,0,1,1,0
6_3972079,in-city_city5-2_city5,3972079,6,1,2,3,0
6_1988052,in-city_city4-1_city4,1988052,6,1,2,3,0
5_4530305,noop_in_package1_truck9,4530305,5,0,131,131,0
4_552690,in_package1_truck9,552690,4,0,1,1,0
6_5263322,location_city6-1,5263322,6,1,8,9,0
5_2388406,unload-airplane_package2_plane1_city6-2,2388406,5,5,227,232,0
6_3292746,at_package2_city6-2,3292746,6,4,20,24,0
5_6464956,unload-airplane_package2_plane2_city4-2,6464956,5,5,227,232,0
5_160056,unload-truck_package1_truck1_city1-2,160056,5,4,136,140,0
4_552682,in_package1_truck1,552682,4,0,1,1,0
6_625646,airport_city10-2,625646,6,1,72,73,0
6_5263323,location_city6-2,5263323,6,1,51,52,0
6_323304,airport_city4-2,323304,6,1,4,5,0
5_4722257,unload-truck_package5_truck3_city3-2,4722257,5,4,135,139,0
4_3868825,in_package5_truck3,3868825,4,0,1,1,0
6_7765433,in-city_city4-2_city4,7765433,6,1,2,3,0
5_3604058,unload-truck_package4_truck10_city10-1,3604058,5,5,150,155,0
6_1199109,at_package4_city10-1,1199109,6,1,35,36,0
5_2868209,unload-airplane_package2_plane3_city7-2,2868209,5,5,227,232,0
6_3358282,at_package2_city7-2,3358282,6,4,20,24,0
5_6944759,unload-airplane_package2_plane4_city5-2,6944759,5,5,227,232,0
6_3227210,at_package2_city5-2,3227210,6,4,16,20,0
6_1230283,truck_truck10,1230283,6,1,20,21,0
5_3990710,unload-truck_package4_truck4_city4-1,3990710,5,5,148,153,0
6_3575940,at_package4_city4-1,3575940,6,1,37,38,0
6_5367137,in-city_city1-1_city1,5367137,6,1,2,3,0
6_5001178,location_city2-1,5001178,6,1,6,7,0
5_2126262,unload-airplane_package2_plane1_city2-2,2126262,5,5,227,232,0
5_2341412,unload-truck_package1_truck9_city9-2,2341412,5,5,133,138,0
6_5001179,location_city2-2,5001179,6,1,47,48,0
6_3715160,airplane_plane1,3715160,6,1,88,89,0
6_5459930,location_city9-1,5459930,6,1,8,9,0
6_3715161,airplane_plane2,3715161,6,1,56,57,0
5_2585014,unload-airplane_package2_plane1_city9-2,2585014,5,5,227,232,0
5_6661564,unload-airplane_package2_plane2_city7-2,6661564,5,5,227,232,0
5_6912464,unload-truck_package1_truck10_city10-2,6912464,5,4,135,139,0
4_5470031,in_package1_truck10,5470031,4,0,1,1,0
5_3259164,unload-truck_package3_truck5_city5-1,3259164,5,5,148,153,0
6_7434831,at_package3_city5-1,7434831,6,1,37,38,0
6_2816590,in-city_city8-1_city8,2816590,6,1,2,3,0
6_5459931,location_city9-2,5459931,6,1,51,52,0
6_519912,airport_city7-2,519912,6,1,46,47,0
6_3715162,airplane_plane3,3715162,6,1,115,116,0
5_2606065,unload-airplane_package2_plane3_city3-2,2606065,5,5,227,232,0
6_3096138,at_package2_city3-2,3096138,6,4,20,24,0
5_6682615,unload-airplane_package2_plane4_city1-2,6682615,5,5,227,232,0
6_2965066,at_package2_city1-2,2965066,6,4,19,23,0
6_3143541,in-city_city1-2_city1,3143541,6,1,2,3,0
6_3715163,airplane_plane4,3715163,6,1,115,116,0
5_2085116,unload-truck_package5_truck8_city8-2,2085116,5,4,133,137,0
4_3868830,in_package5_truck8,3868830,4,0,1,1,0
5_7141367,unload-airplane_package2_plane4_city8-2,7141367,5,5,227,232,0
6_6609944,in-city_city7-1_city7,6609944,6,1,2,3,0
5_1353569,unload-truck_package4_truck9_city9-1,1353569,5,5,148,153,0
6_3903620,at_package4_city9-1,3903620,6,1,37,38,0
6_5197786,location_city5-1,5197786,6,1,8,9,0
5_2322870,unload-airplane_package2_plane1_city5-2,2322870,5,5,227,232,0
5_6399420,unload-airplane_package2_plane2_city3-2,6399420,5,5,227,232,0
6_7566596,location_city10-1,7566596,6,1,10,11,0
6_5197787,location_city5-2,5197787,6,1,51,52,0
6_257768,airport_city3-2,257768,6,1,72,73,0
5_3445371,unload-truck_package4_truck2_city2-1,3445371,5,5,149,154,0
6_3444868,at_package4_city2-1,3444868,6,1,34,35,0
6_7566597,location_city10-2,7566597,6,1,52,53,0
5_7532322,unload-truck_package3_truck6_city6-1,7532322,5,5,148,153,0
6_7500367,at_package3_city6-1,7500367,6,1,37,38,0
6_4386348,in-city_city7-2_city7,4386348,6,1,2,3,0
6_2402321,in-city_city6-1_city6,2402321,6,1,2,3,0
5_2802673,unload-airplane_package2_plane3_city6-2,2802673,5,5,227,232,0
5_6879223,unload-airplane_package2_plane4_city4-2,6879223,5,5,227,232,0
5_1796073,unload-truck_package1_truck7_city7-2,1796073,5,5,135,140,0
5_6358274,unload-truck_package5_truck9_city9-2,6358274,5,4,133,137,0
4_3868831,in_package5_truck9,3868831,4,0,1,1,0
6_4935642,location_city1-1,4935642,6,1,9,10,0
5_2060726,unload-airplane_package2_plane1_city1-2,2060726,5,5,227,232,0
6_4935643,location_city1-2,4935643,6,1,51,52,0
6_178725,in-city_city6-2_city6,178725,6,1,2,3,0
5_1539777,unload-truck_package5_truck6_city6-2,1539777,5,4,133,137,0
4_3868828,in_package5_truck6,3868828,4,0,1,1,0
6_5394394,location_city8-1,5394394,6,1,8,9,0
5_2519478,unload-airplane_package2_plane1_city8-2,2519478,5,5,227,232,0
5_6596028,unload-airplane_package2_plane2_city6-2,6596028,5,5,227,232,0
6_5394395,location_city8-2,5394395,6,1,51,52,0
6_454376,airport_city6-2,454376,6,1,72,73,0
5_2540529,unload-airplane_package2_plane3_city2-2,2540529,5,5,227,232,0
5_7718529,unload-truck_package4_truck3_city3-1,7718529,5,5,150,155,0
6_3510404,at_package4_city3-1,3510404,6,1,1,2,0
6_5781406,in-city_city3-1_city3,5781406,6,1,0,1,0
5_2999281,unload-airplane_package2_plane3_city9-2,2999281,5,5,227,232,0
5_7075831,unload-airplane_package2_plane4_city7-2,7075831,5,5,227,232,0
5_6069231,unload-truck_package1_truck8_city8-2,6069231,5,5,133,138,0
5_6986983,unload-truck_package3_truck4_city4-1,6986983,5,5,148,153,0
6_7369295,at_package3_city4-1,7369295,6,1,37,38,0
6_5132250,location_city4-1,5132250,6,1,0,1,0
5_2257334,unload-airplane_package2_plane1_city4-2,2257334,5,5,227,232,0
5_6333884,unload-airplane_package2_plane2_city2-2,6333884,5,5,227,232,0
5_1250734,unload-truck_package1_truck5_city5-2,1250734,5,5,133,138,0
5_76684,unload-truck_package3_truck8_city8-1,76684,5,5,148,153,0
6_7631439,at_package3_city8-1,7631439,6,1,37,38,0
6_1573783,in-city_city2-1_city2,1573783,6,1,2,3,0
6_192232,airport_city2-2,192232,6,1,72,73,0
6_3557810,in-city_city3-2_city3,3557810,6,1,2,3,0
6_5132251,location_city4-2,5132251,6,1,2,3,0
6_7347850,in-city_city10-2_city10,7347850,6,1,0,1,0
5_5812935,unload-truck_package5_truck7_city7-2,5812935,5,4,135,139,0
4_3868829,in_package5_truck7,3868829,4,0,1,1,0
6_2661380,truck_truck1,2661380,6,1,6,7,0
5_6792636,unload-airplane_package2_plane2_city9-2,6792636,5,5,227,232,0
5_2168486,unload-truck_package3_truck1_city1-1,2168486,5,5,149,154,0
6_7172687,at_package3_city1-1,7172687,6,1,36,37,0
6_650984,airport_city9-2,650984,6,1,72,73,0
6_2661381,truck_truck2,2661381,6,1,18,19,0
5_2737137,unload-airplane_package2_plane3_city5-2,2737137,5,5,227,232,0
5_6813687,unload-airplane_package2_plane4_city3-2,6813687,5,5,227,232,0
6_2661382,truck_truck3,2661382,6,1,17,18,0
6_7024213,in-city_city9-1_city9,7024213,6,1,2,3,0
5_5081388,unload-truck_package4_truck8_city8-1,5081388,5,5,148,153,0
6_3838084,at_package4_city8-1,3838084,6,1,35,36,0
5_994438,unload-truck_package5_truck4_city4-2,994438,5,4,133,137,0
4_3868826,in_package5_truck4,3868826,4,0,1,1,0
6_2661383,truck_truck4,2661383,6,1,17,18,0
5_7846439,noop_in_package5_truck2,7846439,5,0,134,134,0
4_3868824,in_package5_truck2,3868824,4,0,1,1,0
6_7351164,in-city_city2-2_city2,7351164,6,1,0,1,0
6_2661384,truck_truck5,2661384,6,1,17,18,0
5_7846440,noop_in_package5_truck3,7846440,5,1,133,134,0
5_7173190,unload-truck_package4_truck1_city1-1,7173190,5,5,149,154,0
6_3379332,at_package4_city1-1,3379332,6,1,35,36,0
6_2661385,truck_truck6,2661385,6,1,17,18,0
5_7846441,noop_in_package5_truck4,7846441,5,1,131,132,0
5_262891,unload-truck_package4_truck5_city5-1,262891,5,5,148,153,0
6_3641476,at_package4_city5-1,3641476,6,1,35,36,0
6_2661386,truck_truck7,2661386,6,1,17,18,0
5_7615392,noop_in_package1_truck10,7615392,5,1,133,134,0
5_7846442,noop_in_package5_truck5,7846442,5,0,131,131,0
4_3868827,in_package5_truck5,3868827,4,0,1,1,0
6_4800617,in-city_city9-2_city9,4800617,6,1,2,3,0
6_5328858,location_city7-1,5328858,6,1,1,2,0
5_2453942,unload-airplane_package2_plane1_city7-2,2453942,5,5,227,232,0
5_6530492,unload-airplane_package2_plane2_city5-2,6530492,5,5,227,232,0
5_5523892,unload-truck_package1_truck6_city6-2,5523892,5,5,133,138,0
5_4349842,unload-truck_package3_truck9_city9-1,4349842,5,5,148,153,0
6_7696975,at_package3_city9-1,7696975,6,1,37,38,0
5_7835242,unload-truck_package5_truck10_city10-2,7835242,5,4,135,139,0
4_6298565,in_package5_truck10,6298565,4,0,1,1,0
6_6497292,city_city1,6497292,6,1,2,3,0
6_388840,airport_city5-2,388840,6,1,72,73,0
6_2661387,truck_truck8,2661387,6,1,7,8,0
5_7846443,noop_in_package5_truck6,7846443,5,1,131,132,0
6_5328859,location_city7-2,5328859,6,1,7,8,0
5_2474993,unload-airplane_package2_plane3_city1-2,2474993,5,5,227,232,0
6_6497293,city_city2,6497293,6,1,2,3,0
6_2661388,truck_truck9,2661388,6,1,17,18,0
6_518082,in-city_city10-1_city10,518082,6,1,2,3,0
5_7846444,noop_in_package5_truck7,7846444,5,1,133,134,0
5_6441644,unload-truck_package3_truck2_city2-1,6441644,5,5,149,154,0
6_7238223,at_package3_city2-1,7238223,6,1,35,36,0
6_6497294,city_city3,6497294,6,1,2,3,0
6_4435789,obj_package1,4435789,6,1,111,112,0
5_7846445,noop_in_package5_truck8,7846445,5,1,131,132,0
5_2933745,unload-airplane_package2_plane3_city8-2,2933745,5,5,227,232,0
5_7010295,unload-airplane_package2_plane4_city6-2,7010295,5,5,227,232,0
5_705395,unload-truck_package1_truck3_city3-2,705395,5,4,135,139,0
4_552684,in_package1_truck3,552684,4,0,1,1,0
6_6497295,city_city4,6497295,6,1,2,3,0
6_592994,in-city_city8-2_city8,592994,6,1,2,3,0
6_4435790,obj_package2,4435790,6,1,93,94,0
5_7846446,noop_in_package5_truck9,7846446,5,1,131,132,0
5_5267596,unload-truck_package5_truck5_city5-2,5267596,5,5,133,138,0
6_6497296,city_city5,6497296,6,1,2,3,0
6_4435791,obj_package3,4435791,6,1,120,121,0
5_4530297,noop_in_package1_truck1,4530297,5,1,134,135,0
6_6497297,city_city6,6497297,6,1,2,3,0
6_4435792,obj_package4,4435792,6,1,120,121,0
6_5066714,location_city3-1,5066714,6,1,4,5,0
5_2191798,unload-airplane_package2_plane1_city3-2,2191798,5,5,227,232,0
5_6268348,unload-airplane_package2_plane2_city1-2,6268348,5,5,227,232,0
6_6497298,city_city7,6497298,6,1,2,3,0
6_126696,airport_city1-2,126696,6,1,72,73,0
6_4435793,obj_package5,4435793,6,1,111,112,0
5_4530299,noop_in_package1_truck3,4530299,5,1,133,134,0
6_5066715,location_city3-2,5066715,6,1,44,45,0
5_442949,noop_in_package5_truck10,442949,5,1,133,134,0
5_4536049,unload-truck_package4_truck6_city6-1,4536049,5,5,148,153,0
6_3707012,at_package4_city6-1,3707012,6,1,37,38,0
5_449099,unload-truck_package5_truck2_city2-2,449099,5,5,136,141,0
7_2937985,noop_in-city_city10-2_city10,2937985,7,0,0,0,0
7_7656764,drive-truck_truck10_city10-1_city10-2_city10,7656764,7,27,0,27,0
7_1874900,drive-truck_truck10_city10-2_city10-1_city10,1874900,7,29,0,29,0
7_2839184,noop_location_city4-1,2839184,7,0,0,0,0
7_4013645,drive-truck_truck4_city4-1_city4-2_city4,4013645,7,24,0,24,0
7_1256180,drive-truck_truck4_city4-2_city4-1_city4,1256180,7,26,0,26,0
7_4978552,unload-truck_package1_truck4_city4-1,4978552,7,153,0,153,0
7_6986983,unload-truck_package3_truck4_city4-1,6986983,7,167,0,167,0
7_3990710,unload-truck_package4_truck4_city4-1,3990710,7,167,0,167,0
7_994437,unload-truck_package5_truck4_city4-1,994437,7,153,0,153,0
7_7744831,load-truck_package3_truck4_city4-1,7744831,7,171,0,171,0
7_4748558,load-truck_package4_truck4_city4-1,4748558,7,171,0,171,0
7_4005501,noop_city_city9,4005501,7,0,0,0,0
7_5227117,drive-truck_truck9_city9-1_city9-2_city9,5227117,7,24,0,24,0
7_2469652,drive-truck_truck9_city9-2_city9-1_city9,2469652,7,26,0,26,0
7_5896302,noop_at_plane4_city2-2,5896302,7,189,0,189,0
7_5852660,fly-airplane_plane4_city2-2_city4-2,5852660,7,203,0,203,0
7_6049268,fly-airplane_plane4_city2-2_city7-2,6049268,7,203,0,203,0
7_5787124,fly-airplane_plane4_city2-2_city3-2,5787124,7,203,0,203,0
7_5983732,fly-airplane_plane4_city2-2_city6-2,5983732,7,203,0,203,0
7_6180340,fly-airplane_plane4_city2-2_city9-2,6180340,7,203,0,203,0
7_5918196,fly-airplane_plane4_city2-2_city5-2,5918196,7,203,0,203,0
7_5656052,fly-airplane_plane4_city2-2_city1-2,5656052,7,203,0,203,0
7_7968830,fly-airplane_plane4_city2-2_city10-2,7968830,7,203,0,203,0
7_6114804,fly-airplane_plane4_city2-2_city8-2,6114804,7,203,0,203,0
7_1743447,unload-airplane_package1_plane4_city2-2,1743447,7,310,0,310,0
7_6748151,unload-airplane_package2_plane4_city2-2,6748151,7,283,0,283,0
7_3751878,unload-airplane_package3_plane4_city2-2,3751878,7,328,0,328,0
7_755605,unload-airplane_package4_plane4_city2-2,755605,7,328,0,328,0
7_5760309,unload-airplane_package5_plane4_city2-2,5760309,7,310,0,310,0
7_4756559,load-airplane_package1_plane4_city2-2,4756559,7,310,0,310,0
7_1760286,load-airplane_package2_plane4_city2-2,1760286,7,283,0,283,0
7_6764990,load-airplane_package3_plane4_city2-2,6764990,7,328,0,328,0
7_3768717,load-airplane_package4_plane4_city2-2,3768717,7,328,0,328,0
7_772444,load-airplane_package5_plane4_city2-2,772444,7,310,0,310,0
7_1111044,at_plane4_city6-2,1111044,7,27,9,36,0
7_712137,at_plane4_city10-2,712137,7,27,9,36,0
7_914436,at_plane4_city3-2,914436,7,27,9,36,0
7_1307652,at_plane4_city9-2,1307652,7,27,8,35,0
7_1045508,at_plane4_city5-2,1045508,7,27,9,36,0
7_783364,at_plane4_city1-2,783364,7,27,9,36,0
7_1242116,at_plane4_city8-2,1242116,7,27,9,36,0
7_979972,at_plane4_city4-2,979972,7,27,9,36,0
7_1176580,at_plane4_city7-2,1176580,7,27,9,36,0
7_7670415,noop_at_plane3_city10-2,7670415,7,189,0,189,0
7_4181684,fly-airplane_plane3_city10-2_city4-2,4181684,7,203,0,203,0
7_4378292,fly-airplane_plane3_city10-2_city7-2,4378292,7,203,0,203,0
7_4116148,fly-airplane_plane3_city10-2_city3-2,4116148,7,203,0,203,0
7_4312756,fly-airplane_plane3_city10-2_city6-2,4312756,7,203,0,203,0
7_4050612,fly-airplane_plane3_city10-2_city2-2,4050612,7,203,0,203,0
7_4509364,fly-airplane_plane3_city10-2_city9-2,4509364,7,203,0,203,0
7_4247220,fly-airplane_plane3_city10-2_city5-2,4247220,7,203,0,203,0
7_3985076,fly-airplane_plane3_city10-2_city1-2,3985076,7,203,0,203,0
7_4443828,fly-airplane_plane3_city10-2_city8-2,4443828,7,203,0,203,0
7_668499,unload-airplane_package1_plane3_city10-2,668499,7,310,0,310,0
7_1716403,unload-airplane_package2_plane3_city10-2,1716403,7,283,0,283,0
7_2764307,unload-airplane_package3_plane3_city10-2,2764307,7,328,0,328,0
7_3812211,unload-airplane_package4_plane3_city10-2,3812211,7,328,0,328,0
7_4860115,unload-airplane_package5_plane3_city10-2,4860115,7,310,0,310,0
7_3931379,load-airplane_package1_plane3_city10-2,3931379,7,310,0,310,0
7_4979283,load-airplane_package2_plane3_city10-2,4979283,7,283,0,283,0
7_6027187,load-airplane_package3_plane3_city10-2,6027187,7,328,0,328,0
7_7075091,load-airplane_package4_plane3_city10-2,7075091,7,328,0,328,0
7_122018,load-airplane_package5_plane3_city10-2,122018,7,310,0,310,0
7_4904399,at_plane3_city6-2,4904399,7,27,9,36,0
7_4707791,at_plane3_city3-2,4707791,7,27,9,36,0
7_4969935,at_plane3_city7-2,4969935,7,27,9,36,0
7_4642255,at_plane3_city2-2,4642255,7,27,8,35,0
7_5101007,at_plane3_city9-2,5101007,7,27,9,36,0
7_4838863,at_plane3_city5-2,4838863,7,27,9,36,0
7_4576719,at_plane3_city1-2,4576719,7,27,9,36,0
7_5035471,at_plane3_city8-2,5035471,7,27,9,36,0
7_4773327,at_plane3_city4-2,4773327,7,27,9,36,0
7_1230485,noop_at_package1_city6-2,1230485,7,135,0,135,0
7_396814,load-airplane_package1_plane1_city6-2,396814,7,311,0,311,0
7_4604436,load-airplane_package1_plane2_city6-2,4604436,7,311,0,311,0
7_811081,load-airplane_package1_plane3_city6-2,811081,7,311,0,311,0
7_5018703,load-airplane_package1_plane4_city6-2,5018703,7,311,0,311,0
7_6281740,load-truck_package1_truck6_city6-2,6281740,7,150,0,150,0
7_5646949,in_package1_plane4,5646949,7,44,33,77,0
7_5646948,in_package1_plane3,5646948,7,44,33,77,0
7_5646947,in_package1_plane2,5646947,7,44,33,77,0
7_5646946,in_package1_plane1,5646946,7,44,33,77,0
7_6889493,at_package1_city3-2,6889493,7,34,33,67,0
7_7151637,at_package1_city7-2,7151637,7,34,33,67,0
7_552683,in_package1_truck2,552683,7,28,33,61,0
7_6823956,at_package1_city2-1,6823956,7,26,33,59,0
7_6823957,at_package1_city2-2,6823957,7,34,33,67,0
7_7282709,at_package1_city9-2,7282709,7,34,33,67,0
7_7020565,at_package1_city5-2,7020565,7,34,33,67,0
7_6758421,at_package1_city1-2,6758421,7,34,33,67,0
7_2140122,at_package1_city10-2,2140122,7,34,33,67,0
7_7217173,at_package1_city8-2,7217173,7,34,33,67,0
7_6955029,at_package1_city4-2,6955029,7,34,33,67,0
7_5470031,in_package1_truck10,5470031,7,29,33,62,0
7_552682,in_package1_truck1,552682,7,29,33,62,0
7_552684,in_package1_truck3,552684,7,28,33,61,0
7_552685,in_package1_truck4,552685,7,29,33,62,0
7_552686,in_package1_truck5,552686,7,29,33,62,0
7_552687,in_package1_truck6,552687,7,29,33,62,0
7_552688,in_package1_truck7,552688,7,28,33,61,0
7_552689,in_package1_truck8,552689,7,29,33,62,0
7_552690,in_package1_truck9,552690,7,29,33,62,0
7_2839185,noop_location_city4-2,2839185,7,0,0,0,0
7_5253607,unload-airplane_package1_plane1_city4-2,5253607,7,310,0,310,0
7_1460252,unload-airplane_package1_plane2_city4-2,1460252,7,310,0,310,0
7_5667874,unload-airplane_package1_plane3_city4-2,5667874,7,310,0,310,0
7_1874519,unload-airplane_package1_plane4_city4-2,1874519,7,310,0,310,0
7_2257334,unload-airplane_package2_plane1_city4-2,2257334,7,283,0,283,0
7_6464956,unload-airplane_package2_plane2_city4-2,6464956,7,283,0,283,0
7_2671601,unload-airplane_package2_plane3_city4-2,2671601,7,283,0,283,0
7_6879223,unload-airplane_package2_plane4_city4-2,6879223,7,283,0,283,0
7_7262038,unload-airplane_package3_plane1_city4-2,7262038,7,328,0,328,0
7_3468683,unload-airplane_package3_plane2_city4-2,3468683,7,328,0,328,0
7_7676305,unload-airplane_package3_plane3_city4-2,7676305,7,328,0,328,0
7_3882950,unload-airplane_package3_plane4_city4-2,3882950,7,328,0,328,0
7_4265765,unload-airplane_package4_plane1_city4-2,4265765,7,328,0,328,0
7_472410,unload-airplane_package4_plane2_city4-2,472410,7,328,0,328,0
7_4680032,unload-airplane_package4_plane3_city4-2,4680032,7,328,0,328,0
7_886677,unload-airplane_package4_plane4_city4-2,886677,7,328,0,328,0
7_1269492,unload-airplane_package5_plane1_city4-2,1269492,7,310,0,310,0
7_5477114,unload-airplane_package5_plane2_city4-2,5477114,7,310,0,310,0
7_1683759,unload-airplane_package5_plane3_city4-2,1683759,7,310,0,310,0
7_5891381,unload-airplane_package5_plane4_city4-2,5891381,7,310,0,310,0
7_4978553,unload-truck_package1_truck4_city4-2,4978553,7,149,0,149,0
7_6986984,unload-truck_package3_truck4_city4-2,6986984,7,165,0,165,0
7_3990711,unload-truck_package4_truck4_city4-2,3990711,7,165,0,165,0
7_994438,unload-truck_package5_truck4_city4-2,994438,7,149,0,149,0
7_265742,load-airplane_package1_plane1_city4-2,265742,7,310,0,310,0
7_4473364,load-airplane_package1_plane2_city4-2,4473364,7,310,0,310,0
7_680009,load-airplane_package1_plane3_city4-2,680009,7,310,0,310,0
7_4887631,load-airplane_package1_plane4_city4-2,4887631,7,310,0,310,0
7_5270446,load-airplane_package2_plane1_city4-2,5270446,7,283,0,283,0
7_1477091,load-airplane_package2_plane2_city4-2,1477091,7,283,0,283,0
7_5684713,load-airplane_package2_plane3_city4-2,5684713,7,283,0,283,0
7_1891358,load-airplane_package2_plane4_city4-2,1891358,7,283,0,283,0
7_2274173,load-airplane_package3_plane1_city4-2,2274173,7,328,0,328,0
7_6481795,load-airplane_package3_plane2_city4-2,6481795,7,328,0,328,0
7_2688440,load-airplane_package3_plane3_city4-2,2688440,7,328,0,328,0
7_6896062,load-airplane_package3_plane4_city4-2,6896062,7,328,0,328,0
7_7278877,load-airplane_package4_plane1_city4-2,7278877,7,328,0,328,0
7_3485522,load-airplane_package4_plane2_city4-2,3485522,7,328,0,328,0
7_7693144,load-airplane_package4_plane3_city4-2,7693144,7,328,0,328,0
7_3899789,load-airplane_package4_plane4_city4-2,3899789,7,328,0,328,0
7_4282604,load-airplane_package5_plane1_city4-2,4282604,7,310,0,310,0
7_489249,load-airplane_package5_plane2_city4-2,489249,7,310,0,310,0
7_4696871,load-airplane_package5_plane3_city4-2,4696871,7,310,0,310,0
7_903516,load-airplane_package5_plane4_city4-2,903516,7,310,0,310,0
7_5736401,load-truck_package1_truck4_city4-2,5736401,7,149,0,149,0
7_2740128,load-truck_package2_truck4_city4-2,2740128,7,123,0,123,0
7_7744832,load-truck_package3_truck4_city4-2,7744832,7,165,0,165,0
7_4748559,load-truck_package4_truck4_city4-2,4748559,7,165,0,165,0
7_1752286,load-truck_package5_truck4_city4-2,1752286,7,149,0,149,0
7_5175963,noop_at_package2_city2-2,5175963,7,108,0,108,0
7_5139374,load-airplane_package2_plane1_city2-2,5139374,7,283,0,283,0
7_1346019,load-airplane_package2_plane2_city2-2,1346019,7,283,0,283,0
7_5553641,load-airplane_package2_plane3_city2-2,5553641,7,283,0,283,0
7_2194789,load-truck_package2_truck2_city2-2,2194789,7,124,0,124,0
7_3292746,at_package2_city6-2,3292746,7,24,24,48,0
7_4475740,in_package2_plane4,4475740,7,35,24,59,0
7_4475739,in_package2_plane3,4475739,7,35,24,59,0
7_4475738,in_package2_plane2,4475738,7,35,24,59,0
7_3096138,at_package2_city3-2,3096138,7,24,24,48,0
7_4475737,in_package2_plane1,4475737,7,35,24,59,0
7_7160436,at_package2_city10-2,7160436,7,25,24,49,0
7_7160435,at_package2_city10-1,7160435,7,17,24,41,0
7_3358282,at_package2_city7-2,3358282,7,24,24,48,0
7_1676676,in_package2_truck10,1676676,7,19,24,43,0
7_3161674,at_package2_city4-2,3161674,7,24,24,48,0
7_3423818,at_package2_city8-2,3423818,7,24,24,48,0
7_2965066,at_package2_city1-2,2965066,7,24,24,48,0
7_3227210,at_package2_city5-2,3227210,7,24,24,48,0
7_3489354,at_package2_city9-2,3489354,7,24,29,53,0
7_7198704,noop_in-city_city4-1_city4,7198704,7,0,0,0,0
7_6355054,noop_at_plane4_city9-2,6355054,7,189,0,189,0
7_1156223,fly-airplane_plane4_city9-2_city4-2,1156223,7,203,0,203,0
7_1352831,fly-airplane_plane4_city9-2_city7-2,1352831,7,203,0,203,0
7_1090687,fly-airplane_plane4_city9-2_city3-2,1090687,7,203,0,203,0
7_1287295,fly-airplane_plane4_city9-2_city6-2,1287295,7,203,0,203,0
7_1025151,fly-airplane_plane4_city9-2_city2-2,1025151,7,203,0,203,0
7_1221759,fly-airplane_plane4_city9-2_city5-2,1221759,7,203,0,203,0
7_959615,fly-airplane_plane4_city9-2_city1-2,959615,7,203,0,203,0
7_5827508,fly-airplane_plane4_city9-2_city10-2,5827508,7,203,0,203,0
7_1418367,fly-airplane_plane4_city9-2_city8-2,1418367,7,203,0,203,0
7_2202199,unload-airplane_package1_plane4_city9-2,2202199,7,310,0,310,0
7_7206903,unload-airplane_package2_plane4_city9-2,7206903,7,283,0,283,0
7_4210630,unload-airplane_package3_plane4_city9-2,4210630,7,328,0,328,0
7_1214357,unload-airplane_package4_plane4_city9-2,1214357,7,328,0,328,0
7_6219061,unload-airplane_package5_plane4_city9-2,6219061,7,310,0,310,0
7_5215311,load-airplane_package1_plane4_city9-2,5215311,7,310,0,310,0
7_2219038,load-airplane_package2_plane4_city9-2,2219038,7,283,0,283,0
7_7223742,load-airplane_package3_plane4_city9-2,7223742,7,328,0,328,0
7_4227469,load-airplane_package4_plane4_city9-2,4227469,7,328,0,328,0
7_1231196,load-airplane_package5_plane4_city9-2,1231196,7,310,0,310,0
7_848900,at_plane4_city2-2,848900,7,27,0,27,0
7_1208877,noop_at_plane1_city1-2,1208877,7,189,0,189,0
7_5665861,fly-airplane_plane1_city1-2_city4-2,5665861,7,203,0,203,0
7_5862469,fly-airplane_plane1_city1-2_city7-2,5862469,7,203,0,203,0
7_5600325,fly-airplane_plane1_city1-2_city3-2,5600325,7,203,0,203,0
7_5796933,fly-airplane_plane1_city1-2_city6-2,5796933,7,203,0,203,0
7_5534789,fly-airplane_plane1_city1-2_city2-2,5534789,7,203,0,203,0
7_5993541,fly-airplane_plane1_city1-2_city9-2,5993541,7,203,0,203,0
7_5731397,fly-airplane_plane1_city1-2_city5-2,5731397,7,203,0,203,0
7_153171,fly-airplane_plane1_city1-2_city10-2,153171,7,203,0,203,0
7_5928005,fly-airplane_plane1_city1-2_city8-2,5928005,7,203,0,203,0
7_5056999,unload-airplane_package1_plane1_city1-2,5056999,7,310,0,310,0
7_2060726,unload-airplane_package2_plane1_city1-2,2060726,7,283,0,283,0
7_7065430,unload-airplane_package3_plane1_city1-2,7065430,7,328,0,328,0
7_4069157,unload-airplane_package4_plane1_city1-2,4069157,7,328,0,328,0
7_1072884,unload-airplane_package5_plane1_city1-2,1072884,7,310,0,310,0
7_69134,load-airplane_package1_plane1_city1-2,69134,7,310,0,310,0
7_5073838,load-airplane_package2_plane1_city1-2,5073838,7,283,0,283,0
7_2077565,load-airplane_package3_plane1_city1-2,2077565,7,328,0,328,0
7_7082269,load-airplane_package4_plane1_city1-2,7082269,7,328,0,328,0
7_4085996,load-airplane_package5_plane1_city1-2,4085996,7,310,0,310,0
7_1653149,at_plane1_city10-2,1653149,7,27,9,36,0
7_4424596,at_plane1_city5-2,4424596,7,27,9,36,0
7_4686740,at_plane1_city9-2,4686740,7,27,9,36,0
7_4227988,at_plane1_city2-2,4227988,7,27,9,36,0
7_4621204,at_plane1_city8-2,4621204,7,27,8,35,0
7_4359060,at_plane1_city4-2,4359060,7,27,9,36,0
7_4555668,at_plane1_city7-2,4555668,7,27,9,36,0
7_4293524,at_plane1_city3-2,4293524,7,27,9,36,0
7_4490132,at_plane1_city6-2,4490132,7,27,9,36,0
7_1710287,noop_at_package3_city7-1,1710287,7,166,0,166,0
7_4562351,load-truck_package3_truck7_city7-1,4562351,7,171,0,171,0
7_6211249,in_package3_truck9,6211249,7,37,33,70,0
7_6211248,in_package3_truck8,6211248,7,37,33,70,0
7_5884298,in_package3_truck10,5884298,7,37,33,70,0
7_6211247,in_package3_truck7,6211247,7,37,33,70,0
7_7369296,at_package3_city4-2,7369296,7,43,33,76,0
7_6211246,in_package3_truck6,6211246,7,37,33,70,0
7_6211245,in_package3_truck5,6211245,7,37,33,70,0
7_7369295,at_package3_city4-1,7369295,7,38,34,72,0
7_6211244,in_package3_truck4,6211244,7,37,33,70,0
7_6211243,in_package3_truck3,6211243,7,37,33,70,0
7_6211242,in_package3_truck2,6211242,7,37,33,70,0
7_6211241,in_package3_truck1,6211241,7,37,33,70,0
7_7631440,at_package3_city8-2,7631440,7,43,33,76,0
7_7631439,at_package3_city8-1,7631439,7,38,34,72,0
7_7172688,at_package3_city1-2,7172688,7,43,33,76,0
7_7172687,at_package3_city1-1,7172687,7,37,35,72,0
7_7434832,at_package3_city5-2,7434832,7,43,33,76,0
7_3304531,in_package3_plane4,3304531,7,53,33,86,0
7_7434831,at_package3_city5-1,7434831,7,38,34,72,0
7_3304530,in_package3_plane3,3304530,7,53,33,86,0
7_3868829,in_package5_truck7,3868829,7,28,33,61,0
7_3304529,in_package3_plane2,3304529,7,53,33,86,0
7_3304528,in_package3_plane1,3304528,7,53,33,86,0
7_7696976,at_package3_city9-2,7696976,7,43,33,76,0
7_7696975,at_package3_city9-1,7696975,7,38,34,72,0
7_7238224,at_package3_city2-2,7238224,7,43,33,76,0
7_4179773,at_package3_city10-2,4179773,7,43,33,76,0
7_7238223,at_package3_city2-1,7238223,7,37,34,71,0
7_4179772,at_package3_city10-1,4179772,7,38,33,71,0
7_7500368,at_package3_city6-2,7500368,7,43,33,76,0
7_7500367,at_package3_city6-1,7500367,7,38,34,72,0
7_5915916,at_truck7_city7-2,5915916,7,4,3,7,0
7_7303760,at_package3_city3-2,7303760,7,43,33,76,0
7_7303759,at_package3_city3-1,7303759,7,35,33,68,0
7_7565904,at_package3_city7-2,7565904,7,43,32,75,0
7_5634715,noop_at_package2_city9-2,5634715,7,108,0,108,0
7_5598126,load-airplane_package2_plane1_city9-2,5598126,7,283,0,283,0
7_1804771,load-airplane_package2_plane2_city9-2,1804771,7,283,0,283,0
7_6012393,load-airplane_package2_plane3_city9-2,6012393,7,283,0,283,0
7_102987,load-truck_package2_truck9_city9-2,102987,7,123,0,123,0
7_3030602,at_package2_city2-2,3030602,7,24,24,48,0
7_5655765,noop_at_package4_city3-1,5655765,7,166,0,166,0
7_475400,load-truck_package4_truck3_city3-1,475400,7,171,0,171,0
7_3772549,at_package4_city7-2,3772549,7,43,33,76,0
7_3772548,at_package4_city7-1,3772548,7,35,33,68,0
7_2090943,in_package4_truck10,2090943,7,37,33,70,0
7_3575941,at_package4_city4-2,3575941,7,43,33,76,0
7_5040040,in_package4_truck9,5040040,7,37,33,70,0
7_3575940,at_package4_city4-1,3575940,7,38,34,72,0
7_5040039,in_package4_truck8,5040039,7,37,33,70,0
7_4825238,at_truck3_city3-2,4825238,7,4,3,7,0
7_5040038,in_package4_truck7,5040038,7,37,33,70,0
7_5040037,in_package4_truck6,5040037,7,37,33,70,0
7_5040036,in_package4_truck5,5040036,7,37,33,70,0
7_3838085,at_package4_city8-2,3838085,7,43,33,76,0
7_5040035,in_package4_truck4,5040035,7,37,33,70,0
7_5040034,in_package4_truck3,5040034,7,37,33,70,0
7_3838084,at_package4_city8-1,3838084,7,38,34,72,0
7_3379333,at_package4_city1-2,3379333,7,43,33,76,0
7_5040033,in_package4_truck2,5040033,7,37,33,70,0
7_5040032,in_package4_truck1,5040032,7,37,33,70,0
7_3379332,at_package4_city1-1,3379332,7,37,34,71,0
7_3641477,at_package4_city5-2,3641477,7,43,33,76,0
7_3641476,at_package4_city5-1,3641476,7,38,34,72,0
7_3868825,in_package5_truck3,3868825,7,28,33,61,0
7_2133322,in_package4_plane4,2133322,7,53,33,86,0
7_3903621,at_package4_city9-2,3903621,7,43,33,76,0
7_2133321,in_package4_plane3,2133321,7,53,33,86,0
7_2133320,in_package4_plane2,2133320,7,53,33,86,0
7_3903620,at_package4_city9-1,3903620,7,38,34,72,0
7_3444869,at_package4_city2-2,3444869,7,43,33,76,0
7_2133319,in_package4_plane1,2133319,7,53,33,86,0
7_3444868,at_package4_city2-1,3444868,7,37,34,71,0
7_3707013,at_package4_city6-2,3707013,7,43,33,76,0
7_3707012,at_package4_city6-1,3707012,7,38,35,73,0
7_1199110,at_package4_city10-2,1199110,7,43,33,76,0
7_1199109,at_package4_city10-1,1199109,7,38,33,71,0
7_3510405,at_package4_city3-2,3510405,7,43,33,76,0
7_1731338,noop_at_package5_city1-1,1731338,7,135,0,135,0
7_4934765,load-truck_package5_truck1_city1-1,4934765,7,150,0,150,0
7_7849099,at_package5_city5-2,7849099,7,34,33,67,0
7_7652491,at_package5_city2-2,7652491,7,34,33,67,0
7_7914635,at_package5_city6-2,7914635,7,34,33,67,0
7_7586955,at_package5_city1-2,7586955,7,34,32,66,0
7_962110,in_package5_plane1,962110,7,44,33,77,0
7_962111,in_package5_plane2,962111,7,44,33,77,0
7_962112,in_package5_plane3,962112,7,44,33,77,0
7_962113,in_package5_plane4,962113,7,44,33,77,0
7_7783563,at_package5_city4-2,7783563,7,34,38,72,0
7_6298565,in_package5_truck10,6298565,7,29,33,62,0
7_110266,at_package5_city9-2,110266,7,34,33,67,0
7_7980171,at_package5_city7-2,7980171,7,34,33,67,0
7_3868823,in_package5_truck1,3868823,7,28,33,61,0
7_3868824,in_package5_truck2,3868824,7,29,33,62,0
7_6219424,at_package5_city10-2,6219424,7,34,33,67,0
7_3868826,in_package5_truck4,3868826,7,29,33,62,0
7_3868827,in_package5_truck5,3868827,7,29,33,62,0
7_7718027,at_package5_city3-2,7718027,7,34,33,67,0
7_3868828,in_package5_truck6,3868828,7,29,33,62,0
7_3868830,in_package5_truck8,3868830,7,29,33,62,0
7_44730,at_package5_city8-2,44730,7,34,33,67,0
7_3868831,in_package5_truck9,3868831,7,29,33,62,0
7_3507679,noop_at_truck9_city9-1,3507679,7,12,0,12,0
7_2341411,unload-truck_package1_truck9_city9-1,2341411,7,153,0,153,0
7_4349842,unload-truck_package3_truck9_city9-1,4349842,7,167,0,167,0
7_1353569,unload-truck_package4_truck9_city9-1,1353569,7,167,0,167,0
7_6358273,unload-truck_package5_truck9_city9-1,6358273,7,153,0,153,0
7_5107690,load-truck_package3_truck9_city9-1,5107690,7,171,0,171,0
7_2111417,load-truck_package4_truck9_city9-1,2111417,7,171,0,171,0
7_6461255,at_truck9_city9-2,6461255,7,5,2,7,0
7_1627007,noop_airport_city4-2,1627007,7,0,0,0,0
7_4992707,fly-airplane_plane1_city4-2_city7-2,4992707,7,202,0,202,0
7_4730563,fly-airplane_plane1_city4-2_city3-2,4730563,7,202,0,202,0
7_4927171,fly-airplane_plane1_city4-2_city6-2,4927171,7,202,0,202,0
7_4665027,fly-airplane_plane1_city4-2_city2-2,4665027,7,202,0,202,0
7_5123779,fly-airplane_plane1_city4-2_city9-2,5123779,7,202,0,202,0
7_4861635,fly-airplane_plane1_city4-2_city5-2,4861635,7,202,0,202,0
7_4599491,fly-airplane_plane1_city4-2_city1-2,4599491,7,202,0,202,0
7_1521455,fly-airplane_plane1_city4-2_city10-2,1521455,7,202,0,202,0
7_5058243,fly-airplane_plane1_city4-2_city8-2,5058243,7,202,0,202,0
7_3926337,fly-airplane_plane1_city7-2_city4-2,3926337,7,202,0,202,0
7_7753012,fly-airplane_plane1_city3-2_city4-2,7753012,7,202,0,202,0
7_6883250,fly-airplane_plane1_city6-2_city4-2,6883250,7,202,0,202,0
7_2708948,fly-airplane_plane1_city2-2_city4-2,2708948,7,202,0,202,0
7_6013488,fly-airplane_plane1_city9-2_city4-2,6013488,7,202,0,202,0
7_1839186,fly-airplane_plane1_city5-2_city4-2,1839186,7,202,0,202,0
7_3720295,fly-airplane_plane1_city10-2_city4-2,3720295,7,202,0,202,0
7_969424,fly-airplane_plane1_city8-2_city4-2,969424,7,202,0,202,0
7_6040611,fly-airplane_plane2_city4-2_city7-2,6040611,7,202,0,202,0
7_5778467,fly-airplane_plane2_city4-2_city3-2,5778467,7,202,0,202,0
7_5975075,fly-airplane_plane2_city4-2_city6-2,5975075,7,202,0,202,0
7_5712931,fly-airplane_plane2_city4-2_city2-2,5712931,7,202,0,202,0
7_6171683,fly-airplane_plane2_city4-2_city9-2,6171683,7,202,0,202,0
7_5909539,fly-airplane_plane2_city4-2_city5-2,5909539,7,202,0,202,0
7_5647395,fly-airplane_plane2_city4-2_city1-2,5647395,7,202,0,202,0
7_5752638,fly-airplane_plane2_city4-2_city10-2,5752638,7,202,0,202,0
7_6106147,fly-airplane_plane2_city4-2_city8-2,6106147,7,202,0,202,0
7_4974241,fly-airplane_plane2_city7-2_city4-2,4974241,7,202,0,202,0
7_799939,fly-airplane_plane2_city3-2_city4-2,799939,7,202,0,202,0
7_7931154,fly-airplane_plane2_city6-2_city4-2,7931154,7,202,0,202,0
7_3756852,fly-airplane_plane2_city2-2_city4-2,3756852,7,202,0,202,0
7_7061392,fly-airplane_plane2_city9-2_city4-2,7061392,7,202,0,202,0
7_2887090,fly-airplane_plane2_city5-2_city4-2,2887090,7,202,0,202,0
7_6713765,fly-airplane_plane2_city1-2_city4-2,6713765,7,202,0,202,0
7_7951478,fly-airplane_plane2_city10-2_city4-2,7951478,7,202,0,202,0
7_2017328,fly-airplane_plane2_city8-2_city4-2,2017328,7,202,0,202,0
7_7088515,fly-airplane_plane3_city4-2_city7-2,7088515,7,202,0,202,0
7_6826371,fly-airplane_plane3_city4-2_city3-2,6826371,7,202,0,202,0
7_7022979,fly-airplane_plane3_city4-2_city6-2,7022979,7,202,0,202,0
7_6760835,fly-airplane_plane3_city4-2_city2-2,6760835,7,202,0,202,0
7_7219587,fly-airplane_plane3_city4-2_city9-2,7219587,7,202,0,202,0
7_6957443,fly-airplane_plane3_city4-2_city5-2,6957443,7,202,0,202,0
7_6695299,fly-airplane_plane3_city4-2_city1-2,6695299,7,202,0,202,0
7_1982844,fly-airplane_plane3_city4-2_city10-2,1982844,7,202,0,202,0
7_7154051,fly-airplane_plane3_city4-2_city8-2,7154051,7,202,0,202,0
7_6022145,fly-airplane_plane3_city7-2_city4-2,6022145,7,202,0,202,0
7_1847843,fly-airplane_plane3_city3-2_city4-2,1847843,7,202,0,202,0
7_978081,fly-airplane_plane3_city6-2_city4-2,978081,7,202,0,202,0
7_4804756,fly-airplane_plane3_city2-2_city4-2,4804756,7,202,0,202,0
7_108319,fly-airplane_plane3_city9-2_city4-2,108319,7,202,0,202,0
7_3934994,fly-airplane_plane3_city5-2_city4-2,3934994,7,202,0,202,0
7_7761669,fly-airplane_plane3_city1-2_city4-2,7761669,7,202,0,202,0
7_3065232,fly-airplane_plane3_city8-2_city4-2,3065232,7,202,0,202,0
7_135442,fly-airplane_plane4_city4-2_city7-2,135442,7,202,0,202,0
7_7874275,fly-airplane_plane4_city4-2_city3-2,7874275,7,202,0,202,0
7_69906,fly-airplane_plane4_city4-2_city6-2,69906,7,202,0,202,0
7_7808739,fly-airplane_plane4_city4-2_city2-2,7808739,7,202,0,202,0
7_266514,fly-airplane_plane4_city4-2_city9-2,266514,7,202,0,202,0
7_4370,fly-airplane_plane4_city4-2_city5-2,4370,7,202,0,202,0
7_7743203,fly-airplane_plane4_city4-2_city1-2,7743203,7,202,0,202,0
7_6214027,fly-airplane_plane4_city4-2_city10-2,6214027,7,202,0,202,0
7_200978,fly-airplane_plane4_city4-2_city8-2,200978,7,202,0,202,0
7_7070049,fly-airplane_plane4_city7-2_city4-2,7070049,7,202,0,202,0
7_2895747,fly-airplane_plane4_city3-2_city4-2,2895747,7,202,0,202,0
7_2025985,fly-airplane_plane4_city6-2_city4-2,2025985,7,202,0,202,0
7_4982898,fly-airplane_plane4_city5-2_city4-2,4982898,7,202,0,202,0
7_808596,fly-airplane_plane4_city1-2_city4-2,808596,7,202,0,202,0
7_411890,fly-airplane_plane4_city10-2_city4-2,411890,7,202,0,202,0
7_4113136,fly-airplane_plane4_city8-2_city4-2,4113136,7,202,0,202,0
7_1667629,noop_at_plane1_city8-2,1667629,7,189,0,189,0
7_1166032,fly-airplane_plane1_city8-2_city7-2,1166032,7,203,0,203,0
7_903888,fly-airplane_plane1_city8-2_city3-2,903888,7,203,0,203,0
7_1100496,fly-airplane_plane1_city8-2_city6-2,1100496,7,203,0,203,0
7_838352,fly-airplane_plane1_city8-2_city2-2,838352,7,203,0,203,0
7_1297104,fly-airplane_plane1_city8-2_city9-2,1297104,7,203,0,203,0
7_1034960,fly-airplane_plane1_city8-2_city5-2,1034960,7,203,0,203,0
7_772816,fly-airplane_plane1_city8-2_city1-2,772816,7,203,0,203,0
7_6012826,fly-airplane_plane1_city8-2_city10-2,6012826,7,203,0,203,0
7_5515751,unload-airplane_package1_plane1_city8-2,5515751,7,310,0,310,0
7_2519478,unload-airplane_package2_plane1_city8-2,2519478,7,283,0,283,0
7_7524182,unload-airplane_package3_plane1_city8-2,7524182,7,328,0,328,0
7_4527909,unload-airplane_package4_plane1_city8-2,4527909,7,328,0,328,0
7_1531636,unload-airplane_package5_plane1_city8-2,1531636,7,310,0,310,0
7_527886,load-airplane_package1_plane1_city8-2,527886,7,310,0,310,0
7_5532590,load-airplane_package2_plane1_city8-2,5532590,7,283,0,283,0
7_2536317,load-airplane_package3_plane1_city8-2,2536317,7,328,0,328,0
7_7541021,load-airplane_package4_plane1_city8-2,7541021,7,328,0,328,0
7_4544748,load-airplane_package5_plane1_city8-2,4544748,7,310,0,310,0
7_4162452,at_plane1_city1-2,4162452,7,27,0,27,0
7_1710288,noop_at_package3_city7-2,1710288,7,153,0,153,0
7_2470781,load-airplane_package3_plane1_city7-2,2470781,7,329,0,329,0
7_6678403,load-airplane_package3_plane2_city7-2,6678403,7,329,0,329,0
7_2885048,load-airplane_package3_plane3_city7-2,2885048,7,329,0,329,0
7_7092670,load-airplane_package3_plane4_city7-2,7092670,7,329,0,329,0
7_4562352,load-truck_package3_truck7_city7-2,4562352,7,165,0,165,0
7_7565903,at_package3_city7-1,7565903,7,38,4,42,0
7_1731339,noop_at_package5_city1-2,1731339,7,135,0,135,0
7_292641,load-airplane_package5_plane2_city1-2,292641,7,311,0,311,0
7_4500263,load-airplane_package5_plane3_city1-2,4500263,7,311,0,311,0
7_706908,load-airplane_package5_plane4_city1-2,706908,7,311,0,311,0
7_4934766,load-truck_package5_truck1_city1-2,4934766,7,150,0,150,0
7_7586954,at_package5_city1-1,7586954,7,26,4,30,0
7_3507680,noop_at_truck9_city9-2,3507680,7,11,0,11,0
7_2341412,unload-truck_package1_truck9_city9-2,2341412,7,149,0,149,0
7_4349843,unload-truck_package3_truck9_city9-2,4349843,7,165,0,165,0
7_1353570,unload-truck_package4_truck9_city9-2,1353570,7,165,0,165,0
7_6358274,unload-truck_package5_truck9_city9-2,6358274,7,149,0,149,0
7_3099260,load-truck_package1_truck9_city9-2,3099260,7,149,0,149,0
7_5107691,load-truck_package3_truck9_city9-2,5107691,7,165,0,165,0
7_2111418,load-truck_package4_truck9_city9-2,2111418,7,165,0,165,0
7_7116122,load-truck_package5_truck9_city9-2,7116122,7,149,0,149,0
7_6461254,at_truck9_city9-1,6461254,7,3,1,4,0
7_1688680,noop_at_plane3_city2-2,1688680,7,189,0,189,0
7_5001364,fly-airplane_plane3_city2-2_city7-2,5001364,7,203,0,203,0
7_4739220,fly-airplane_plane3_city2-2_city3-2,4739220,7,203,0,203,0
7_4935828,fly-airplane_plane3_city2-2_city6-2,4935828,7,203,0,203,0
7_5132436,fly-airplane_plane3_city2-2_city9-2,5132436,7,203,0,203,0
7_4870292,fly-airplane_plane3_city2-2_city5-2,4870292,7,203,0,203,0
7_4608148,fly-airplane_plane3_city2-2_city1-2,4608148,7,203,0,203,0
7_3737647,fly-airplane_plane3_city2-2_city10-2,3737647,7,203,0,203,0
7_5066900,fly-airplane_plane3_city2-2_city8-2,5066900,7,203,0,203,0
7_5536802,unload-airplane_package1_plane3_city2-2,5536802,7,310,0,310,0
7_2540529,unload-airplane_package2_plane3_city2-2,2540529,7,283,0,283,0
7_7545233,unload-airplane_package3_plane3_city2-2,7545233,7,328,0,328,0
7_4548960,unload-airplane_package4_plane3_city2-2,4548960,7,328,0,328,0
7_1552687,unload-airplane_package5_plane3_city2-2,1552687,7,310,0,310,0
7_548937,load-airplane_package1_plane3_city2-2,548937,7,310,0,310,0
7_2557368,load-airplane_package3_plane3_city2-2,2557368,7,328,0,328,0
7_7562072,load-airplane_package4_plane3_city2-2,7562072,7,328,0,328,0
7_4565799,load-airplane_package5_plane3_city2-2,4565799,7,310,0,310,0
7_3692800,at_plane3_city10-2,3692800,7,27,0,27,0
7_5613107,noop_at_plane2_city4-2,5613107,7,189,0,189,0
7_827849,at_plane2_city8-2,827849,7,27,9,36,0
7_369097,at_plane2_city1-2,369097,7,27,9,36,0
7_631241,at_plane2_city5-2,631241,7,27,9,36,0
7_893385,at_plane2_city9-2,893385,7,27,9,36,0
7_434633,at_plane2_city2-2,434633,7,27,9,36,0
7_762313,at_plane2_city7-2,762313,7,27,8,35,0
7_6673463,at_plane2_city10-2,6673463,7,27,9,36,0
7_500169,at_plane2_city3-2,500169,7,27,9,36,0
7_696777,at_plane2_city6-2,696777,7,27,9,36,0
7_5655766,noop_at_package4_city3-2,5655766,7,153,0,153,0
7_7213341,load-airplane_package4_plane1_city3-2,7213341,7,329,0,329,0
7_3419986,load-airplane_package4_plane2_city3-2,3419986,7,329,0,329,0
7_7627608,load-airplane_package4_plane3_city3-2,7627608,7,329,0,329,0
7_3834253,load-airplane_package4_plane4_city3-2,3834253,7,329,0,329,0
7_475401,load-truck_package4_truck3_city3-2,475401,7,165,0,165,0
7_3510404,at_package4_city3-1,3510404,7,38,5,43,0
7_968340,noop_at_package1_city2-1,968340,7,135,0,135,0
7_5191061,load-truck_package1_truck2_city2-1,5191061,7,150,0,150,0
7_7086101,at_package1_city6-2,7086101,7,34,32,66,0
7_2991081,noop_in-city_city3-1_city3,2991081,7,0,0,0,0
7_5371146,drive-truck_truck3_city3-1_city3-2_city3,5371146,7,24,0,24,0
7_2613681,drive-truck_truck3_city3-2_city3-1_city3,2613681,7,25,0,25,0
7_968341,noop_at_package1_city2-2,968341,7,135,0,135,0
7_134670,load-airplane_package1_plane1_city2-2,134670,7,311,0,311,0
7_4342292,load-airplane_package1_plane2_city2-2,4342292,7,311,0,311,0
7_5191062,load-truck_package1_truck2_city2-2,5191062,7,150,0,150,0
7_6690159,noop_at_truck6_city6-1,6690159,7,12,0,12,0
7_1298643,drive-truck_truck6_city6-1_city6-2_city6,1298643,7,25,0,25,0
7_5523891,unload-truck_package1_truck6_city6-1,5523891,7,153,0,153,0
7_7532322,unload-truck_package3_truck6_city6-1,7532322,7,167,0,167,0
7_4536049,unload-truck_package4_truck6_city6-1,4536049,7,167,0,167,0
7_1539776,unload-truck_package5_truck6_city6-1,1539776,7,153,0,153,0
7_289193,load-truck_package3_truck6_city6-1,289193,7,171,0,171,0
7_5293897,load-truck_package4_truck6_city6-1,5293897,7,171,0,171,0
7_1642758,at_truck6_city6-2,1642758,7,5,3,8,0
7_2147432,noop_at_plane3_city9-2,2147432,7,189,0,189,0
7_304927,fly-airplane_plane3_city9-2_city7-2,304927,7,203,0,203,0
7_42783,fly-airplane_plane3_city9-2_city3-2,42783,7,203,0,203,0
7_239391,fly-airplane_plane3_city9-2_city6-2,239391,7,203,0,203,0
7_7978224,fly-airplane_plane3_city9-2_city2-2,7978224,7,203,0,203,0
7_173855,fly-airplane_plane3_city9-2_city5-2,173855,7,203,0,203,0
7_7912688,fly-airplane_plane3_city9-2_city1-2,7912688,7,203,0,203,0
7_1596325,fly-airplane_plane3_city9-2_city10-2,1596325,7,203,0,203,0
7_370463,fly-airplane_plane3_city9-2_city8-2,370463,7,203,0,203,0
7_5995554,unload-airplane_package1_plane3_city9-2,5995554,7,310,0,310,0
7_2999281,unload-airplane_package2_plane3_city9-2,2999281,7,283,0,283,0
7_3008,unload-airplane_package3_plane3_city9-2,3008,7,328,0,328,0
7_5007712,unload-airplane_package4_plane3_city9-2,5007712,7,328,0,328,0
7_2011439,unload-airplane_package5_plane3_city9-2,2011439,7,310,0,310,0
7_1007689,load-airplane_package1_plane3_city9-2,1007689,7,310,0,310,0
7_3016120,load-airplane_package3_plane3_city9-2,3016120,7,328,0,328,0
7_19847,load-airplane_package4_plane3_city9-2,19847,7,328,0,328,0
7_5024551,load-airplane_package5_plane3_city9-2,5024551,7,310,0,310,0
7_3035792,noop_location_city7-1,3035792,7,0,0,0,0
7_7942119,drive-truck_truck7_city7-1_city7-2_city7,7942119,7,24,0,24,0
7_5184654,drive-truck_truck7_city7-2_city7-1_city7,5184654,7,25,0,25,0
7_1796072,unload-truck_package1_truck7_city7-1,1796072,7,151,0,151,0
7_3804503,unload-truck_package3_truck7_city7-1,3804503,7,167,0,167,0
7_808230,unload-truck_package4_truck7_city7-1,808230,7,167,0,167,0
7_5812934,unload-truck_package5_truck7_city7-1,5812934,7,151,0,151,0
7_1566078,load-truck_package4_truck7_city7-1,1566078,7,167,0,167,0
7_6690160,noop_at_truck6_city6-2,6690160,7,11,0,11,0
7_6542155,drive-truck_truck6_city6-2_city6-1_city6,6542155,7,27,0,27,0
7_5523892,unload-truck_package1_truck6_city6-2,5523892,7,149,0,149,0
7_7532323,unload-truck_package3_truck6_city6-2,7532323,7,165,0,165,0
7_4536050,unload-truck_package4_truck6_city6-2,4536050,7,165,0,165,0
7_1539777,unload-truck_package5_truck6_city6-2,1539777,7,149,0,149,0
7_3285467,load-truck_package2_truck6_city6-2,3285467,7,123,0,123,0
7_289194,load-truck_package3_truck6_city6-2,289194,7,165,0,165,0
7_5293898,load-truck_package4_truck6_city6-2,5293898,7,165,0,165,0
7_2297625,load-truck_package5_truck6_city6-2,2297625,7,149,0,149,0
7_1642757,at_truck6_city6-1,1642757,7,3,2,5,0
7_6092910,noop_at_plane4_city5-2,6092910,7,189,0,189,0
7_5179506,fly-airplane_plane4_city5-2_city7-2,5179506,7,203,0,203,0
7_4917362,fly-airplane_plane4_city5-2_city3-2,4917362,7,203,0,203,0
7_5113970,fly-airplane_plane4_city5-2_city6-2,5113970,7,203,0,203,0
7_4851826,fly-airplane_plane4_city5-2_city2-2,4851826,7,203,0,203,0
7_5310578,fly-airplane_plane4_city5-2_city9-2,5310578,7,203,0,203,0
7_4786290,fly-airplane_plane4_city5-2_city1-2,4786290,7,203,0,203,0
7_1336137,fly-airplane_plane4_city5-2_city10-2,1336137,7,203,0,203,0
7_5245042,fly-airplane_plane4_city5-2_city8-2,5245042,7,203,0,203,0
7_1940055,unload-airplane_package1_plane4_city5-2,1940055,7,310,0,310,0
7_6944759,unload-airplane_package2_plane4_city5-2,6944759,7,283,0,283,0
7_3948486,unload-airplane_package3_plane4_city5-2,3948486,7,328,0,328,0
7_952213,unload-airplane_package4_plane4_city5-2,952213,7,328,0,328,0
7_5956917,unload-airplane_package5_plane4_city5-2,5956917,7,310,0,310,0
7_4953167,load-airplane_package1_plane4_city5-2,4953167,7,310,0,310,0
7_1956894,load-airplane_package2_plane4_city5-2,1956894,7,283,0,283,0
7_6961598,load-airplane_package3_plane4_city5-2,6961598,7,328,0,328,0
7_3965325,load-airplane_package4_plane4_city5-2,3965325,7,328,0,328,0
7_969052,load-airplane_package5_plane4_city5-2,969052,7,310,0,310,0
7_6345089,noop_at_package4_city10-1,6345089,7,167,0,167,0
7_7866347,load-truck_package4_truck10_city10-1,7866347,7,172,0,172,0
7_3973470,at_truck10_city10-2,3973470,7,5,2,7,0
7_1427093,noop_at_package1_city9-2,1427093,7,135,0,135,0
7_593422,load-airplane_package1_plane1_city9-2,593422,7,311,0,311,0
7_4801044,load-airplane_package1_plane2_city9-2,4801044,7,311,0,311,0
7_1448143,noop_at_package3_city3-1,1448143,7,153,0,153,0
7_3471673,load-truck_package3_truck3_city3-1,3471673,7,168,0,168,0
7_3035793,noop_location_city7-2,3035793,7,0,0,0,0
7_5450215,unload-airplane_package1_plane1_city7-2,5450215,7,310,0,310,0
7_1656860,unload-airplane_package1_plane2_city7-2,1656860,7,310,0,310,0
7_5864482,unload-airplane_package1_plane3_city7-2,5864482,7,310,0,310,0
7_2071127,unload-airplane_package1_plane4_city7-2,2071127,7,310,0,310,0
7_2453942,unload-airplane_package2_plane1_city7-2,2453942,7,283,0,283,0
7_6661564,unload-airplane_package2_plane2_city7-2,6661564,7,283,0,283,0
7_2868209,unload-airplane_package2_plane3_city7-2,2868209,7,283,0,283,0
7_7075831,unload-airplane_package2_plane4_city7-2,7075831,7,283,0,283,0
7_7458646,unload-airplane_package3_plane1_city7-2,7458646,7,328,0,328,0
7_3665291,unload-airplane_package3_plane2_city7-2,3665291,7,328,0,328,0
7_7872913,unload-airplane_package3_plane3_city7-2,7872913,7,328,0,328,0
7_4079558,unload-airplane_package3_plane4_city7-2,4079558,7,328,0,328,0
7_4462373,unload-airplane_package4_plane1_city7-2,4462373,7,328,0,328,0
7_669018,unload-airplane_package4_plane2_city7-2,669018,7,328,0,328,0
7_4876640,unload-airplane_package4_plane3_city7-2,4876640,7,328,0,328,0
7_1083285,unload-airplane_package4_plane4_city7-2,1083285,7,328,0,328,0
7_1466100,unload-airplane_package5_plane1_city7-2,1466100,7,310,0,310,0
7_5673722,unload-airplane_package5_plane2_city7-2,5673722,7,310,0,310,0
7_1880367,unload-airplane_package5_plane3_city7-2,1880367,7,310,0,310,0
7_6087989,unload-airplane_package5_plane4_city7-2,6087989,7,310,0,310,0
7_1796073,unload-truck_package1_truck7_city7-2,1796073,7,148,0,148,0
7_3804504,unload-truck_package3_truck7_city7-2,3804504,7,164,0,164,0
7_808231,unload-truck_package4_truck7_city7-2,808231,7,165,0,165,0
7_5812935,unload-truck_package5_truck7_city7-2,5812935,7,148,0,148,0
7_462350,load-airplane_package1_plane1_city7-2,462350,7,310,0,310,0
7_4669972,load-airplane_package1_plane2_city7-2,4669972,7,310,0,310,0
7_876617,load-airplane_package1_plane3_city7-2,876617,7,310,0,310,0
7_5084239,load-airplane_package1_plane4_city7-2,5084239,7,310,0,310,0
7_5467054,load-airplane_package2_plane1_city7-2,5467054,7,283,0,283,0
7_1673699,load-airplane_package2_plane2_city7-2,1673699,7,283,0,283,0
7_5881321,load-airplane_package2_plane3_city7-2,5881321,7,283,0,283,0
7_2087966,load-airplane_package2_plane4_city7-2,2087966,7,283,0,283,0
7_7475485,load-airplane_package4_plane1_city7-2,7475485,7,328,0,328,0
7_3682130,load-airplane_package4_plane2_city7-2,3682130,7,328,0,328,0
7_7889752,load-airplane_package4_plane3_city7-2,7889752,7,328,0,328,0
7_4096397,load-airplane_package4_plane4_city7-2,4096397,7,328,0,328,0
7_4479212,load-airplane_package5_plane1_city7-2,4479212,7,310,0,310,0
7_685857,load-airplane_package5_plane2_city7-2,685857,7,310,0,310,0
7_4893479,load-airplane_package5_plane3_city7-2,4893479,7,310,0,310,0
7_1100124,load-airplane_package5_plane4_city7-2,1100124,7,310,0,310,0
7_2553921,load-truck_package1_truck7_city7-2,2553921,7,148,0,148,0
7_7558625,load-truck_package2_truck7_city7-2,7558625,7,122,0,122,0
7_1566079,load-truck_package4_truck7_city7-2,1566079,7,165,0,165,0
7_6570783,load-truck_package5_truck7_city7-2,6570783,7,148,0,148,0
7_5372571,noop_at_package2_city5-2,5372571,7,108,0,108,0
7_5335982,load-airplane_package2_plane1_city5-2,5335982,7,283,0,283,0
7_1542627,load-airplane_package2_plane2_city5-2,1542627,7,283,0,283,0
7_5750249,load-airplane_package2_plane3_city5-2,5750249,7,283,0,283,0
7_7013286,load-truck_package2_truck5_city5-2,7013286,7,123,0,123,0
7_4939725,noop_in_package5_plane1,4939725,7,135,0,135,0
7_1203956,unload-airplane_package5_plane1_city3-2,1203956,7,311,0,311,0
7_1400564,unload-airplane_package5_plane1_city6-2,1400564,7,311,0,311,0
7_1138420,unload-airplane_package5_plane1_city2-2,1138420,7,311,0,311,0
7_1597172,unload-airplane_package5_plane1_city9-2,1597172,7,311,0,311,0
7_1335028,unload-airplane_package5_plane1_city5-2,1335028,7,311,0,311,0
7_2820464,unload-airplane_package5_plane1_city10-2,2820464,7,311,0,311,0
7_1448144,noop_at_package3_city3-2,1448144,7,153,0,153,0
7_2208637,load-airplane_package3_plane1_city3-2,2208637,7,329,0,329,0
7_6416259,load-airplane_package3_plane2_city3-2,6416259,7,329,0,329,0
7_2622904,load-airplane_package3_plane3_city3-2,2622904,7,329,0,329,0
7_6830526,load-airplane_package3_plane4_city3-2,6830526,7,329,0,329,0
7_3471674,load-truck_package3_truck3_city3-2,3471674,7,166,0,166,0
7_767485,noop_in-city_city3-2_city3,767485,7,0,0,0,0
7_5018863,noop_airplane_plane1,5018863,7,0,0,0,0
7_3860801,fly-airplane_plane1_city7-2_city3-2,3860801,7,202,0,202,0
7_4057409,fly-airplane_plane1_city7-2_city6-2,4057409,7,202,0,202,0
7_3795265,fly-airplane_plane1_city7-2_city2-2,3795265,7,202,0,202,0
7_4254017,fly-airplane_plane1_city7-2_city9-2,4254017,7,202,0,202,0
7_3991873,fly-airplane_plane1_city7-2_city5-2,3991873,7,202,0,202,0
7_3729729,fly-airplane_plane1_city7-2_city1-2,3729729,7,202,0,202,0
7_2889739,fly-airplane_plane1_city7-2_city10-2,2889739,7,202,0,202,0
7_4188481,fly-airplane_plane1_city7-2_city8-2,4188481,7,202,0,202,0
7_7949620,fly-airplane_plane1_city3-2_city7-2,7949620,7,202,0,202,0
7_7884084,fly-airplane_plane1_city3-2_city6-2,7884084,7,202,0,202,0
7_7621940,fly-airplane_plane1_city3-2_city2-2,7621940,7,202,0,202,0
7_79715,fly-airplane_plane1_city3-2_city9-2,79715,7,202,0,202,0
7_7818548,fly-airplane_plane1_city3-2_city5-2,7818548,7,202,0,202,0
7_7556404,fly-airplane_plane1_city3-2_city1-2,7556404,7,202,0,202,0
7_6399345,fly-airplane_plane1_city3-2_city10-2,6399345,7,202,0,202,0
7_14179,fly-airplane_plane1_city3-2_city8-2,14179,7,202,0,202,0
7_7079858,fly-airplane_plane1_city6-2_city7-2,7079858,7,202,0,202,0
7_6817714,fly-airplane_plane1_city6-2_city3-2,6817714,7,202,0,202,0
7_6752178,fly-airplane_plane1_city6-2_city2-2,6752178,7,202,0,202,0
7_7210930,fly-airplane_plane1_city6-2_city9-2,7210930,7,202,0,202,0
7_6948786,fly-airplane_plane1_city6-2_city5-2,6948786,7,202,0,202,0
7_6686642,fly-airplane_plane1_city6-2_city1-2,6686642,7,202,0,202,0
7_7767629,fly-airplane_plane1_city6-2_city10-2,7767629,7,202,0,202,0
7_7145394,fly-airplane_plane1_city6-2_city8-2,7145394,7,202,0,202,0
7_2905556,fly-airplane_plane1_city2-2_city7-2,2905556,7,202,0,202,0
7_2643412,fly-airplane_plane1_city2-2_city3-2,2643412,7,202,0,202,0
7_2840020,fly-airplane_plane1_city2-2_city6-2,2840020,7,202,0,202,0
7_3036628,fly-airplane_plane1_city2-2_city9-2,3036628,7,202,0,202,0
7_2774484,fly-airplane_plane1_city2-2_city5-2,2774484,7,202,0,202,0
7_2512340,fly-airplane_plane1_city2-2_city1-2,2512340,7,202,0,202,0
7_3276258,fly-airplane_plane1_city2-2_city10-2,3276258,7,202,0,202,0
7_2971092,fly-airplane_plane1_city2-2_city8-2,2971092,7,202,0,202,0
7_6210096,fly-airplane_plane1_city9-2_city7-2,6210096,7,202,0,202,0
7_5947952,fly-airplane_plane1_city9-2_city3-2,5947952,7,202,0,202,0
7_6144560,fly-airplane_plane1_city9-2_city6-2,6144560,7,202,0,202,0
7_5882416,fly-airplane_plane1_city9-2_city2-2,5882416,7,202,0,202,0
7_6079024,fly-airplane_plane1_city9-2_city5-2,6079024,7,202,0,202,0
7_5816880,fly-airplane_plane1_city9-2_city1-2,5816880,7,202,0,202,0
7_1134936,fly-airplane_plane1_city9-2_city10-2,1134936,7,202,0,202,0
7_6275632,fly-airplane_plane1_city9-2_city8-2,6275632,7,202,0,202,0
7_2035794,fly-airplane_plane1_city5-2_city7-2,2035794,7,202,0,202,0
7_1773650,fly-airplane_plane1_city5-2_city3-2,1773650,7,202,0,202,0
7_1970258,fly-airplane_plane1_city5-2_city6-2,1970258,7,202,0,202,0
7_1708114,fly-airplane_plane1_city5-2_city2-2,1708114,7,202,0,202,0
7_2166866,fly-airplane_plane1_city5-2_city9-2,2166866,7,202,0,202,0
7_1642578,fly-airplane_plane1_city5-2_city1-2,1642578,7,202,0,202,0
7_4644542,fly-airplane_plane1_city5-2_city10-2,4644542,7,202,0,202,0
7_2101330,fly-airplane_plane1_city5-2_city8-2,2101330,7,202,0,202,0
7_3916903,fly-airplane_plane1_city10-2_city7-2,3916903,7,202,0,202,0
7_3654759,fly-airplane_plane1_city10-2_city3-2,3654759,7,202,0,202,0
7_3851367,fly-airplane_plane1_city10-2_city6-2,3851367,7,202,0,202,0
7_3589223,fly-airplane_plane1_city10-2_city2-2,3589223,7,202,0,202,0
7_4047975,fly-airplane_plane1_city10-2_city9-2,4047975,7,202,0,202,0
7_3785831,fly-airplane_plane1_city10-2_city5-2,3785831,7,202,0,202,0
7_3523687,fly-airplane_plane1_city10-2_city1-2,3523687,7,202,0,202,0
7_3982439,fly-airplane_plane1_city10-2_city8-2,3982439,7,202,0,202,0
7_5188071,unload-airplane_package1_plane1_city3-2,5188071,7,310,0,310,0
7_5384679,unload-airplane_package1_plane1_city6-2,5384679,7,310,0,310,0
7_5122535,unload-airplane_package1_plane1_city2-2,5122535,7,310,0,310,0
7_5581287,unload-airplane_package1_plane1_city9-2,5581287,7,310,0,310,0
7_5319143,unload-airplane_package1_plane1_city5-2,5319143,7,310,0,310,0
7_6629825,unload-airplane_package1_plane1_city10-2,6629825,7,310,0,310,0
7_2191798,unload-airplane_package2_plane1_city3-2,2191798,7,283,0,283,0
7_2388406,unload-airplane_package2_plane1_city6-2,2388406,7,283,0,283,0
7_2126262,unload-airplane_package2_plane1_city2-2,2126262,7,283,0,283,0
7_2585014,unload-airplane_package2_plane1_city9-2,2585014,7,283,0,283,0
7_2322870,unload-airplane_package2_plane1_city5-2,2322870,7,283,0,283,0
7_7677729,unload-airplane_package2_plane1_city10-2,7677729,7,283,0,283,0
7_7196502,unload-airplane_package3_plane1_city3-2,7196502,7,328,0,328,0
7_7393110,unload-airplane_package3_plane1_city6-2,7393110,7,328,0,328,0
7_7130966,unload-airplane_package3_plane1_city2-2,7130966,7,328,0,328,0
7_7589718,unload-airplane_package3_plane1_city9-2,7589718,7,328,0,328,0
7_7327574,unload-airplane_package3_plane1_city5-2,7327574,7,328,0,328,0
7_724656,unload-airplane_package3_plane1_city10-2,724656,7,328,0,328,0
7_4200229,unload-airplane_package4_plane1_city3-2,4200229,7,328,0,328,0
7_4396837,unload-airplane_package4_plane1_city6-2,4396837,7,328,0,328,0
7_4134693,unload-airplane_package4_plane1_city2-2,4134693,7,328,0,328,0
7_4593445,unload-airplane_package4_plane1_city9-2,4593445,7,328,0,328,0
7_4331301,unload-airplane_package4_plane1_city5-2,4331301,7,328,0,328,0
7_1772560,unload-airplane_package4_plane1_city10-2,1772560,7,328,0,328,0
7_200206,load-airplane_package1_plane1_city3-2,200206,7,310,0,310,0
7_331278,load-airplane_package1_plane1_city5-2,331278,7,310,0,310,0
7_1891728,load-airplane_package1_plane1_city10-2,1891728,7,310,0,310,0
7_5204910,load-airplane_package2_plane1_city3-2,5204910,7,283,0,283,0
7_5401518,load-airplane_package2_plane1_city6-2,5401518,7,283,0,283,0
7_2939632,load-airplane_package2_plane1_city10-2,2939632,7,283,0,283,0
7_2405245,load-airplane_package3_plane1_city6-2,2405245,7,328,0,328,0
7_2143101,load-airplane_package3_plane1_city2-2,2143101,7,328,0,328,0
7_2601853,load-airplane_package3_plane1_city9-2,2601853,7,328,0,328,0
7_2339709,load-airplane_package3_plane1_city5-2,2339709,7,328,0,328,0
7_3987536,load-airplane_package3_plane1_city10-2,3987536,7,328,0,328,0
7_7409949,load-airplane_package4_plane1_city6-2,7409949,7,328,0,328,0
7_7147805,load-airplane_package4_plane1_city2-2,7147805,7,328,0,328,0
7_7606557,load-airplane_package4_plane1_city9-2,7606557,7,328,0,328,0
7_7344413,load-airplane_package4_plane1_city5-2,7344413,7,328,0,328,0
7_5035440,load-airplane_package4_plane1_city10-2,5035440,7,328,0,328,0
7_4217068,load-airplane_package5_plane1_city3-2,4217068,7,310,0,310,0
7_4413676,load-airplane_package5_plane1_city6-2,4413676,7,310,0,310,0
7_4151532,load-airplane_package5_plane1_city2-2,4151532,7,310,0,310,0
7_4610284,load-airplane_package5_plane1_city9-2,4610284,7,310,0,310,0
7_4348140,load-airplane_package5_plane1_city5-2,4348140,7,310,0,310,0
7_6083344,load-airplane_package5_plane1_city10-2,6083344,7,310,0,310,0
7_1405485,noop_at_plane1_city4-2,1405485,7,189,0,189,0
7_6345090,noop_at_package4_city10-2,6345090,7,153,0,153,0
7_2054777,load-airplane_package4_plane2_city10-2,2054777,7,329,0,329,0
7_4094428,load-airplane_package4_plane4_city10-2,4094428,7,329,0,329,0
7_7866348,load-truck_package4_truck10_city10-2,7866348,7,168,0,168,0
7_4939726,noop_in_package5_plane2,4939726,7,135,0,135,0
7_5411578,unload-airplane_package5_plane2_city3-2,5411578,7,311,0,311,0
7_5608186,unload-airplane_package5_plane2_city6-2,5608186,7,311,0,311,0
7_5346042,unload-airplane_package5_plane2_city2-2,5346042,7,311,0,311,0
7_5804794,unload-airplane_package5_plane2_city9-2,5804794,7,311,0,311,0
7_5542650,unload-airplane_package5_plane2_city5-2,5542650,7,311,0,311,0
7_5280506,unload-airplane_package5_plane2_city1-2,5280506,7,311,0,311,0
7_5739258,unload-airplane_package5_plane2_city8-2,5739258,7,311,0,311,0
7_7840778,unload-airplane_package5_plane2_city10-2,7840778,7,311,0,311,0
7_5018864,noop_airplane_plane2,5018864,7,0,0,0,0
7_4908705,fly-airplane_plane2_city7-2_city3-2,4908705,7,202,0,202,0
7_5105313,fly-airplane_plane2_city7-2_city6-2,5105313,7,202,0,202,0
7_4843169,fly-airplane_plane2_city7-2_city2-2,4843169,7,202,0,202,0
7_5301921,fly-airplane_plane2_city7-2_city9-2,5301921,7,202,0,202,0
7_5039777,fly-airplane_plane2_city7-2_city5-2,5039777,7,202,0,202,0
7_4777633,fly-airplane_plane2_city7-2_city1-2,4777633,7,202,0,202,0
7_7120922,fly-airplane_plane2_city7-2_city10-2,7120922,7,202,0,202,0
7_5236385,fly-airplane_plane2_city7-2_city8-2,5236385,7,202,0,202,0
7_996547,fly-airplane_plane2_city3-2_city7-2,996547,7,202,0,202,0
7_931011,fly-airplane_plane2_city3-2_city6-2,931011,7,202,0,202,0
7_668867,fly-airplane_plane2_city3-2_city2-2,668867,7,202,0,202,0
7_1127619,fly-airplane_plane2_city3-2_city9-2,1127619,7,202,0,202,0
7_865475,fly-airplane_plane2_city3-2_city5-2,865475,7,202,0,202,0
7_603331,fly-airplane_plane2_city3-2_city1-2,603331,7,202,0,202,0
7_2629551,fly-airplane_plane2_city3-2_city10-2,2629551,7,202,0,202,0
7_1062083,fly-airplane_plane2_city3-2_city8-2,1062083,7,202,0,202,0
7_126785,fly-airplane_plane2_city6-2_city7-2,126785,7,202,0,202,0
7_7865618,fly-airplane_plane2_city6-2_city3-2,7865618,7,202,0,202,0
7_7800082,fly-airplane_plane2_city6-2_city2-2,7800082,7,202,0,202,0
7_257857,fly-airplane_plane2_city6-2_city9-2,257857,7,202,0,202,0
7_7996690,fly-airplane_plane2_city6-2_city5-2,7996690,7,202,0,202,0
7_7734546,fly-airplane_plane2_city6-2_city1-2,7734546,7,202,0,202,0
7_3997835,fly-airplane_plane2_city6-2_city10-2,3997835,7,202,0,202,0
7_192321,fly-airplane_plane2_city6-2_city8-2,192321,7,202,0,202,0
7_3953460,fly-airplane_plane2_city2-2_city7-2,3953460,7,202,0,202,0
7_3691316,fly-airplane_plane2_city2-2_city3-2,3691316,7,202,0,202,0
7_3887924,fly-airplane_plane2_city2-2_city6-2,3887924,7,202,0,202,0
7_4084532,fly-airplane_plane2_city2-2_city9-2,4084532,7,202,0,202,0
7_3822388,fly-airplane_plane2_city2-2_city5-2,3822388,7,202,0,202,0
7_3560244,fly-airplane_plane2_city2-2_city1-2,3560244,7,202,0,202,0
7_7507441,fly-airplane_plane2_city2-2_city10-2,7507441,7,202,0,202,0
7_4018996,fly-airplane_plane2_city2-2_city8-2,4018996,7,202,0,202,0
7_7258000,fly-airplane_plane2_city9-2_city7-2,7258000,7,202,0,202,0
7_6995856,fly-airplane_plane2_city9-2_city3-2,6995856,7,202,0,202,0
7_7192464,fly-airplane_plane2_city9-2_city6-2,7192464,7,202,0,202,0
7_6930320,fly-airplane_plane2_city9-2_city2-2,6930320,7,202,0,202,0
7_7126928,fly-airplane_plane2_city9-2_city5-2,7126928,7,202,0,202,0
7_6864784,fly-airplane_plane2_city9-2_city1-2,6864784,7,202,0,202,0
7_5366119,fly-airplane_plane2_city9-2_city10-2,5366119,7,202,0,202,0
7_7323536,fly-airplane_plane2_city9-2_city8-2,7323536,7,202,0,202,0
7_3083698,fly-airplane_plane2_city5-2_city7-2,3083698,7,202,0,202,0
7_2821554,fly-airplane_plane2_city5-2_city3-2,2821554,7,202,0,202,0
7_3018162,fly-airplane_plane2_city5-2_city6-2,3018162,7,202,0,202,0
7_2756018,fly-airplane_plane2_city5-2_city2-2,2756018,7,202,0,202,0
7_3214770,fly-airplane_plane2_city5-2_city9-2,3214770,7,202,0,202,0
7_2690482,fly-airplane_plane2_city5-2_city1-2,2690482,7,202,0,202,0
7_874748,fly-airplane_plane2_city5-2_city10-2,874748,7,202,0,202,0
7_3149234,fly-airplane_plane2_city5-2_city8-2,3149234,7,202,0,202,0
7_6910373,fly-airplane_plane2_city1-2_city7-2,6910373,7,202,0,202,0
7_6648229,fly-airplane_plane2_city1-2_city3-2,6648229,7,202,0,202,0
7_6844837,fly-airplane_plane2_city1-2_city6-2,6844837,7,202,0,202,0
7_6582693,fly-airplane_plane2_city1-2_city2-2,6582693,7,202,0,202,0
7_7041445,fly-airplane_plane2_city1-2_city9-2,7041445,7,202,0,202,0
7_6779301,fly-airplane_plane2_city1-2_city5-2,6779301,7,202,0,202,0
7_4384354,fly-airplane_plane2_city1-2_city10-2,4384354,7,202,0,202,0
7_6975909,fly-airplane_plane2_city1-2_city8-2,6975909,7,202,0,202,0
7_147109,fly-airplane_plane2_city10-2_city7-2,147109,7,202,0,202,0
7_7885942,fly-airplane_plane2_city10-2_city3-2,7885942,7,202,0,202,0
7_81573,fly-airplane_plane2_city10-2_city6-2,81573,7,202,0,202,0
7_7820406,fly-airplane_plane2_city10-2_city2-2,7820406,7,202,0,202,0
7_278181,fly-airplane_plane2_city10-2_city9-2,278181,7,202,0,202,0
7_16037,fly-airplane_plane2_city10-2_city5-2,16037,7,202,0,202,0
7_7754870,fly-airplane_plane2_city10-2_city1-2,7754870,7,202,0,202,0
7_212645,fly-airplane_plane2_city10-2_city8-2,212645,7,202,0,202,0
7_2213936,fly-airplane_plane2_city8-2_city7-2,2213936,7,202,0,202,0
7_1951792,fly-airplane_plane2_city8-2_city3-2,1951792,7,202,0,202,0
7_2148400,fly-airplane_plane2_city8-2_city6-2,2148400,7,202,0,202,0
7_1886256,fly-airplane_plane2_city8-2_city2-2,1886256,7,202,0,202,0
7_2345008,fly-airplane_plane2_city8-2_city9-2,2345008,7,202,0,202,0
7_2082864,fly-airplane_plane2_city8-2_city5-2,2082864,7,202,0,202,0
7_1820720,fly-airplane_plane2_city8-2_city1-2,1820720,7,202,0,202,0
7_2243032,fly-airplane_plane2_city8-2_city10-2,2243032,7,202,0,202,0
7_1394716,unload-airplane_package1_plane2_city3-2,1394716,7,310,0,310,0
7_1591324,unload-airplane_package1_plane2_city6-2,1591324,7,310,0,310,0
7_1329180,unload-airplane_package1_plane2_city2-2,1329180,7,310,0,310,0
7_1787932,unload-airplane_package1_plane2_city9-2,1787932,7,310,0,310,0
7_1525788,unload-airplane_package1_plane2_city5-2,1525788,7,310,0,310,0
7_1263644,unload-airplane_package1_plane2_city1-2,1263644,7,310,0,310,0
7_1722396,unload-airplane_package1_plane2_city8-2,1722396,7,310,0,310,0
7_3649162,unload-airplane_package1_plane2_city10-2,3649162,7,310,0,310,0
7_6399420,unload-airplane_package2_plane2_city3-2,6399420,7,283,0,283,0
7_6596028,unload-airplane_package2_plane2_city6-2,6596028,7,283,0,283,0
7_6333884,unload-airplane_package2_plane2_city2-2,6333884,7,283,0,283,0
7_6792636,unload-airplane_package2_plane2_city9-2,6792636,7,283,0,283,0
7_6530492,unload-airplane_package2_plane2_city5-2,6530492,7,283,0,283,0
7_6268348,unload-airplane_package2_plane2_city1-2,6268348,7,283,0,283,0
7_6727100,unload-airplane_package2_plane2_city8-2,6727100,7,283,0,283,0
7_4697066,unload-airplane_package2_plane2_city10-2,4697066,7,283,0,283,0
7_3403147,unload-airplane_package3_plane2_city3-2,3403147,7,328,0,328,0
7_3599755,unload-airplane_package3_plane2_city6-2,3599755,7,328,0,328,0
7_3337611,unload-airplane_package3_plane2_city2-2,3337611,7,328,0,328,0
7_3796363,unload-airplane_package3_plane2_city9-2,3796363,7,328,0,328,0
7_3534219,unload-airplane_package3_plane2_city5-2,3534219,7,328,0,328,0
7_3272075,unload-airplane_package3_plane2_city1-2,3272075,7,328,0,328,0
7_3730827,unload-airplane_package3_plane2_city8-2,3730827,7,328,0,328,0
7_5744970,unload-airplane_package3_plane2_city10-2,5744970,7,328,0,328,0
7_406874,unload-airplane_package4_plane2_city3-2,406874,7,328,0,328,0
7_603482,unload-airplane_package4_plane2_city6-2,603482,7,328,0,328,0
7_341338,unload-airplane_package4_plane2_city2-2,341338,7,328,0,328,0
7_800090,unload-airplane_package4_plane2_city9-2,800090,7,328,0,328,0
7_537946,unload-airplane_package4_plane2_city5-2,537946,7,328,0,328,0
7_275802,unload-airplane_package4_plane2_city1-2,275802,7,328,0,328,0
7_734554,unload-airplane_package4_plane2_city8-2,734554,7,328,0,328,0
7_6792874,unload-airplane_package4_plane2_city10-2,6792874,7,328,0,328,0
7_4407828,load-airplane_package1_plane2_city3-2,4407828,7,310,0,310,0
7_4538900,load-airplane_package1_plane2_city5-2,4538900,7,310,0,310,0
7_4276756,load-airplane_package1_plane2_city1-2,4276756,7,310,0,310,0
7_4735508,load-airplane_package1_plane2_city8-2,4735508,7,310,0,310,0
7_6912042,load-airplane_package1_plane2_city10-2,6912042,7,310,0,310,0
7_1411555,load-airplane_package2_plane2_city3-2,1411555,7,283,0,283,0
7_1608163,load-airplane_package2_plane2_city6-2,1608163,7,283,0,283,0
7_1280483,load-airplane_package2_plane2_city1-2,1280483,7,283,0,283,0
7_1739235,load-airplane_package2_plane2_city8-2,1739235,7,283,0,283,0
7_7959946,load-airplane_package2_plane2_city10-2,7959946,7,283,0,283,0
7_6612867,load-airplane_package3_plane2_city6-2,6612867,7,328,0,328,0
7_6350723,load-airplane_package3_plane2_city2-2,6350723,7,328,0,328,0
7_6809475,load-airplane_package3_plane2_city9-2,6809475,7,328,0,328,0
7_6547331,load-airplane_package3_plane2_city5-2,6547331,7,328,0,328,0
7_6285187,load-airplane_package3_plane2_city1-2,6285187,7,328,0,328,0
7_6743939,load-airplane_package3_plane2_city8-2,6743939,7,328,0,328,0
7_1006873,load-airplane_package3_plane2_city10-2,1006873,7,328,0,328,0
7_3616594,load-airplane_package4_plane2_city6-2,3616594,7,328,0,328,0
7_3354450,load-airplane_package4_plane2_city2-2,3354450,7,328,0,328,0
7_3813202,load-airplane_package4_plane2_city9-2,3813202,7,328,0,328,0
7_3551058,load-airplane_package4_plane2_city5-2,3551058,7,328,0,328,0
7_3288914,load-airplane_package4_plane2_city1-2,3288914,7,328,0,328,0
7_3747666,load-airplane_package4_plane2_city8-2,3747666,7,328,0,328,0
7_423713,load-airplane_package5_plane2_city3-2,423713,7,310,0,310,0
7_620321,load-airplane_package5_plane2_city6-2,620321,7,310,0,310,0
7_358177,load-airplane_package5_plane2_city2-2,358177,7,310,0,310,0
7_816929,load-airplane_package5_plane2_city9-2,816929,7,310,0,310,0
7_554785,load-airplane_package5_plane2_city5-2,554785,7,310,0,310,0
7_751393,load-airplane_package5_plane2_city8-2,751393,7,310,0,310,0
7_3102681,load-airplane_package5_plane2_city10-2,3102681,7,310,0,310,0
7_1281200,noop_city_city10,1281200,7,0,0,0,0
7_5852373,noop_at_package4_city6-1,5852373,7,166,0,166,0
7_4939727,noop_in_package5_plane3,4939727,7,135,0,135,0
7_1618223,unload-airplane_package5_plane3_city3-2,1618223,7,311,0,311,0
7_1814831,unload-airplane_package5_plane3_city6-2,1814831,7,311,0,311,0
7_1749295,unload-airplane_package5_plane3_city5-2,1749295,7,311,0,311,0
7_1487151,unload-airplane_package5_plane3_city1-2,1487151,7,311,0,311,0
7_1945903,unload-airplane_package5_plane3_city8-2,1945903,7,311,0,311,0
7_1823615,noop_airport_city7-2,1823615,7,0,0,0,0
7_5956609,fly-airplane_plane3_city7-2_city3-2,5956609,7,202,0,202,0
7_6153217,fly-airplane_plane3_city7-2_city6-2,6153217,7,202,0,202,0
7_5891073,fly-airplane_plane3_city7-2_city2-2,5891073,7,202,0,202,0
7_6349825,fly-airplane_plane3_city7-2_city9-2,6349825,7,202,0,202,0
7_6087681,fly-airplane_plane3_city7-2_city5-2,6087681,7,202,0,202,0
7_5825537,fly-airplane_plane3_city7-2_city1-2,5825537,7,202,0,202,0
7_3351128,fly-airplane_plane3_city7-2_city10-2,3351128,7,202,0,202,0
7_6284289,fly-airplane_plane3_city7-2_city8-2,6284289,7,202,0,202,0
7_2044451,fly-airplane_plane3_city3-2_city7-2,2044451,7,202,0,202,0
7_1174689,fly-airplane_plane3_city6-2_city7-2,1174689,7,202,0,202,0
7_4131602,fly-airplane_plane3_city5-2_city7-2,4131602,7,202,0,202,0
7_7958277,fly-airplane_plane3_city1-2_city7-2,7958277,7,202,0,202,0
7_3261840,fly-airplane_plane3_city8-2_city7-2,3261840,7,202,0,202,0
7_7004513,fly-airplane_plane4_city7-2_city3-2,7004513,7,202,0,202,0
7_7201121,fly-airplane_plane4_city7-2_city6-2,7201121,7,202,0,202,0
7_6938977,fly-airplane_plane4_city7-2_city2-2,6938977,7,202,0,202,0
7_7397729,fly-airplane_plane4_city7-2_city9-2,7397729,7,202,0,202,0
7_7135585,fly-airplane_plane4_city7-2_city5-2,7135585,7,202,0,202,0
7_6873441,fly-airplane_plane4_city7-2_city1-2,6873441,7,202,0,202,0
7_7582311,fly-airplane_plane4_city7-2_city10-2,7582311,7,202,0,202,0
7_7332193,fly-airplane_plane4_city7-2_city8-2,7332193,7,202,0,202,0
7_3092355,fly-airplane_plane4_city3-2_city7-2,3092355,7,202,0,202,0
7_2222593,fly-airplane_plane4_city6-2_city7-2,2222593,7,202,0,202,0
7_1005204,fly-airplane_plane4_city1-2_city7-2,1005204,7,202,0,202,0
7_608498,fly-airplane_plane4_city10-2_city7-2,608498,7,202,0,202,0
7_4309744,fly-airplane_plane4_city8-2_city7-2,4309744,7,202,0,202,0
7_5018865,noop_airplane_plane3,5018865,7,0,0,0,0
7_1978915,fly-airplane_plane3_city3-2_city6-2,1978915,7,202,0,202,0
7_1716771,fly-airplane_plane3_city3-2_city2-2,1716771,7,202,0,202,0
7_2175523,fly-airplane_plane3_city3-2_city9-2,2175523,7,202,0,202,0
7_1913379,fly-airplane_plane3_city3-2_city5-2,1913379,7,202,0,202,0
7_1651235,fly-airplane_plane3_city3-2_city1-2,1651235,7,202,0,202,0
7_6860734,fly-airplane_plane3_city3-2_city10-2,6860734,7,202,0,202,0
7_2109987,fly-airplane_plane3_city3-2_city8-2,2109987,7,202,0,202,0
7_912545,fly-airplane_plane3_city6-2_city3-2,912545,7,202,0,202,0
7_847009,fly-airplane_plane3_city6-2_city2-2,847009,7,202,0,202,0
7_1305761,fly-airplane_plane3_city6-2_city9-2,1305761,7,202,0,202,0
7_1043617,fly-airplane_plane3_city6-2_city5-2,1043617,7,202,0,202,0
7_781473,fly-airplane_plane3_city6-2_city1-2,781473,7,202,0,202,0
7_228041,fly-airplane_plane3_city6-2_city10-2,228041,7,202,0,202,0
7_1240225,fly-airplane_plane3_city6-2_city8-2,1240225,7,202,0,202,0
7_3869458,fly-airplane_plane3_city5-2_city3-2,3869458,7,202,0,202,0
7_4066066,fly-airplane_plane3_city5-2_city6-2,4066066,7,202,0,202,0
7_3803922,fly-airplane_plane3_city5-2_city2-2,3803922,7,202,0,202,0
7_4262674,fly-airplane_plane3_city5-2_city9-2,4262674,7,202,0,202,0
7_3738386,fly-airplane_plane3_city5-2_city1-2,3738386,7,202,0,202,0
7_5105931,fly-airplane_plane3_city5-2_city10-2,5105931,7,202,0,202,0
7_4197138,fly-airplane_plane3_city5-2_city8-2,4197138,7,202,0,202,0
7_7696133,fly-airplane_plane3_city1-2_city3-2,7696133,7,202,0,202,0
7_7892741,fly-airplane_plane3_city1-2_city6-2,7892741,7,202,0,202,0
7_7630597,fly-airplane_plane3_city1-2_city2-2,7630597,7,202,0,202,0
7_88372,fly-airplane_plane3_city1-2_city9-2,88372,7,202,0,202,0
7_7827205,fly-airplane_plane3_city1-2_city5-2,7827205,7,202,0,202,0
7_614560,fly-airplane_plane3_city1-2_city10-2,614560,7,202,0,202,0
7_22836,fly-airplane_plane3_city1-2_city8-2,22836,7,202,0,202,0
7_2999696,fly-airplane_plane3_city8-2_city3-2,2999696,7,202,0,202,0
7_3196304,fly-airplane_plane3_city8-2_city6-2,3196304,7,202,0,202,0
7_2934160,fly-airplane_plane3_city8-2_city2-2,2934160,7,202,0,202,0
7_3392912,fly-airplane_plane3_city8-2_city9-2,3392912,7,202,0,202,0
7_3130768,fly-airplane_plane3_city8-2_city5-2,3130768,7,202,0,202,0
7_2868624,fly-airplane_plane3_city8-2_city1-2,2868624,7,202,0,202,0
7_6474215,fly-airplane_plane3_city8-2_city10-2,6474215,7,202,0,202,0
7_5602338,unload-airplane_package1_plane3_city3-2,5602338,7,310,0,310,0
7_5798946,unload-airplane_package1_plane3_city6-2,5798946,7,310,0,310,0
7_5733410,unload-airplane_package1_plane3_city5-2,5733410,7,310,0,310,0
7_5471266,unload-airplane_package1_plane3_city1-2,5471266,7,310,0,310,0
7_5930018,unload-airplane_package1_plane3_city8-2,5930018,7,310,0,310,0
7_2606065,unload-airplane_package2_plane3_city3-2,2606065,7,283,0,283,0
7_2802673,unload-airplane_package2_plane3_city6-2,2802673,7,283,0,283,0
7_2737137,unload-airplane_package2_plane3_city5-2,2737137,7,283,0,283,0
7_2474993,unload-airplane_package2_plane3_city1-2,2474993,7,283,0,283,0
7_2933745,unload-airplane_package2_plane3_city8-2,2933745,7,283,0,283,0
7_7610769,unload-airplane_package3_plane3_city3-2,7610769,7,328,0,328,0
7_7807377,unload-airplane_package3_plane3_city6-2,7807377,7,328,0,328,0
7_7741841,unload-airplane_package3_plane3_city5-2,7741841,7,328,0,328,0
7_7479697,unload-airplane_package3_plane3_city1-2,7479697,7,328,0,328,0
7_7938449,unload-airplane_package3_plane3_city8-2,7938449,7,328,0,328,0
7_4614496,unload-airplane_package4_plane3_city3-2,4614496,7,328,0,328,0
7_4811104,unload-airplane_package4_plane3_city6-2,4811104,7,328,0,328,0
7_4745568,unload-airplane_package4_plane3_city5-2,4745568,7,328,0,328,0
7_4483424,unload-airplane_package4_plane3_city1-2,4483424,7,328,0,328,0
7_4942176,unload-airplane_package4_plane3_city8-2,4942176,7,328,0,328,0
7_614473,load-airplane_package1_plane3_city3-2,614473,7,310,0,310,0
7_745545,load-airplane_package1_plane3_city5-2,745545,7,310,0,310,0
7_483401,load-airplane_package1_plane3_city1-2,483401,7,310,0,310,0
7_942153,load-airplane_package1_plane3_city8-2,942153,7,310,0,310,0
7_5619177,load-airplane_package2_plane3_city3-2,5619177,7,283,0,283,0
7_5815785,load-airplane_package2_plane3_city6-2,5815785,7,283,0,283,0
7_5488105,load-airplane_package2_plane3_city1-2,5488105,7,283,0,283,0
7_5946857,load-airplane_package2_plane3_city8-2,5946857,7,283,0,283,0
7_2819512,load-airplane_package3_plane3_city6-2,2819512,7,328,0,328,0
7_2753976,load-airplane_package3_plane3_city5-2,2753976,7,328,0,328,0
7_2491832,load-airplane_package3_plane3_city1-2,2491832,7,328,0,328,0
7_2950584,load-airplane_package3_plane3_city8-2,2950584,7,328,0,328,0
7_7824216,load-airplane_package4_plane3_city6-2,7824216,7,328,0,328,0
7_7758680,load-airplane_package4_plane3_city5-2,7758680,7,328,0,328,0
7_7496536,load-airplane_package4_plane3_city1-2,7496536,7,328,0,328,0
7_7955288,load-airplane_package4_plane3_city8-2,7955288,7,328,0,328,0
7_4631335,load-airplane_package5_plane3_city3-2,4631335,7,310,0,310,0
7_4827943,load-airplane_package5_plane3_city6-2,4827943,7,310,0,310,0
7_4762407,load-airplane_package5_plane3_city5-2,4762407,7,310,0,310,0
7_4959015,load-airplane_package5_plane3_city8-2,4959015,7,310,0,310,0
7_1927947,noop_at_package5_city4-2,1927947,7,135,0,135,0
7_4939728,noop_in_package5_plane4,4939728,7,135,0,135,0
7_5825845,unload-airplane_package5_plane4_city3-2,5825845,7,311,0,311,0
7_6022453,unload-airplane_package5_plane4_city6-2,6022453,7,311,0,311,0
7_5694773,unload-airplane_package5_plane4_city1-2,5694773,7,311,0,311,0
7_6153525,unload-airplane_package5_plane4_city8-2,6153525,7,311,0,311,0
7_1879452,unload-airplane_package5_plane4_city10-2,1879452,7,311,0,311,0
7_4233888,noop_in-city_city9-1_city9,4233888,7,0,0,0,0
7_5018866,noop_airplane_plane4,5018866,7,0,0,0,0
7_3026819,fly-airplane_plane4_city3-2_city6-2,3026819,7,202,0,202,0
7_2764675,fly-airplane_plane4_city3-2_city2-2,2764675,7,202,0,202,0
7_3223427,fly-airplane_plane4_city3-2_city9-2,3223427,7,202,0,202,0
7_2961283,fly-airplane_plane4_city3-2_city5-2,2961283,7,202,0,202,0
7_2699139,fly-airplane_plane4_city3-2_city1-2,2699139,7,202,0,202,0
7_3090940,fly-airplane_plane4_city3-2_city10-2,3090940,7,202,0,202,0
7_3157891,fly-airplane_plane4_city3-2_city8-2,3157891,7,202,0,202,0
7_1960449,fly-airplane_plane4_city6-2_city3-2,1960449,7,202,0,202,0
7_1894913,fly-airplane_plane4_city6-2_city2-2,1894913,7,202,0,202,0
7_2353665,fly-airplane_plane4_city6-2_city9-2,2353665,7,202,0,202,0
7_2091521,fly-airplane_plane4_city6-2_city5-2,2091521,7,202,0,202,0
7_1829377,fly-airplane_plane4_city6-2_city1-2,1829377,7,202,0,202,0
7_4459224,fly-airplane_plane4_city6-2_city10-2,4459224,7,202,0,202,0
7_2288129,fly-airplane_plane4_city6-2_city8-2,2288129,7,202,0,202,0
7_743060,fly-airplane_plane4_city1-2_city3-2,743060,7,202,0,202,0
7_939668,fly-airplane_plane4_city1-2_city6-2,939668,7,202,0,202,0
7_677524,fly-airplane_plane4_city1-2_city2-2,677524,7,202,0,202,0
7_1136276,fly-airplane_plane4_city1-2_city9-2,1136276,7,202,0,202,0
7_874132,fly-airplane_plane4_city1-2_city5-2,874132,7,202,0,202,0
7_4845743,fly-airplane_plane4_city1-2_city10-2,4845743,7,202,0,202,0
7_1070740,fly-airplane_plane4_city1-2_city8-2,1070740,7,202,0,202,0
7_346354,fly-airplane_plane4_city10-2_city3-2,346354,7,202,0,202,0
7_542962,fly-airplane_plane4_city10-2_city6-2,542962,7,202,0,202,0
7_280818,fly-airplane_plane4_city10-2_city2-2,280818,7,202,0,202,0
7_739570,fly-airplane_plane4_city10-2_city9-2,739570,7,202,0,202,0
7_477426,fly-airplane_plane4_city10-2_city5-2,477426,7,202,0,202,0
7_215282,fly-airplane_plane4_city10-2_city1-2,215282,7,202,0,202,0
7_674034,fly-airplane_plane4_city10-2_city8-2,674034,7,202,0,202,0
7_4047600,fly-airplane_plane4_city8-2_city3-2,4047600,7,202,0,202,0
7_4244208,fly-airplane_plane4_city8-2_city6-2,4244208,7,202,0,202,0
7_3982064,fly-airplane_plane4_city8-2_city2-2,3982064,7,202,0,202,0
7_4440816,fly-airplane_plane4_city8-2_city9-2,4440816,7,202,0,202,0
7_4178672,fly-airplane_plane4_city8-2_city5-2,4178672,7,202,0,202,0
7_3916528,fly-airplane_plane4_city8-2_city1-2,3916528,7,202,0,202,0
7_2704421,fly-airplane_plane4_city8-2_city10-2,2704421,7,202,0,202,0
7_1808983,unload-airplane_package1_plane4_city3-2,1808983,7,310,0,310,0
7_2005591,unload-airplane_package1_plane4_city6-2,2005591,7,310,0,310,0
7_1677911,unload-airplane_package1_plane4_city1-2,1677911,7,310,0,310,0
7_2136663,unload-airplane_package1_plane4_city8-2,2136663,7,310,0,310,0
7_5688813,unload-airplane_package1_plane4_city10-2,5688813,7,310,0,310,0
7_6813687,unload-airplane_package2_plane4_city3-2,6813687,7,283,0,283,0
7_7010295,unload-airplane_package2_plane4_city6-2,7010295,7,283,0,283,0
7_6682615,unload-airplane_package2_plane4_city1-2,6682615,7,283,0,283,0
7_7141367,unload-airplane_package2_plane4_city8-2,7141367,7,283,0,283,0
7_6736717,unload-airplane_package2_plane4_city10-2,6736717,7,283,0,283,0
7_3817414,unload-airplane_package3_plane4_city3-2,3817414,7,328,0,328,0
7_4014022,unload-airplane_package3_plane4_city6-2,4014022,7,328,0,328,0
7_3686342,unload-airplane_package3_plane4_city1-2,3686342,7,328,0,328,0
7_4145094,unload-airplane_package3_plane4_city8-2,4145094,7,328,0,328,0
7_7784621,unload-airplane_package3_plane4_city10-2,7784621,7,328,0,328,0
7_821141,unload-airplane_package4_plane4_city3-2,821141,7,328,0,328,0
7_1017749,unload-airplane_package4_plane4_city6-2,1017749,7,328,0,328,0
7_690069,unload-airplane_package4_plane4_city1-2,690069,7,328,0,328,0
7_1148821,unload-airplane_package4_plane4_city8-2,1148821,7,328,0,328,0
7_831548,unload-airplane_package4_plane4_city10-2,831548,7,328,0,328,0
7_4822095,load-airplane_package1_plane4_city3-2,4822095,7,310,0,310,0
7_4691023,load-airplane_package1_plane4_city1-2,4691023,7,310,0,310,0
7_5149775,load-airplane_package1_plane4_city8-2,5149775,7,310,0,310,0
7_950716,load-airplane_package1_plane4_city10-2,950716,7,310,0,310,0
7_1825822,load-airplane_package2_plane4_city3-2,1825822,7,283,0,283,0
7_2022430,load-airplane_package2_plane4_city6-2,2022430,7,283,0,283,0
7_1694750,load-airplane_package2_plane4_city1-2,1694750,7,283,0,283,0
7_2153502,load-airplane_package2_plane4_city8-2,2153502,7,283,0,283,0
7_1998620,load-airplane_package2_plane4_city10-2,1998620,7,283,0,283,0
7_7027134,load-airplane_package3_plane4_city6-2,7027134,7,328,0,328,0
7_6699454,load-airplane_package3_plane4_city1-2,6699454,7,328,0,328,0
7_7158206,load-airplane_package3_plane4_city8-2,7158206,7,328,0,328,0
7_3046524,load-airplane_package3_plane4_city10-2,3046524,7,328,0,328,0
7_4030861,load-airplane_package4_plane4_city6-2,4030861,7,328,0,328,0
7_3703181,load-airplane_package4_plane4_city1-2,3703181,7,328,0,328,0
7_4161933,load-airplane_package4_plane4_city8-2,4161933,7,328,0,328,0
7_837980,load-airplane_package5_plane4_city3-2,837980,7,310,0,310,0
7_1034588,load-airplane_package5_plane4_city6-2,1034588,7,310,0,310,0
7_1165660,load-airplane_package5_plane4_city8-2,1165660,7,310,0,310,0
7_5142332,load-airplane_package5_plane4_city10-2,5142332,7,310,0,310,0
7_1885288,noop_at_plane3_city5-2,1885288,7,189,0,189,0
7_2650101,noop_at_plane2_city10-2,2650101,7,189,0,189,0
7_565705,at_plane2_city4-2,565705,7,27,0,27,0
7_5809715,noop_at_plane2_city7-2,5809715,7,189,0,189,0
7_5852374,noop_at_package4_city6-2,5852374,7,153,0,153,0
7_4560839,noop_in-city_city2-2_city2,4560839,7,0,0,0,0
7_6728647,drive-truck_truck2_city2-1_city2-2_city2,6728647,7,25,0,25,0
7_3971182,drive-truck_truck2_city2-2_city2-1_city2,3971182,7,27,0,27,0
7_2773648,noop_location_city3-1,2773648,7,0,0,0,0
7_705394,unload-truck_package1_truck3_city3-1,705394,7,151,0,151,0
7_2713825,unload-truck_package3_truck3_city3-1,2713825,7,167,0,167,0
7_7718529,unload-truck_package4_truck3_city3-1,7718529,7,167,0,167,0
7_4722256,unload-truck_package5_truck3_city3-1,4722256,7,151,0,151,0
7_5830766,noop_at_plane4_city1-2,5830766,7,189,0,189,0
7_1164949,noop_at_package1_city5-2,1164949,7,135,0,135,0
7_2008582,load-truck_package1_truck5_city5-2,2008582,7,150,0,150,0
7_2962340,noop_at_truck7_city7-1,2962340,7,12,0,12,0
7_2773649,noop_location_city3-2,2773649,7,0,0,0,0
7_705395,unload-truck_package1_truck3_city3-2,705395,7,148,0,148,0
7_2713826,unload-truck_package3_truck3_city3-2,2713826,7,165,0,165,0
7_7718530,unload-truck_package4_truck3_city3-2,7718530,7,164,0,164,0
7_4722257,unload-truck_package5_truck3_city3-2,4722257,7,148,0,148,0
7_1463243,load-truck_package1_truck3_city3-2,1463243,7,148,0,148,0
7_6467947,load-truck_package2_truck3_city3-2,6467947,7,122,0,122,0
7_5480105,load-truck_package5_truck3_city3-2,5480105,7,148,0,148,0
7_442949,noop_in_package5_truck10,442949,7,139,0,139,0
7_7835241,unload-truck_package5_truck10_city10-1,7835241,7,154,0,154,0
7_7835242,unload-truck_package5_truck10_city10-2,7835242,7,152,0,152,0
7_5110427,noop_at_package2_city1-2,5110427,7,108,0,108,0
7_5922608,load-truck_package2_truck1_city1-2,5922608,7,124,0,124,0
7_2255627,noop_at_package5_city9-2,2255627,7,135,0,135,0
7_2962341,noop_at_truck7_city7-2,2962341,7,10,0,10,0
7_5915915,at_truck7_city7-1,5915915,7,3,1,4,0
7_6289518,noop_at_plane4_city8-2,6289518,7,189,0,189,0
7_1644751,noop_at_package3_city6-1,1644751,7,166,0,166,0
7_2010292,noop_in-city_city9-2_city9,2010292,7,0,0,0,0
7_5569179,noop_at_package2_city8-2,5569179,7,108,0,108,0
7_3830806,load-truck_package2_truck8_city8-2,3830806,7,123,0,123,0
7_5590229,noop_at_package4_city2-1,5590229,7,164,0,164,0
7_4203219,load-truck_package4_truck2_city2-1,4203219,7,169,0,169,0
7_552080,at_truck2_city2-2,552080,7,5,2,7,0
7_6144820,noop_at_truck4_city4-1,6144820,7,12,0,12,0
7_1097419,at_truck4_city4-2,1097419,7,5,3,8,0
7_1561471,noop_airport_city3-2,1561471,7,0,0,0,0
7_1602093,noop_at_plane1_city7-2,1602093,7,189,0,189,0
7_1644752,noop_at_package3_city6-2,1644752,7,153,0,153,0
7_6110934,noop_in_package4_plane1,6110934,7,153,0,153,0
7_6118830,noop_at_truck10_city10-1,6118830,7,13,0,13,0
7_6912463,unload-truck_package1_truck10_city10-1,6912463,7,154,0,154,0
7_3142669,unload-truck_package2_truck10_city10-1,3142669,7,123,0,123,0
7_7373852,unload-truck_package3_truck10_city10-1,7373852,7,168,0,168,0
7_3604058,unload-truck_package4_truck10_city10-1,3604058,7,168,0,168,0
7_7404958,load-truck_package2_truck10_city10-1,7404958,7,123,0,123,0
7_3635164,load-truck_package3_truck10_city10-1,3635164,7,172,0,172,0
7_5547571,noop_at_plane2_city3-2,5547571,7,189,0,189,0
7_6144821,noop_at_truck4_city4-2,6144821,7,11,0,11,0
7_1097418,at_truck4_city4-1,1097418,7,3,2,5,0
7_1623144,noop_at_plane3_city1-2,1623144,7,189,0,189,0
7_5590230,noop_at_package4_city2-2,5590230,7,153,0,153,0
7_4203220,load-truck_package4_truck2_city2-2,4203220,7,167,0,167,0
7_6048981,noop_at_package4_city9-1,6048981,7,166,0,166,0
7_6110935,noop_in_package4_plane2,6110935,7,153,0,153,0
7_6118831,noop_at_truck10_city10-2,6118831,7,13,0,13,0
7_6912464,unload-truck_package1_truck10_city10-2,6912464,7,151,0,151,0
7_3142670,unload-truck_package2_truck10_city10-2,3142670,7,123,0,123,0
7_7373853,unload-truck_package3_truck10_city10-2,7373853,7,167,0,167,0
7_3604059,unload-truck_package4_truck10_city10-2,3604059,7,167,0,167,0
7_3173776,load-truck_package1_truck10_city10-2,3173776,7,151,0,151,0
7_7404959,load-truck_package2_truck10_city10-2,7404959,7,123,0,123,0
7_3635165,load-truck_package3_truck10_city10-2,3635165,7,167,0,167,0
7_4096554,load-truck_package5_truck10_city10-2,4096554,7,151,0,151,0
7_3973469,at_truck10_city10-1,3973469,7,3,0,3,0
7_902805,noop_at_package1_city1-2,902805,7,135,0,135,0
7_917904,load-truck_package1_truck1_city1-2,917904,7,151,0,151,0
7_2124555,noop_at_package5_city7-2,2124555,7,135,0,135,0
7_7612973,noop_in-city_city6-1_city6,7612973,7,0,0,0,0
7_6110936,noop_in_package4_plane3,6110936,7,153,0,153,0
7_2081896,noop_at_plane3_city8-2,2081896,7,189,0,189,0
7_6048982,noop_at_package4_city9-2,6048982,7,153,0,153,0
7_1324775,noop_at_package3_city10-1,1324775,7,167,0,167,0
7_7286102,noop_at_package1_city10-2,7286102,7,135,0,135,0
7_6110937,noop_in_package4_plane4,6110937,7,153,0,153,0
7_2970256,noop_location_city6-1,2970256,7,0,0,0,0
7_6027374,noop_at_plane4_city4-2,6027374,7,189,0,189,0
7_1382607,noop_at_package3_city2-1,1382607,7,164,0,164,0
7_7199492,load-truck_package3_truck2_city2-1,7199492,7,169,0,169,0
7_1361557,noop_at_package1_city8-2,1361557,7,135,0,135,0
7_6827079,load-truck_package1_truck8_city8-2,6827079,7,150,0,150,0
7_7846438,noop_in_package5_truck1,7846438,7,135,0,135,0
7_4176917,unload-truck_package5_truck1_city1-1,4176917,7,150,0,150,0
7_4176918,unload-truck_package5_truck1_city1-2,4176918,7,150,0,150,0
7_2970257,noop_location_city6-2,2970257,7,0,0,0,0
7_1324776,noop_at_package3_city10-2,1324776,7,153,0,153,0
7_5307035,noop_at_package2_city4-2,5307035,7,108,0,108,0
7_3364427,noop_at_package5_city10-2,3364427,7,135,0,135,0
7_1339949,noop_at_plane1_city3-2,1339949,7,189,0,189,0
7_1382608,noop_at_package3_city2-2,1382608,7,153,0,153,0
7_7199493,load-truck_package3_truck2_city2-2,7199493,7,167,0,167,0
7_7846439,noop_in_package5_truck2,7846439,7,139,0,139,0
7_449098,unload-truck_package5_truck2_city2-1,449098,7,153,0,153,0
7_449099,unload-truck_package5_truck2_city2-2,449099,7,151,0,151,0
7_1841359,noop_at_package3_city9-1,1841359,7,166,0,166,0
7_3405350,noop_in-city_city5-1_city5,3405350,7,0,0,0,0
7_2656144,drive-truck_truck5_city5-1_city5-2_city5,2656144,7,24,0,24,0
7_7899656,drive-truck_truck5_city5-2_city5-1_city5,7899656,7,26,0,26,0
7_5389377,noop_in-city_city6-2_city6,5389377,7,0,0,0,0
7_7846440,noop_in_package5_truck3,7846440,7,137,0,137,0
7_5786837,noop_at_package4_city5-1,5786837,7,166,0,166,0
7_1020739,load-truck_package4_truck5_city5-1,1020739,7,171,0,171,0
7_5370577,at_truck5_city5-2,5370577,7,5,3,8,0
7_2417001,noop_at_truck5_city5-1,2417001,7,12,0,12,0
7_1250733,unload-truck_package1_truck5_city5-1,1250733,7,153,0,153,0
7_3259164,unload-truck_package3_truck5_city5-1,3259164,7,167,0,167,0
7_262891,unload-truck_package4_truck5_city5-1,262891,7,167,0,167,0
7_5267595,unload-truck_package5_truck5_city5-1,5267595,7,153,0,153,0
7_4017012,load-truck_package3_truck5_city5-1,4017012,7,171,0,171,0
7_1758079,noop_airport_city6-2,1758079,7,0,0,0,0
7_3822037,noop_in_package2_truck10,3822037,7,108,0,108,0
7_1841360,noop_at_package3_city9-2,1841360,7,153,0,153,0
7_7846441,noop_in_package5_truck4,7846441,7,139,0,139,0
7_1862411,noop_at_package5_city3-2,1862411,7,135,0,135,0
7_2417002,noop_at_truck5_city5-2,2417002,7,11,0,11,0
7_1250734,unload-truck_package1_truck5_city5-2,1250734,7,149,0,149,0
7_3259165,unload-truck_package3_truck5_city5-2,3259165,7,165,0,165,0
7_262892,unload-truck_package4_truck5_city5-2,262892,7,165,0,165,0
7_5267596,unload-truck_package5_truck5_city5-2,5267596,7,149,0,149,0
7_4017013,load-truck_package3_truck5_city5-2,4017013,7,165,0,165,0
7_1020740,load-truck_package4_truck5_city5-2,1020740,7,165,0,165,0
7_6025444,load-truck_package5_truck5_city5-2,6025444,7,149,0,149,0
7_5370576,at_truck5_city5-1,5370576,7,3,2,5,0
7_1819752,noop_at_plane3_city4-2,1819752,7,189,0,189,0
7_5744179,noop_at_plane2_city6-2,5744179,7,189,0,189,0
7_5786838,noop_at_package4_city5-2,5786838,7,153,0,153,0
7_7846442,noop_in_package5_truck5,7846442,7,139,0,139,0
7_7282143,noop_in_package3_plane1,7282143,7,153,0,153,0
7_2708112,noop_location_city2-1,2708112,7,0,0,0,0
7_4433213,unload-truck_package1_truck2_city2-1,4433213,7,149,0,149,0
7_6441644,unload-truck_package3_truck2_city2-1,6441644,7,167,0,167,0
7_3445371,unload-truck_package4_truck2_city2-1,3445371,7,167,0,167,0
7_7846443,noop_in_package5_truck6,7846443,7,139,0,139,0
7_1099413,noop_at_package1_city4-2,1099413,7,135,0,135,0
7_5599481,noop_at_truck2_city2-1,5599481,7,12,0,12,0
7_1181754,noop_in-city_city5-2_city5,1181754,7,0,0,0,0
7_2708113,noop_location_city2-2,2708113,7,0,0,0,0
7_4433214,unload-truck_package1_truck2_city2-2,4433214,7,149,0,149,0
7_6441645,unload-truck_package3_truck2_city2-2,6441645,7,166,0,166,0
7_3445372,unload-truck_package4_truck2_city2-2,3445372,7,166,0,166,0
7_1206947,load-truck_package5_truck2_city2-2,1206947,7,150,0,150,0
7_7282144,noop_in_package3_plane2,7282144,7,153,0,153,0
7_7846444,noop_in_package5_truck7,7846444,7,137,0,137,0
7_2190091,noop_at_package5_city8-2,2190091,7,135,0,135,0
7_2842964,load-truck_package5_truck8_city8-2,2842964,7,150,0,150,0
7_7282145,noop_in_package3_plane3,7282145,7,153,0,153,0
7_3166864,noop_location_city9-1,3166864,7,0,0,0,0
7_62686,noop_truck_truck1,62686,7,0,0,0,0
7_85171,drive-truck_truck1_city1-1_city1-2_city1,85171,7,25,0,25,0
7_5328683,drive-truck_truck1_city1-2_city1-1_city1,5328683,7,27,0,27,0
7_160055,unload-truck_package1_truck1_city1-1,160055,7,153,0,153,0
7_160056,unload-truck_package1_truck1_city1-2,160056,7,150,0,150,0
7_2168486,unload-truck_package3_truck1_city1-1,2168486,7,167,0,167,0
7_2168487,unload-truck_package3_truck1_city1-2,2168487,7,166,0,166,0
7_7173190,unload-truck_package4_truck1_city1-1,7173190,7,167,0,167,0
7_7173191,unload-truck_package4_truck1_city1-2,7173191,7,166,0,166,0
7_2926334,load-truck_package3_truck1_city1-1,2926334,7,169,0,169,0
7_2926335,load-truck_package3_truck1_city1-2,2926335,7,166,0,166,0
7_7931038,load-truck_package4_truck1_city1-1,7931038,7,169,0,169,0
7_7931039,load-truck_package4_truck1_city1-2,7931039,7,166,0,166,0
7_5599482,noop_at_truck2_city2-2,5599482,7,12,0,12,0
7_552079,at_truck2_city2-1,552079,7,3,1,4,0
7_6223982,noop_at_plane4_city7-2,6223982,7,189,0,189,0
7_7846445,noop_in_package5_truck8,7846445,7,139,0,139,0
7_2085115,unload-truck_package5_truck8_city8-1,2085115,7,153,0,153,0
7_2085116,unload-truck_package5_truck8_city8-2,2085116,7,150,0,150,0
7_1579215,noop_at_package3_city5-1,1579215,7,166,0,166,0
7_3166865,noop_location_city9-2,3166865,7,0,0,0,0
7_62687,noop_truck_truck2,62687,7,0,0,0,0
7_7282146,noop_in_package3_plane4,7282146,7,153,0,153,0
7_7846446,noop_in_package5_truck9,7846446,7,139,0,139,0
7_7615392,noop_in_package1_truck10,7615392,7,139,0,139,0
7_5503643,noop_at_package2_city7-2,5503643,7,108,0,108,0
7_5524693,noop_at_package4_city1-1,5524693,7,164,0,164,0
7_4279899,at_truck1_city1-2,4279899,7,5,2,7,0
7_1016670,noop_in_package4_truck1,1016670,7,153,0,153,0
7_1536557,noop_at_plane1_city6-2,1536557,7,189,0,189,0
7_4109194,noop_in-city_city10-1_city10,4109194,7,0,0,0,0
7_1495935,noop_airport_city2-2,1495935,7,0,0,0,0
7_62688,noop_truck_truck3,62688,7,0,0,0,0
7_1579216,noop_at_package3_city5-2,1579216,7,153,0,153,0
7_4530297,noop_in_package1_truck1,4530297,7,139,0,139,0
7_1016671,noop_in_package4_truck2,1016671,7,153,0,153,0
7_4530298,noop_in_package1_truck2,4530298,7,135,0,135,0
7_6784435,noop_in-city_city2-1_city2,6784435,7,0,0,0,0
7_4975108,noop_in-city_city4-2_city4,4975108,7,0,0,0,0
7_62689,noop_truck_truck4,62689,7,0,0,0,0
7_45710,noop_truck_truck10,45710,7,0,0,0,0
7_5482035,noop_at_plane2_city2-2,5482035,7,189,0,189,0
7_5524694,noop_at_package4_city1-2,5524694,7,153,0,153,0
7_5983445,noop_at_package4_city8-1,5983445,7,166,0,166,0
7_5839236,load-truck_package4_truck8_city8-1,5839236,7,171,0,171,0
7_2188097,at_truck8_city8-2,2188097,7,5,3,8,0
7_1016672,noop_in_package4_truck3,1016672,7,153,0,153,0
7_1954687,noop_airport_city9-2,1954687,7,0,0,0,0
7_62690,noop_truck_truck5,62690,7,0,0,0,0
7_4530299,noop_in_package1_truck3,4530299,7,137,0,137,0
7_2059019,noop_at_package5_city6-2,2059019,7,135,0,135,0
7_1016673,noop_in_package4_truck4,1016673,7,153,0,153,0
7_4305438,noop_at_package2_city10-1,4305438,7,108,0,108,0
7_2016360,noop_at_plane3_city7-2,2016360,7,189,0,189,0
7_62691,noop_truck_truck6,62691,7,0,0,0,0
7_5940787,noop_at_plane2_city9-2,5940787,7,189,0,189,0
7_5983446,noop_at_package4_city8-2,5983446,7,153,0,153,0
7_5839237,load-truck_package4_truck8_city8-2,5839237,7,166,0,166,0
7_4530300,noop_in_package1_truck4,4530300,7,139,0,139,0
7_1016674,noop_in_package4_truck5,1016674,7,153,0,153,0
7_5961838,noop_at_plane4_city3-2,5961838,7,189,0,189,0
7_2904720,noop_location_city5-1,2904720,7,0,0,0,0
7_62692,noop_truck_truck7,62692,7,0,0,0,0
7_4305439,noop_at_package2_city10-2,4305439,7,108,0,108,0
7_4530301,noop_in_package1_truck5,4530301,7,139,0,139,0
7_1317071,noop_at_package3_city1-1,1317071,7,164,0,164,0
7_1296021,noop_at_package1_city7-2,1296021,7,135,0,135,0
7_452375,noop_in_package2_plane1,452375,7,108,0,108,0
7_1016675,noop_in_package4_truck6,1016675,7,153,0,153,0
7_1871662,noop_at_truck3_city3-1,1871662,7,12,0,12,0
7_2576812,noop_in-city_city1-1_city1,2576812,7,0,0,0,0
7_2904721,noop_location_city5-2,2904721,7,0,0,0,0
7_62693,noop_truck_truck8,62693,7,0,0,0,0
7_6584618,drive-truck_truck8_city8-1_city8-2_city8,6584618,7,24,0,24,0
7_3827153,drive-truck_truck8_city8-2_city8-1_city8,3827153,7,26,0,26,0
7_6069230,unload-truck_package1_truck8_city8-1,6069230,7,153,0,153,0
7_6069231,unload-truck_package1_truck8_city8-2,6069231,7,149,0,149,0
7_76684,unload-truck_package3_truck8_city8-1,76684,7,167,0,167,0
7_76685,unload-truck_package3_truck8_city8-2,76685,7,165,0,165,0
7_5081388,unload-truck_package4_truck8_city8-1,5081388,7,167,0,167,0
7_5081389,unload-truck_package4_truck8_city8-2,5081389,7,165,0,165,0
7_834532,load-truck_package3_truck8_city8-1,834532,7,171,0,171,0
7_834533,load-truck_package3_truck8_city8-2,834533,7,165,0,165,0
7_4689752,noop_at_plane4_city10-2,4689752,7,189,0,189,0
7_4530302,noop_in_package1_truck6,4530302,7,139,0,139,0
7_5241499,noop_at_package2_city3-2,5241499,7,108,0,108,0
7_452376,noop_in_package2_plane2,452376,7,108,0,108,0
7_1016676,noop_in_package4_truck7,1016676,7,153,0,153,0
7_62694,noop_truck_truck9,62694,7,0,0,0,0
7_1871663,noop_at_truck3_city3-2,1871663,7,10,0,10,0
7_4825237,at_truck3_city3-1,4825237,7,3,2,5,0
7_1274413,noop_at_plane1_city2-2,1274413,7,189,0,189,0
7_1317072,noop_at_package3_city1-2,1317072,7,153,0,153,0
7_4530303,noop_in_package1_truck7,4530303,7,137,0,137,0
7_1775823,noop_at_package3_city8-1,1775823,7,166,0,166,0
7_452377,noop_in_package2_plane3,452377,7,108,0,108,0
7_1016677,noop_in_package4_truck8,1016677,7,153,0,153,0
7_1837095,noop_obj_package1,1837095,7,0,0,0,0
7_4530304,noop_in_package1_truck8,4530304,7,139,0,139,0
7_5721301,noop_at_package4_city4-1,5721301,7,166,0,166,0
7_452378,noop_in_package2_plane4,452378,7,108,0,108,0
7_1016678,noop_in_package4_truck9,1016678,7,153,0,153,0
7_26265,noop_in-city_city8-1_city8,26265,7,0,0,0,0
7_1692543,noop_airport_city5-2,1692543,7,0,0,0,0
7_1837096,noop_obj_package2,1837096,7,0,0,0,0
7_1733165,noop_at_plane1_city9-2,1733165,7,189,0,189,0
7_1775824,noop_at_package3_city8-2,1775824,7,153,0,153,0
7_4530305,noop_in_package1_truck9,4530305,7,139,0,139,0
7_1796875,noop_at_package5_city2-2,1796875,7,135,0,135,0
7_2187879,noop_in_package3_truck1,2187879,7,153,0,153,0
7_353216,noop_in-city_city1-2_city1,353216,7,0,0,0,0
7_1837097,noop_obj_package3,1837097,7,0,0,0,0
7_1754216,noop_at_plane3_city3-2,1754216,7,189,0,189,0
7_5678643,noop_at_plane2_city5-2,5678643,7,189,0,189,0
7_5721302,noop_at_package4_city4-2,5721302,7,153,0,153,0
7_2187880,noop_in_package3_truck2,2187880,7,153,0,153,0
7_2642576,noop_location_city1-1,2642576,7,0,0,0,0
7_4005493,noop_city_city1,4005493,7,0,0,0,0
7_1837098,noop_obj_package4,1837098,7,0,0,0,0
7_1033877,noop_at_package1_city3-2,1033877,7,135,0,135,0
7_4236304,noop_in_package4_truck10,4236304,7,153,0,153,0
7_2187881,noop_in_package3_truck3,2187881,7,153,0,153,0
7_2642577,noop_location_city1-2,2642577,7,0,0,0,0
7_4005494,noop_city_city2,4005494,7,0,0,0,0
7_1837099,noop_obj_package5,1837099,7,0,0,0,0
7_2187882,noop_in_package3_truck4,2187882,7,153,0,153,0
7_3819619,noop_in-city_city7-1_city7,3819619,7,0,0,0,0
7_5803646,noop_in-city_city8-2_city8,5803646,7,0,0,0,0
7_3101328,noop_location_city8-1,3101328,7,0,0,0,0
7_4005495,noop_city_city3,4005495,7,0,0,0,0
7_6158446,noop_at_plane4_city6-2,6158446,7,189,0,189,0
7_1513679,noop_at_package3_city4-1,1513679,7,166,0,166,0
7_2187883,noop_in_package3_truck5,2187883,7,153,0,153,0
7_3101329,noop_location_city8-2,3101329,7,0,0,0,0
7_4005496,noop_city_city4,4005496,7,0,0,0,0
7_5438107,noop_at_package2_city6-2,5438107,7,108,0,108,0
7_2187884,noop_in_package3_truck6,2187884,7,153,0,153,0
7_1623584,noop_in_package1_plane1,1623584,7,135,0,135,0
7_7235498,noop_at_truck8_city8-1,7235498,7,12,0,12,0
7_1430399,noop_airport_city1-2,1430399,7,0,0,0,0
7_6333557,noop_airport_city10-2,6333557,7,0,0,0,0
7_4613021,noop_location_city10-1,4613021,7,0,0,0,0
7_4005497,noop_city_city5,4005497,7,0,0,0,0
7_1471021,noop_at_plane1_city5-2,1471021,7,189,0,189,0
7_1513680,noop_at_package3_city4-2,1513680,7,153,0,153,0
7_2187885,noop_in_package3_truck7,2187885,7,153,0,153,0
7_1623585,noop_in_package1_plane2,1623585,7,135,0,135,0
7_4613022,noop_location_city10-2,4613022,7,0,0,0,0
7_4005498,noop_city_city6,4005498,7,0,0,0,0
7_7235499,noop_at_truck8_city8-2,7235499,7,11,0,11,0
7_2188096,at_truck8_city8-1,2188096,7,3,2,5,0
7_5416499,noop_at_plane2_city1-2,5416499,7,189,0,189,0
7_5917909,noop_at_package4_city7-1,5917909,7,153,0,153,0
7_28682,noop_in_package3_truck10,28682,7,153,0,153,0
7_2187886,noop_in_package3_truck8,2187886,7,153,0,153,0
7_1623586,noop_in_package1_plane3,1623586,7,135,0,135,0
7_1326323,noop_at_truck1_city1-1,1326323,7,12,0,12,0
7_1596023,noop_in-city_city7-2_city7,1596023,7,0,0,0,0
7_1889151,noop_airport_city8-2,1889151,7,0,0,0,0
7_4005499,noop_city_city7,4005499,7,0,0,0,0
7_1993483,noop_at_package5_city5-2,1993483,7,135,0,135,0
7_2187887,noop_in_package3_truck9,2187887,7,153,0,153,0
7_1623587,noop_in_package1_plane4,1623587,7,135,0,135,0
7_5917910,noop_at_package4_city7-2,5917910,7,153,0,153,0
7_4005500,noop_city_city8,4005500,7,0,0,0,0
7_1326324,noop_at_truck1_city1-2,1326324,7,12,0,12,0
7_4279898,at_truck1_city1-1,4279898,7,3,2,5,0
7_1950824,noop_at_plane3_city6-2,1950824,7,189,0,189,0
7_5875251,noop_at_plane2_city8-2,5875251,7,189,0,189,0
7_5630764,noop_at_plane1_city10-2,5630764,7,189,0,189,0
7_6497299,city_city8,6497299,7,1,0,1,0
7_6195675,in-city_city5-1_city5,6195675,7,1,0,1,0
7_7104561,city_city10,7104561,7,1,0,1,0
6_1694750,load-airplane_package2_plane4_city1-2,1694750,6,4,281,285,0
5_2965066,at_package2_city1-2,2965066,5,0,5,5,0
6_475400,load-truck_package4_truck3_city3-1,475400,6,4,169,173,0
5_3510404,at_package4_city3-1,3510404,5,0,1,1,0
7_585448,airport_city8-2,585448,7,1,0,1,0
6_5721301,noop_at_package4_city4-1,5721301,6,0,167,167,0
5_3575940,at_package4_city4-1,3575940,5,0,1,1,0
6_1644751,noop_at_package3_city6-1,1644751,6,0,167,167,0
5_7500367,at_package3_city6-1,7500367,5,0,1,1,0
7_6497300,city_city9,6497300,7,1,0,1,0
6_4562351,load-truck_package3_truck7_city7-1,4562351,6,4,169,173,0
5_7565903,at_package3_city7-1,7565903,5,0,1,1,0
6_4978552,unload-truck_package1_truck4_city4-1,4978552,6,5,151,156,0
7_6955028,at_package1_city4-1,6955028,7,1,35,36,0
6_2153502,load-airplane_package2_plane4_city8-2,2153502,6,4,281,285,0
5_3423818,at_package2_city8-2,3423818,5,0,5,5,0
7_3972079,in-city_city5-2_city5,3972079,7,1,0,1,0
7_1988052,in-city_city4-1_city4,1988052,7,1,0,1,0
6_5467054,load-airplane_package2_plane1_city7-2,5467054,6,4,281,285,0
5_3358282,at_package2_city7-2,3358282,5,0,5,5,0
6_160055,unload-truck_package1_truck1_city1-1,160055,6,5,151,156,0
7_6758420,at_package1_city1-1,6758420,7,1,34,35,0
6_1411555,load-airplane_package2_plane2_city3-2,1411555,6,4,281,285,0
5_3096138,at_package2_city3-2,3096138,5,0,5,5,0
6_5488105,load-airplane_package2_plane3_city1-2,5488105,6,5,281,286,0
7_5263322,location_city6-1,5263322,7,1,0,1,0
6_4722256,unload-truck_package5_truck3_city3-1,4722256,6,5,149,154,0
7_7718026,at_package5_city3-1,7718026,7,1,34,35,0
6_3830806,load-truck_package2_truck8_city8-2,3830806,6,5,121,126,0
7_7382457,in_package2_truck8,7382457,7,1,28,29,0
7_625646,airport_city10-2,625646,7,1,0,1,0
6_5438107,noop_at_package2_city6-2,5438107,6,0,109,109,0
5_3292746,at_package2_city6-2,3292746,5,0,5,5,0
7_5263323,location_city6-2,5263323,7,1,0,1,0
6_1382607,noop_at_package3_city2-1,1382607,6,0,165,165,0
5_7238223,at_package3_city2-1,7238223,5,0,1,1,0
7_323304,airport_city4-2,323304,7,1,0,1,0
6_5946857,load-airplane_package2_plane3_city8-2,5946857,6,5,281,286,0
7_7765433,in-city_city4-2_city4,7765433,7,1,0,1,0
6_1891358,load-airplane_package2_plane4_city4-2,1891358,6,4,281,285,0
5_3161674,at_package2_city4-2,3161674,5,0,5,5,0
6_5922608,load-truck_package2_truck1_city1-2,5922608,6,5,122,127,0
7_7382450,in_package2_truck1,7382450,7,1,2,3,0
6_4748558,load-truck_package4_truck4_city4-1,4748558,6,5,169,174,0
6_1841359,noop_at_package3_city9-1,1841359,6,0,167,167,0
5_7696975,at_package3_city9-1,7696975,5,0,1,1,0
7_1230283,truck_truck10,1230283,7,1,0,1,0
6_5204910,load-airplane_package2_plane1_city3-2,5204910,6,5,281,286,0
6_2341411,unload-truck_package1_truck9_city9-1,2341411,6,5,151,156,0
7_7282708,at_package1_city9-1,7282708,7,1,35,36,0
7_5367137,in-city_city1-1_city1,5367137,7,1,0,1,0
7_5001178,location_city2-1,5001178,7,1,0,1,0
6_4017012,load-truck_package3_truck5_city5-1,4017012,6,4,169,173,0
5_7434831,at_package3_city5-1,7434831,5,0,1,1,0
7_5001179,location_city2-2,5001179,7,1,0,1,0
7_3715160,airplane_plane1,3715160,7,1,0,1,0
6_5175963,noop_at_package2_city2-2,5175963,6,0,109,109,0
5_3030602,at_package2_city2-2,3030602,5,0,5,5,0
6_6912463,unload-truck_package1_truck10_city10-1,6912463,6,5,152,157,0
7_2140121,at_package1_city10-1,2140121,7,1,34,35,0
6_1608163,load-airplane_package2_plane2_city6-2,1608163,6,5,281,286,0
6_5684713,load-airplane_package2_plane3_city4-2,5684713,6,5,281,286,0
7_5459930,location_city9-1,5459930,7,1,0,1,0
7_3715161,airplane_plane2,3715161,7,1,0,1,0
6_3635164,load-truck_package3_truck10_city10-1,3635164,6,4,170,174,0
5_4179772,at_package3_city10-1,4179772,5,0,1,1,0
7_2816590,in-city_city8-1_city8,2816590,7,1,0,1,0
7_5459931,location_city9-2,5459931,7,1,0,1,0
6_1579215,noop_at_package3_city5-1,1579215,6,1,167,168,0
7_3715162,airplane_plane3,3715162,7,1,0,1,0
7_519912,airport_city7-2,519912,7,1,0,1,0
6_5655765,noop_at_package4_city3-1,5655765,6,1,167,168,0
6_5634715,noop_at_package2_city9-2,5634715,6,0,109,109,0
5_3489354,at_package2_city9-2,3489354,5,0,5,5,0
6_2085115,unload-truck_package5_truck8_city8-1,2085115,6,5,151,156,0
7_44729,at_package5_city8-1,44729,7,1,35,36,0
7_3143541,in-city_city1-2_city1,3143541,7,1,0,1,0
7_3715163,airplane_plane4,3715163,7,1,0,1,0
6_2087966,load-airplane_package2_plane4_city7-2,2087966,6,5,281,286,0
6_3285467,load-truck_package2_truck6_city6-2,3285467,6,5,121,126,0
7_7382455,in_package2_truck6,7382455,7,1,28,29,0
6_2111417,load-truck_package4_truck9_city9-1,2111417,6,4,169,173,0
5_3903620,at_package4_city9-1,3903620,5,0,1,1,0
6_5401518,load-airplane_package2_plane1_city6-2,5401518,6,5,281,286,0
7_6609944,in-city_city7-1_city7,6609944,7,1,0,1,0
6_1346019,load-airplane_package2_plane2_city2-2,1346019,6,5,281,286,0
6_4203219,load-truck_package4_truck2_city2-1,4203219,6,4,167,171,0
5_3444868,at_package4_city2-1,3444868,5,0,1,1,0
7_5197786,location_city5-1,5197786,7,1,0,1,0
7_7566596,location_city10-1,7566596,7,1,0,1,0
7_5197787,location_city5-2,5197787,7,1,0,1,0
6_1317071,noop_at_package3_city1-1,1317071,6,0,165,165,0
5_7172687,at_package3_city1-1,7172687,5,0,1,1,0
7_257768,airport_city3-2,257768,7,1,0,1,0
6_5372571,noop_at_package2_city5-2,5372571,6,0,109,109,0
5_3227210,at_package2_city5-2,3227210,5,0,5,5,0
6_1804771,load-airplane_package2_plane2_city9-2,1804771,6,5,281,286,0
6_5881321,load-airplane_package2_plane3_city7-2,5881321,6,5,281,286,0
7_7566597,location_city10-2,7566597,7,1,0,1,0
6_1796072,unload-truck_package1_truck7_city7-1,1796072,6,5,149,154,0
7_7151636,at_package1_city7-1,7151636,7,1,35,36,0
6_1825822,load-airplane_package2_plane4_city3-2,1825822,6,5,281,286,0
7_4386348,in-city_city7-2_city7,4386348,7,1,0,1,0
6_1775823,noop_at_package3_city8-1,1775823,6,0,167,167,0
5_7631439,at_package3_city8-1,7631439,5,0,1,1,0
7_2402321,in-city_city6-1_city6,2402321,7,1,0,1,0
6_5852373,noop_at_package4_city6-1,5852373,6,0,167,167,0
5_3707012,at_package4_city6-1,3707012,5,0,1,1,0
6_6358273,unload-truck_package5_truck9_city9-1,6358273,6,5,151,156,0
7_110265,at_package5_city9-1,110265,7,1,35,36,0
6_5139374,load-airplane_package2_plane1_city2-2,5139374,6,5,281,286,0
6_1324775,noop_at_package3_city10-1,1324775,6,1,168,169,0
6_7558625,load-truck_package2_truck7_city7-2,7558625,6,5,120,125,0
7_7382456,in_package2_truck7,7382456,7,1,27,28,0
7_4935642,location_city1-1,4935642,7,1,0,1,0
6_1539776,unload-truck_package5_truck6_city6-1,1539776,6,5,151,156,0
7_7914634,at_package5_city6-1,7914634,7,1,35,36,0
6_5598126,load-airplane_package2_plane1_city9-2,5598126,6,5,281,286,0
7_4935643,location_city1-2,4935643,7,1,0,1,0
7_178725,in-city_city6-2_city6,178725,7,1,0,1,0
6_5110427,noop_at_package2_city1-2,5110427,6,1,109,110,0
6_1542627,load-airplane_package2_plane2_city5-2,1542627,6,5,281,286,0
6_5619177,load-airplane_package2_plane3_city3-2,5619177,6,5,281,286,0
7_5394394,location_city8-1,5394394,7,1,0,1,0
6_2740128,load-truck_package2_truck4_city4-2,2740128,6,5,121,126,0
7_7382453,in_package2_truck4,7382453,7,1,25,26,0
7_5394395,location_city8-2,5394395,7,1,0,1,0
6_1513679,noop_at_package3_city4-1,1513679,6,0,167,167,0
5_7369295,at_package3_city4-1,7369295,5,0,1,1,0
7_454376,airport_city6-2,454376,7,1,0,1,0
6_5590229,noop_at_package4_city2-1,5590229,6,1,165,166,0
6_5569179,noop_at_package2_city8-2,5569179,6,1,109,110,0
6_6069230,unload-truck_package1_truck8_city8-1,6069230,6,5,151,156,0
7_7217172,at_package1_city8-1,7217172,7,1,34,35,0
6_2022430,load-airplane_package2_plane4_city6-2,2022430,6,5,281,286,0
6_6048981,noop_at_package4_city9-1,6048981,6,1,167,168,0
7_5781406,in-city_city3-1_city3,5781406,7,1,0,1,0
6_7744831,load-truck_package3_truck4_city4-1,7744831,6,5,169,174,0
6_5335982,load-airplane_package2_plane1_city5-2,5335982,6,5,281,286,0
6_834532,load-truck_package3_truck8_city8-1,834532,6,5,169,174,0
6_1250733,unload-truck_package1_truck5_city5-1,1250733,6,5,151,156,0
7_7020564,at_package1_city5-1,7020564,7,1,34,35,0
6_1280483,load-airplane_package2_plane2_city1-2,1280483,6,5,281,286,0
7_5132250,location_city4-1,5132250,7,1,0,1,0
6_5812934,unload-truck_package5_truck7_city7-1,5812934,6,5,149,154,0
7_7980170,at_package5_city7-1,7980170,7,1,35,36,0
6_2926334,load-truck_package3_truck1_city1-1,2926334,6,5,167,172,0
7_1573783,in-city_city2-1_city2,1573783,7,1,0,1,0
7_192232,airport_city2-2,192232,7,1,0,1,0
6_5307035,noop_at_package2_city4-2,5307035,6,1,109,110,0
7_3557810,in-city_city3-2_city3,3557810,7,1,0,1,0
7_5132251,location_city4-2,5132251,7,1,0,1,0
7_7347850,in-city_city10-2_city10,7347850,7,1,0,1,0
6_1739235,load-airplane_package2_plane2_city8-2,1739235,6,5,281,286,0
6_5815785,load-airplane_package2_plane3_city6-2,5815785,6,5,281,286,0
7_2661380,truck_truck1,2661380,7,1,0,1,0
6_1760286,load-airplane_package2_plane4_city2-2,1760286,6,5,281,286,0
6_7013286,load-truck_package2_truck5_city5-2,7013286,6,5,121,126,0
7_7382454,in_package2_truck5,7382454,7,1,26,27,0
6_5839236,load-truck_package4_truck8_city8-1,5839236,6,4,169,173,0
5_3838084,at_package4_city8-1,3838084,5,0,1,1,0
7_650984,airport_city9-2,650984,7,1,0,1,0
7_2661381,truck_truck2,2661381,7,1,0,1,0
6_5786837,noop_at_package4_city5-1,5786837,6,0,167,167,0
5_3641476,at_package4_city5-1,3641476,5,0,1,1,0
6_1710287,noop_at_package3_city7-1,1710287,6,1,167,168,0
6_994437,unload-truck_package5_truck4_city4-1,994437,6,5,151,156,0
7_7783562,at_package5_city4-1,7783562,7,1,34,35,0
6_102987,load-truck_package2_truck9_city9-2,102987,6,5,121,126,0
7_7382458,in_package2_truck9,7382458,7,1,29,30,0
7_2661382,truck_truck3,2661382,7,1,0,1,0
7_7024213,in-city_city9-1_city9,7024213,7,1,0,1,0
6_5073838,load-airplane_package2_plane1_city1-2,5073838,6,5,281,286,0
6_2219038,load-airplane_package2_plane4_city9-2,2219038,6,5,281,286,0
6_7931038,load-truck_package4_truck1_city1-1,7931038,6,4,167,171,0
5_3379332,at_package4_city1-1,3379332,5,0,1,1,0
7_2661383,truck_truck4,2661383,7,1,0,1,0
7_7351164,in-city_city2-2_city2,7351164,7,1,0,1,0
6_6345089,noop_at_package4_city10-1,6345089,6,0,168,168,0
5_1199109,at_package4_city10-1,1199109,5,0,1,1,0
6_2194789,load-truck_package2_truck2_city2-2,2194789,6,5,122,127,0
7_7382451,in_package2_truck2,7382451,7,1,23,24,0
6_1020739,load-truck_package4_truck5_city5-1,1020739,6,5,169,174,0
7_2661384,truck_truck5,2661384,7,1,0,1,0
6_5532590,load-airplane_package2_plane1_city8-2,5532590,6,5,281,286,0
6_5107690,load-truck_package3_truck9_city9-1,5107690,6,5,169,174,0
7_2661385,truck_truck6,2661385,7,1,0,1,0
6_5523891,unload-truck_package1_truck6_city6-1,5523891,6,5,151,156,0
7_7086100,at_package1_city6-1,7086100,7,1,0,1,0
6_7835241,unload-truck_package5_truck10_city10-1,7835241,6,5,152,157,0
7_6219423,at_package5_city10-1,6219423,7,1,34,35,0
6_1477091,load-airplane_package2_plane2_city4-2,1477091,6,5,281,286,0
6_5553641,load-airplane_package2_plane3_city2-2,5553641,6,5,281,286,0
7_2661386,truck_truck7,2661386,7,1,0,1,0
7_4800617,in-city_city9-2_city9,4800617,7,1,0,1,0
7_5328858,location_city7-1,5328858,7,1,0,1,0
6_7199492,load-truck_package3_truck2_city2-1,7199492,6,5,167,172,0
7_6497292,city_city1,6497292,7,1,0,1,0
7_388840,airport_city5-2,388840,7,1,0,1,0
7_2661387,truck_truck8,2661387,7,1,0,1,0
6_5524693,noop_at_package4_city1-1,5524693,6,1,165,166,0
6_5503643,noop_at_package2_city7-2,5503643,6,1,109,110,0
7_5328859,location_city7-2,5328859,7,1,0,1,0
6_6012393,load-airplane_package2_plane3_city9-2,6012393,6,5,281,286,0
6_289193,load-truck_package3_truck6_city6-1,289193,6,5,169,174,0
7_6497293,city_city2,6497293,7,1,0,1,0
7_2661388,truck_truck9,2661388,7,1,0,1,0
7_518082,in-city_city10-1_city10,518082,7,1,0,1,0
6_705394,unload-truck_package1_truck3_city3-1,705394,6,5,149,154,0
7_6889492,at_package1_city3-1,6889492,7,1,35,36,0
6_1956894,load-airplane_package2_plane4_city5-2,1956894,6,5,281,286,0
7_6497294,city_city3,6497294,7,1,0,1,0
7_4435789,obj_package1,4435789,7,1,0,1,0
6_5983445,noop_at_package4_city8-1,5983445,6,1,167,168,0
6_5267595,unload-truck_package5_truck5_city5-1,5267595,6,5,151,156,0
7_7849098,at_package5_city5-1,7849098,7,1,35,36,0
7_6497295,city_city4,6497295,7,1,0,1,0
7_592994,in-city_city8-2_city8,592994,7,1,0,1,0
7_4435790,obj_package2,4435790,7,1,0,1,0
6_5270446,load-airplane_package2_plane1_city4-2,5270446,6,5,281,286,0
7_6497296,city_city5,6497296,7,1,0,1,0
7_4435791,obj_package3,4435791,7,1,0,1,0
6_6467947,load-truck_package2_truck3_city3-2,6467947,6,5,120,125,0
7_7382452,in_package2_truck3,7382452,7,1,25,26,0
6_7866347,load-truck_package4_truck10_city10-1,7866347,6,5,170,175,0
6_5293897,load-truck_package4_truck6_city6-1,5293897,6,5,169,174,0
7_6497297,city_city6,6497297,7,1,0,1,0
7_4435792,obj_package4,4435792,7,1,0,1,0
7_5066714,location_city3-1,5066714,7,1,0,1,0
6_449098,unload-truck_package5_truck2_city2-1,449098,6,5,151,156,0
7_7652490,at_package5_city2-1,7652490,7,1,35,36,0
7_6497298,city_city7,6497298,7,1,0,1,0
7_126696,airport_city1-2,126696,7,1,0,1,0
7_4435793,obj_package5,4435793,7,1,0,1,0
6_5241499,noop_at_package2_city3-2,5241499,6,1,109,110,0
7_5066715,location_city3-2,5066715,7,1,0,1,0
6_1673699,load-airplane_package2_plane2_city7-2,1673699,6,5,281,286,0
6_5750249,load-airplane_package2_plane3_city5-2,5750249,6,5,281,286,0
8_5646949,in_package1_plane4,5646949,8,32,0,32,0
8_5646948,in_package1_plane3,5646948,8,32,0,32,0
8_5646947,in_package1_plane2,5646947,8,32,0,32,0
8_5646946,in_package1_plane1,5646946,8,32,0,32,0
8_6889493,at_package1_city3-2,6889493,8,32,0,32,0
8_6889492,at_package1_city3-1,6889492,8,34,0,34,0
8_552690,in_package1_truck9,552690,8,32,0,32,0
8_552689,in_package1_truck8,552689,8,32,0,32,0
8_552688,in_package1_truck7,552688,8,32,0,32,0
8_7151637,at_package1_city7-2,7151637,8,32,0,32,0
8_552687,in_package1_truck6,552687,8,32,0,32,0
8_552686,in_package1_truck5,552686,8,32,0,32,0
8_7151636,at_package1_city7-1,7151636,8,34,0,34,0
8_552685,in_package1_truck4,552685,8,32,0,32,0
8_552684,in_package1_truck3,552684,8,32,0,32,0
8_552683,in_package1_truck2,552683,8,32,0,32,0
8_552682,in_package1_truck1,552682,8,32,0,32,0
8_5470031,in_package1_truck10,5470031,8,32,0,32,0
8_6955029,at_package1_city4-2,6955029,8,32,0,32,0
8_6955028,at_package1_city4-1,6955028,8,34,0,34,0
8_7217173,at_package1_city8-2,7217173,8,32,0,32,0
8_2140122,at_package1_city10-2,2140122,8,32,0,32,0
8_7217172,at_package1_city8-1,7217172,8,34,0,34,0
8_6758421,at_package1_city1-2,6758421,8,32,0,32,0
8_2140121,at_package1_city10-1,2140121,8,33,0,33,0
8_6758420,at_package1_city1-1,6758420,8,34,0,34,0
8_7020565,at_package1_city5-2,7020565,8,32,0,32,0
8_7020564,at_package1_city5-1,7020564,8,34,0,34,0
8_7282709,at_package1_city9-2,7282709,8,32,0,32,0
8_1642758,at_truck6_city6-2,1642758,8,2,0,2,0
8_7282708,at_package1_city9-1,7282708,8,34,0,34,0
8_6823957,at_package1_city2-2,6823957,8,32,0,32,0
8_6823956,at_package1_city2-1,6823956,8,32,0,32,0
8_7382455,in_package2_truck6,7382455,8,28,0,28,0
8_7086101,at_package1_city6-2,7086101,8,32,0,32,0
8_4279898,at_truck1_city1-1,4279898,8,1,0,1,0
8_3292746,at_package2_city6-2,3292746,8,23,0,23,0
8_4475740,in_package2_plane4,4475740,8,23,0,23,0
8_4475739,in_package2_plane3,4475739,8,23,0,23,0
8_3096138,at_package2_city3-2,3096138,8,23,0,23,0
8_4475738,in_package2_plane2,4475738,8,23,0,23,0
8_7172687,at_package3_city1-1,7172687,8,33,0,33,0
8_4475737,in_package2_plane1,4475737,8,23,0,23,0
8_7160436,at_package2_city10-2,7160436,8,23,0,23,0
8_7160435,at_package2_city10-1,7160435,8,23,0,23,0
8_3358282,at_package2_city7-2,3358282,8,23,0,23,0
8_3379332,at_package4_city1-1,3379332,8,33,0,33,0
8_1676676,in_package2_truck10,1676676,8,23,0,23,0
8_3161674,at_package2_city4-2,3161674,8,23,0,23,0
8_3423818,at_package2_city8-2,3423818,8,23,0,23,0
8_2965066,at_package2_city1-2,2965066,8,23,0,23,0
8_3227210,at_package2_city5-2,3227210,8,23,0,23,0
8_7382458,in_package2_truck9,7382458,8,28,0,28,0
8_7382457,in_package2_truck8,7382457,8,28,0,28,0
8_7382456,in_package2_truck7,7382456,8,27,0,27,0
8_3489354,at_package2_city9-2,3489354,8,23,0,23,0
8_7382454,in_package2_truck5,7382454,8,28,0,28,0
8_7382453,in_package2_truck4,7382453,8,28,0,28,0
8_3030602,at_package2_city2-2,3030602,8,23,0,23,0
8_7382452,in_package2_truck3,7382452,8,27,0,27,0
8_7382451,in_package2_truck2,7382451,8,27,0,27,0
8_4116148,fly-airplane_plane3_city10-2_city3-2,4116148,8,0,0,0,0
8_4378292,fly-airplane_plane3_city10-2_city7-2,4378292,8,0,0,0,0
8_4181684,fly-airplane_plane3_city10-2_city4-2,4181684,8,0,0,0,0
8_4443828,fly-airplane_plane3_city10-2_city8-2,4443828,8,0,0,0,0
8_3985076,fly-airplane_plane3_city10-2_city1-2,3985076,8,0,0,0,0
8_4247220,fly-airplane_plane3_city10-2_city5-2,4247220,8,0,0,0,0
8_4509364,fly-airplane_plane3_city10-2_city9-2,4509364,8,0,0,0,0
8_4050612,fly-airplane_plane3_city10-2_city2-2,4050612,8,0,0,0,0
8_4312756,fly-airplane_plane3_city10-2_city6-2,4312756,8,0,0,0,0
8_4904399,at_plane3_city6-2,4904399,8,8,0,8,0
8_4707791,at_plane3_city3-2,4707791,8,8,0,8,0
8_4969935,at_plane3_city7-2,4969935,8,8,0,8,0
8_4773327,at_plane3_city4-2,4773327,8,8,0,8,0
8_5035471,at_plane3_city8-2,5035471,8,8,0,8,0
8_4576719,at_plane3_city1-2,4576719,8,8,0,8,0
8_4838863,at_plane3_city5-2,4838863,8,8,0,8,0
8_5101007,at_plane3_city9-2,5101007,8,8,0,8,0
8_4642255,at_plane3_city2-2,4642255,8,8,0,8,0
8_5918196,fly-airplane_plane4_city2-2_city5-2,5918196,8,0,0,0,0
8_6180340,fly-airplane_plane4_city2-2_city9-2,6180340,8,0,0,0,0
8_5983732,fly-airplane_plane4_city2-2_city6-2,5983732,8,0,0,0,0
8_7968830,fly-airplane_plane4_city2-2_city10-2,7968830,8,0,0,0,0
8_5787124,fly-airplane_plane4_city2-2_city3-2,5787124,8,0,0,0,0
8_6049268,fly-airplane_plane4_city2-2_city7-2,6049268,8,0,0,0,0
8_5852660,fly-airplane_plane4_city2-2_city4-2,5852660,8,0,0,0,0
8_6114804,fly-airplane_plane4_city2-2_city8-2,6114804,8,0,0,0,0
8_5656052,fly-airplane_plane4_city2-2_city1-2,5656052,8,0,0,0,0
8_1111044,at_plane4_city6-2,1111044,8,8,0,8,0
8_712137,at_plane4_city10-2,712137,8,8,0,8,0
8_914436,at_plane4_city3-2,914436,8,8,0,8,0
8_1176580,at_plane4_city7-2,1176580,8,8,0,8,0
8_979972,at_plane4_city4-2,979972,8,8,0,8,0
8_1242116,at_plane4_city8-2,1242116,8,8,0,8,0
8_783364,at_plane4_city1-2,783364,8,8,0,8,0
8_1045508,at_plane4_city5-2,1045508,8,8,0,8,0
8_1307652,at_plane4_city9-2,1307652,8,8,0,8,0
8_7652490,at_package5_city2-1,7652490,8,34,0,34,0
8_552079,at_truck2_city2-1,552079,8,1,0,1,0
8_7238223,at_package3_city2-1,7238223,8,33,0,33,0
8_3444868,at_package4_city2-1,3444868,8,33,0,33,0
8_7382450,in_package2_truck1,7382450,8,27,0,27,0
8_6281740,load-truck_package1_truck6_city6-2,6281740,8,0,0,0,0
8_4604436,load-airplane_package1_plane2_city6-2,4604436,8,0,0,0,0
8_811081,load-airplane_package1_plane3_city6-2,811081,8,0,0,0,0
8_396814,load-airplane_package1_plane1_city6-2,396814,8,0,0,0,0
8_5018703,load-airplane_package1_plane4_city6-2,5018703,8,0,0,0,0
8_7086100,at_package1_city6-1,7086100,8,34,0,34,0
8_4825237,at_truck3_city3-1,4825237,8,1,0,1,0
8_7718026,at_package5_city3-1,7718026,8,34,0,34,0
8_3510404,at_package4_city3-1,3510404,8,33,0,33,0
8_5731397,fly-airplane_plane1_city1-2_city5-2,5731397,8,0,0,0,0
8_5993541,fly-airplane_plane1_city1-2_city9-2,5993541,8,0,0,0,0
8_5534789,fly-airplane_plane1_city1-2_city2-2,5534789,8,0,0,0,0
8_5796933,fly-airplane_plane1_city1-2_city6-2,5796933,8,0,0,0,0
8_5600325,fly-airplane_plane1_city1-2_city3-2,5600325,8,0,0,0,0
8_153171,fly-airplane_plane1_city1-2_city10-2,153171,8,0,0,0,0
8_5862469,fly-airplane_plane1_city1-2_city7-2,5862469,8,0,0,0,0
8_5665861,fly-airplane_plane1_city1-2_city4-2,5665861,8,0,0,0,0
8_5928005,fly-airplane_plane1_city1-2_city8-2,5928005,8,0,0,0,0
8_1653149,at_plane1_city10-2,1653149,8,8,0,8,0
8_4424596,at_plane1_city5-2,4424596,8,8,0,8,0
8_4686740,at_plane1_city9-2,4686740,8,8,0,8,0
8_4227988,at_plane1_city2-2,4227988,8,8,0,8,0
8_4490132,at_plane1_city6-2,4490132,8,8,0,8,0
8_4293524,at_plane1_city3-2,4293524,8,8,0,8,0
8_4555668,at_plane1_city7-2,4555668,8,8,0,8,0
8_4359060,at_plane1_city4-2,4359060,8,8,0,8,0
8_4621204,at_plane1_city8-2,4621204,8,8,0,8,0
8_1287295,fly-airplane_plane4_city9-2_city6-2,1287295,8,0,0,0,0
8_1090687,fly-airplane_plane4_city9-2_city3-2,1090687,8,0,0,0,0
8_1352831,fly-airplane_plane4_city9-2_city7-2,1352831,8,0,0,0,0
8_1156223,fly-airplane_plane4_city9-2_city4-2,1156223,8,0,0,0,0
8_1418367,fly-airplane_plane4_city9-2_city8-2,1418367,8,0,0,0,0
8_959615,fly-airplane_plane4_city9-2_city1-2,959615,8,0,0,0,0
8_1221759,fly-airplane_plane4_city9-2_city5-2,1221759,8,0,0,0,0
8_5827508,fly-airplane_plane4_city9-2_city10-2,5827508,8,0,0,0,0
8_1025151,fly-airplane_plane4_city9-2_city2-2,1025151,8,0,0,0,0
8_848900,at_plane4_city2-2,848900,8,8,0,8,0
8_5553641,load-airplane_package2_plane3_city2-2,5553641,8,0,0,0,0
8_2194789,load-truck_package2_truck2_city2-2,2194789,8,0,0,0,0
8_1760286,load-airplane_package2_plane4_city2-2,1760286,8,0,0,0,0
8_5139374,load-airplane_package2_plane1_city2-2,5139374,8,0,0,0,0
8_1346019,load-airplane_package2_plane2_city2-2,1346019,8,0,0,0,0
8_7369295,at_package3_city4-1,7369295,8,33,0,33,0
8_3575940,at_package4_city4-1,3575940,8,33,0,33,0
8_1097418,at_truck4_city4-1,1097418,8,1,0,1,0
8_7783562,at_package5_city4-1,7783562,8,34,0,34,0
8_4562351,load-truck_package3_truck7_city7-1,4562351,8,0,0,0,0
8_6211249,in_package3_truck9,6211249,8,32,0,32,0
8_5884298,in_package3_truck10,5884298,8,32,0,32,0
8_6211248,in_package3_truck8,6211248,8,32,0,32,0
8_6211247,in_package3_truck7,6211247,8,32,0,32,0
8_6211246,in_package3_truck6,6211246,8,32,0,32,0
8_7369296,at_package3_city4-2,7369296,8,32,0,32,0
8_6211245,in_package3_truck5,6211245,8,32,0,32,0
8_6211244,in_package3_truck4,6211244,8,32,0,32,0
8_6211243,in_package3_truck3,6211243,8,32,0,32,0
8_6211242,in_package3_truck2,6211242,8,32,0,32,0
8_6211241,in_package3_truck1,6211241,8,32,0,32,0
8_7631440,at_package3_city8-2,7631440,8,32,0,32,0
8_7631439,at_package3_city8-1,7631439,8,33,0,33,0
8_7172688,at_package3_city1-2,7172688,8,32,0,32,0
8_7565904,at_package3_city7-2,7565904,8,32,0,32,0
8_7303759,at_package3_city3-1,7303759,8,32,0,32,0
8_7303760,at_package3_city3-2,7303760,8,32,0,32,0
8_7500367,at_package3_city6-1,7500367,8,33,0,33,0
8_7500368,at_package3_city6-2,7500368,8,32,0,32,0
8_4179772,at_package3_city10-1,4179772,8,32,0,32,0
8_4179773,at_package3_city10-2,4179773,8,32,0,32,0
8_7238224,at_package3_city2-2,7238224,8,32,0,32,0
8_7696975,at_package3_city9-1,7696975,8,33,0,33,0
8_7696976,at_package3_city9-2,7696976,8,32,0,32,0
8_3304528,in_package3_plane1,3304528,8,32,0,32,0
8_3304529,in_package3_plane2,3304529,8,32,0,32,0
8_3304530,in_package3_plane3,3304530,8,32,0,32,0
8_7434831,at_package3_city5-1,7434831,8,33,0,33,0
8_3304531,in_package3_plane4,3304531,8,32,0,32,0
8_7434832,at_package3_city5-2,7434832,8,32,0,32,0
8_7849098,at_package5_city5-1,7849098,8,34,0,34,0
8_3641476,at_package4_city5-1,3641476,8,33,0,33,0
8_5370576,at_truck5_city5-1,5370576,8,1,0,1,0
8_2885048,load-airplane_package3_plane3_city7-2,2885048,8,0,0,0,0
8_2470781,load-airplane_package3_plane1_city7-2,2470781,8,0,0,0,0
8_7092670,load-airplane_package3_plane4_city7-2,7092670,8,0,0,0,0
8_6678403,load-airplane_package3_plane2_city7-2,6678403,8,0,0,0,0
8_4562352,load-truck_package3_truck7_city7-2,4562352,8,0,0,0,0
8_7565903,at_package3_city7-1,7565903,8,33,0,33,0
8_1100496,fly-airplane_plane1_city8-2_city6-2,1100496,8,0,0,0,0
8_903888,fly-airplane_plane1_city8-2_city3-2,903888,8,0,0,0,0
8_1166032,fly-airplane_plane1_city8-2_city7-2,1166032,8,0,0,0,0
8_6012826,fly-airplane_plane1_city8-2_city10-2,6012826,8,0,0,0,0
8_969424,fly-airplane_plane1_city8-2_city4-2,969424,8,0,0,0,0
8_772816,fly-airplane_plane1_city8-2_city1-2,772816,8,0,0,0,0
8_1034960,fly-airplane_plane1_city8-2_city5-2,1034960,8,0,0,0,0
8_1297104,fly-airplane_plane1_city8-2_city9-2,1297104,8,0,0,0,0
8_838352,fly-airplane_plane1_city8-2_city2-2,838352,8,0,0,0,0
8_4162452,at_plane1_city1-2,4162452,8,8,0,8,0
8_5227117,drive-truck_truck9_city9-1_city9-2_city9,5227117,8,0,0,0,0
8_6461255,at_truck9_city9-2,6461255,8,2,0,2,0
8_4934765,load-truck_package5_truck1_city1-1,4934765,8,0,0,0,0
8_7849099,at_package5_city5-2,7849099,8,32,0,32,0
8_7652491,at_package5_city2-2,7652491,8,32,0,32,0
8_7914634,at_package5_city6-1,7914634,8,34,0,34,0
8_44729,at_package5_city8-1,44729,8,34,0,34,0
8_6219423,at_package5_city10-1,6219423,8,33,0,33,0
8_7980170,at_package5_city7-1,7980170,8,34,0,34,0
8_110265,at_package5_city9-1,110265,8,34,0,34,0
8_3868831,in_package5_truck9,3868831,8,32,0,32,0
8_44730,at_package5_city8-2,44730,8,32,0,32,0
8_3868830,in_package5_truck8,3868830,8,32,0,32,0
8_3868829,in_package5_truck7,3868829,8,32,0,32,0
8_3868828,in_package5_truck6,3868828,8,32,0,32,0
8_7718027,at_package5_city3-2,7718027,8,32,0,32,0
8_3868827,in_package5_truck5,3868827,8,32,0,32,0
8_3868826,in_package5_truck4,3868826,8,32,0,32,0
8_3868825,in_package5_truck3,3868825,8,32,0,32,0
8_6219424,at_package5_city10-2,6219424,8,32,0,32,0
8_3868824,in_package5_truck2,3868824,8,32,0,32,0
8_3868823,in_package5_truck1,3868823,8,32,0,32,0
8_7980171,at_package5_city7-2,7980171,8,32,0,32,0
8_110266,at_package5_city9-2,110266,8,32,0,32,0
8_6298565,in_package5_truck10,6298565,8,32,0,32,0
8_7783563,at_package5_city4-2,7783563,8,32,0,32,0
8_962113,in_package5_plane4,962113,8,32,0,32,0
8_962112,in_package5_plane3,962112,8,32,0,32,0
8_962111,in_package5_plane2,962111,8,32,0,32,0
8_962110,in_package5_plane1,962110,8,32,0,32,0
8_7586955,at_package5_city1-2,7586955,8,32,0,32,0
8_7914635,at_package5_city6-2,7914635,8,32,0,32,0
8_475400,load-truck_package4_truck3_city3-1,475400,8,0,0,0,0
8_3772549,at_package4_city7-2,3772549,8,32,0,32,0
8_3772548,at_package4_city7-1,3772548,8,32,0,32,0
8_2090943,in_package4_truck10,2090943,8,32,0,32,0
8_3575941,at_package4_city4-2,3575941,8,32,0,32,0
8_5040040,in_package4_truck9,5040040,8,32,0,32,0
8_5040039,in_package4_truck8,5040039,8,32,0,32,0
8_5040038,in_package4_truck7,5040038,8,32,0,32,0
8_5040037,in_package4_truck6,5040037,8,32,0,32,0
8_5040036,in_package4_truck5,5040036,8,32,0,32,0
8_3838085,at_package4_city8-2,3838085,8,32,0,32,0
8_3510405,at_package4_city3-2,3510405,8,32,0,32,0
8_1199109,at_package4_city10-1,1199109,8,32,0,32,0
8_1199110,at_package4_city10-2,1199110,8,32,0,32,0
8_3707012,at_package4_city6-1,3707012,8,33,0,33,0
8_3707013,at_package4_city6-2,3707013,8,32,0,32,0
8_2133319,in_package4_plane1,2133319,8,32,0,32,0
8_3444869,at_package4_city2-2,3444869,8,32,0,32,0
8_3903620,at_package4_city9-1,3903620,8,33,0,33,0
8_2133320,in_package4_plane2,2133320,8,32,0,32,0
8_2133321,in_package4_plane3,2133321,8,32,0,32,0
8_3903621,at_package4_city9-2,3903621,8,32,0,32,0
8_2133322,in_package4_plane4,2133322,8,32,0,32,0
8_3641477,at_package4_city5-2,3641477,8,32,0,32,0
8_5040032,in_package4_truck1,5040032,8,32,0,32,0
8_5040033,in_package4_truck2,5040033,8,32,0,32,0
8_3379333,at_package4_city1-2,3379333,8,32,0,32,0
8_3838084,at_package4_city8-1,3838084,8,33,0,33,0
8_5040034,in_package4_truck3,5040034,8,32,0,32,0
8_5040035,in_package4_truck4,5040035,8,32,0,32,0
8_6012393,load-airplane_package2_plane3_city9-2,6012393,8,1,0,1,0
8_2219038,load-airplane_package2_plane4_city9-2,2219038,8,1,0,1,0
8_102987,load-truck_package2_truck9_city9-2,102987,8,1,0,1,0
8_5598126,load-airplane_package2_plane1_city9-2,5598126,8,1,0,1,0
8_1804771,load-airplane_package2_plane2_city9-2,1804771,8,1,0,1,0
8_1642757,at_truck6_city6-1,1642757,8,1,0,1,0
8_7213341,load-airplane_package4_plane1_city3-2,7213341,8,0,0,0,0
8_3419986,load-airplane_package4_plane2_city3-2,3419986,8,0,0,0,0
8_7627608,load-airplane_package4_plane3_city3-2,7627608,8,0,0,0,0
8_3834253,load-airplane_package4_plane4_city3-2,3834253,8,0,0,0,0
8_475401,load-truck_package4_truck3_city3-2,475401,8,0,0,0,0
8_6106147,fly-airplane_plane2_city4-2_city8-2,6106147,8,0,0,0,0
8_5647395,fly-airplane_plane2_city4-2_city1-2,5647395,8,0,0,0,0
8_5909539,fly-airplane_plane2_city4-2_city5-2,5909539,8,0,0,0,0
8_5752638,fly-airplane_plane2_city4-2_city10-2,5752638,8,0,0,0,0
8_6171683,fly-airplane_plane2_city4-2_city9-2,6171683,8,0,0,0,0
8_5712931,fly-airplane_plane2_city4-2_city2-2,5712931,8,0,0,0,0
8_5975075,fly-airplane_plane2_city4-2_city6-2,5975075,8,0,0,0,0
8_5778467,fly-airplane_plane2_city4-2_city3-2,5778467,8,0,0,0,0
8_6040611,fly-airplane_plane2_city4-2_city7-2,6040611,8,0,0,0,0
8_827849,at_plane2_city8-2,827849,8,8,0,8,0
8_369097,at_plane2_city1-2,369097,8,8,0,8,0
8_631241,at_plane2_city5-2,631241,8,8,0,8,0
8_893385,at_plane2_city9-2,893385,8,8,0,8,0
8_696777,at_plane2_city6-2,696777,8,8,0,8,0
8_500169,at_plane2_city3-2,500169,8,8,0,8,0
8_6673463,at_plane2_city10-2,6673463,8,8,0,8,0
8_762313,at_plane2_city7-2,762313,8,8,0,8,0
8_434633,at_plane2_city2-2,434633,8,8,0,8,0
8_4608148,fly-airplane_plane3_city2-2_city1-2,4608148,8,0,0,0,0
8_3737647,fly-airplane_plane3_city2-2_city10-2,3737647,8,0,0,0,0
8_4870292,fly-airplane_plane3_city2-2_city5-2,4870292,8,0,0,0,0
8_5132436,fly-airplane_plane3_city2-2_city9-2,5132436,8,0,0,0,0
8_4935828,fly-airplane_plane3_city2-2_city6-2,4935828,8,0,0,0,0
8_4739220,fly-airplane_plane3_city2-2_city3-2,4739220,8,0,0,0,0
8_5001364,fly-airplane_plane3_city2-2_city7-2,5001364,8,0,0,0,0
8_4804756,fly-airplane_plane3_city2-2_city4-2,4804756,8,0,0,0,0
8_5066900,fly-airplane_plane3_city2-2_city8-2,5066900,8,0,0,0,0
8_3692800,at_plane3_city10-2,3692800,8,8,0,8,0
8_2469652,drive-truck_truck9_city9-2_city9-1_city9,2469652,8,0,0,0,0
8_6461254,at_truck9_city9-1,6461254,8,1,0,1,0
8_4085996,load-airplane_package5_plane1_city1-2,4085996,8,0,0,0,0
8_292641,load-airplane_package5_plane2_city1-2,292641,8,0,0,0,0
8_4934766,load-truck_package5_truck1_city1-2,4934766,8,0,0,0,0
8_4500263,load-airplane_package5_plane3_city1-2,4500263,8,0,0,0,0
8_706908,load-airplane_package5_plane4_city1-2,706908,8,0,0,0,0
8_7586954,at_package5_city1-1,7586954,8,32,0,32,0
8_5915915,at_truck7_city7-1,5915915,8,1,0,1,0
8_5191061,load-truck_package1_truck2_city2-1,5191061,8,0,0,0,0
8_2188096,at_truck8_city8-1,2188096,8,1,0,1,0
8_239391,fly-airplane_plane3_city9-2_city6-2,239391,8,0,0,0,0
8_7912688,fly-airplane_plane3_city9-2_city1-2,7912688,8,0,0,0,0
8_42783,fly-airplane_plane3_city9-2_city3-2,42783,8,0,0,0,0
8_304927,fly-airplane_plane3_city9-2_city7-2,304927,8,0,0,0,0
8_1596325,fly-airplane_plane3_city9-2_city10-2,1596325,8,0,0,0,0
8_7978224,fly-airplane_plane3_city9-2_city2-2,7978224,8,0,0,0,0
8_108319,fly-airplane_plane3_city9-2_city4-2,108319,8,0,0,0,0
8_370463,fly-airplane_plane3_city9-2_city8-2,370463,8,0,0,0,0
8_173855,fly-airplane_plane3_city9-2_city5-2,173855,8,0,0,0,0
8_1298643,drive-truck_truck6_city6-1_city6-2_city6,1298643,8,0,0,0,0
8_4342292,load-airplane_package1_plane2_city2-2,4342292,8,0,0,0,0
8_548937,load-airplane_package1_plane3_city2-2,548937,8,0,0,0,0
8_134670,load-airplane_package1_plane1_city2-2,134670,8,0,0,0,0
8_5191062,load-truck_package1_truck2_city2-2,5191062,8,0,0,0,0
8_4756559,load-airplane_package1_plane4_city2-2,4756559,8,0,0,0,0
8_4982898,fly-airplane_plane4_city5-2_city4-2,4982898,8,0,0,0,0
8_5245042,fly-airplane_plane4_city5-2_city8-2,5245042,8,0,0,0,0
8_4786290,fly-airplane_plane4_city5-2_city1-2,4786290,8,0,0,0,0
8_1336137,fly-airplane_plane4_city5-2_city10-2,1336137,8,0,0,0,0
8_5310578,fly-airplane_plane4_city5-2_city9-2,5310578,8,0,0,0,0
8_4851826,fly-airplane_plane4_city5-2_city2-2,4851826,8,0,0,0,0
8_5113970,fly-airplane_plane4_city5-2_city6-2,5113970,8,0,0,0,0
8_4917362,fly-airplane_plane4_city5-2_city3-2,4917362,8,0,0,0,0
8_5179506,fly-airplane_plane4_city5-2_city7-2,5179506,8,0,0,0,0
8_6542155,drive-truck_truck6_city6-2_city6-1_city6,6542155,8,0,0,0,0
8_3471673,load-truck_package3_truck3_city3-1,3471673,8,0,0,0,0
8_4801044,load-airplane_package1_plane2_city9-2,4801044,8,0,0,0,0
8_1007689,load-airplane_package1_plane3_city9-2,1007689,8,0,0,0,0
8_593422,load-airplane_package1_plane1_city9-2,593422,8,0,0,0,0
8_5215311,load-airplane_package1_plane4_city9-2,5215311,8,0,0,0,0
8_3099260,load-truck_package1_truck9_city9-2,3099260,8,0,0,0,0
8_7866347,load-truck_package4_truck10_city10-1,7866347,8,0,0,0,0
8_7866348,load-truck_package4_truck10_city10-2,7866348,8,0,0,0,0
8_7075091,load-airplane_package4_plane3_city10-2,7075091,8,0,0,0,0
8_5035440,load-airplane_package4_plane1_city10-2,5035440,8,0,0,0,0
8_4094428,load-airplane_package4_plane4_city10-2,4094428,8,0,0,0,0
8_2054777,load-airplane_package4_plane2_city10-2,2054777,8,0,0,0,0
8_5058243,fly-airplane_plane1_city4-2_city8-2,5058243,8,0,0,0,0
8_4599491,fly-airplane_plane1_city4-2_city1-2,4599491,8,0,0,0,0
8_4861635,fly-airplane_plane1_city4-2_city5-2,4861635,8,0,0,0,0
8_5123779,fly-airplane_plane1_city4-2_city9-2,5123779,8,0,0,0,0
8_4665027,fly-airplane_plane1_city4-2_city2-2,4665027,8,0,0,0,0
8_4927171,fly-airplane_plane1_city4-2_city6-2,4927171,8,0,0,0,0
8_4730563,fly-airplane_plane1_city4-2_city3-2,4730563,8,0,0,0,0
8_4992707,fly-airplane_plane1_city4-2_city7-2,4992707,8,0,0,0,0
8_1521455,fly-airplane_plane1_city4-2_city10-2,1521455,8,0,0,0,0
8_2208637,load-airplane_package3_plane1_city3-2,2208637,8,0,0,0,0
8_6830526,load-airplane_package3_plane4_city3-2,6830526,8,0,0,0,0
8_3471674,load-truck_package3_truck3_city3-2,3471674,8,0,0,0,0
8_6416259,load-airplane_package3_plane2_city3-2,6416259,8,0,0,0,0
8_2622904,load-airplane_package3_plane3_city3-2,2622904,8,0,0,0,0
8_1269492,unload-airplane_package5_plane1_city4-2,1269492,8,0,0,0,0
8_1531636,unload-airplane_package5_plane1_city8-2,1531636,8,0,0,0,0
8_1072884,unload-airplane_package5_plane1_city1-2,1072884,8,0,0,0,0
8_1335028,unload-airplane_package5_plane1_city5-2,1335028,8,0,0,0,0
8_1597172,unload-airplane_package5_plane1_city9-2,1597172,8,0,0,0,0
8_1138420,unload-airplane_package5_plane1_city2-2,1138420,8,0,0,0,0
8_2820464,unload-airplane_package5_plane1_city10-2,2820464,8,0,0,0,0
8_1400564,unload-airplane_package5_plane1_city6-2,1400564,8,0,0,0,0
8_1203956,unload-airplane_package5_plane1_city3-2,1203956,8,0,0,0,0
8_1466100,unload-airplane_package5_plane1_city7-2,1466100,8,0,0,0,0
8_5750249,load-airplane_package2_plane3_city5-2,5750249,8,0,0,0,0
8_1956894,load-airplane_package2_plane4_city5-2,1956894,8,0,0,0,0
8_7013286,load-truck_package2_truck5_city5-2,7013286,8,0,0,0,0
8_5335982,load-airplane_package2_plane1_city5-2,5335982,8,0,0,0,0
8_1542627,load-airplane_package2_plane2_city5-2,1542627,8,0,0,0,0
8_5804794,unload-airplane_package5_plane2_city9-2,5804794,8,0,0,0,0
8_5346042,unload-airplane_package5_plane2_city2-2,5346042,8,0,0,0,0
8_5608186,unload-airplane_package5_plane2_city6-2,5608186,8,0,0,0,0
8_7840778,unload-airplane_package5_plane2_city10-2,7840778,8,0,0,0,0
8_5411578,unload-airplane_package5_plane2_city3-2,5411578,8,0,0,0,0
8_5673722,unload-airplane_package5_plane2_city7-2,5673722,8,0,0,0,0
8_5477114,unload-airplane_package5_plane2_city4-2,5477114,8,0,0,0,0
8_5739258,unload-airplane_package5_plane2_city8-2,5739258,8,0,0,0,0
8_5280506,unload-airplane_package5_plane2_city1-2,5280506,8,0,0,0,0
8_5542650,unload-airplane_package5_plane2_city5-2,5542650,8,0,0,0,0
8_1097419,at_truck4_city4-2,1097419,8,2,0,2,0
8_1749295,unload-airplane_package5_plane3_city5-2,1749295,8,0,0,0,0
8_2011439,unload-airplane_package5_plane3_city9-2,2011439,8,0,0,0,0
8_1552687,unload-airplane_package5_plane3_city2-2,1552687,8,0,0,0,0
8_1814831,unload-airplane_package5_plane3_city6-2,1814831,8,0,0,0,0
8_1618223,unload-airplane_package5_plane3_city3-2,1618223,8,0,0,0,0
8_1880367,unload-airplane_package5_plane3_city7-2,1880367,8,0,0,0,0
8_4860115,unload-airplane_package5_plane3_city10-2,4860115,8,0,0,0,0
8_1683759,unload-airplane_package5_plane3_city4-2,1683759,8,0,0,0,0
8_1945903,unload-airplane_package5_plane3_city8-2,1945903,8,0,0,0,0
8_1487151,unload-airplane_package5_plane3_city1-2,1487151,8,0,0,0,0
8_5293897,load-truck_package4_truck6_city6-1,5293897,8,1,0,1,0
8_7409949,load-airplane_package4_plane1_city6-2,7409949,8,0,0,0,0
8_5293898,load-truck_package4_truck6_city6-2,5293898,8,0,0,0,0
8_3616594,load-airplane_package4_plane2_city6-2,3616594,8,0,0,0,0
8_7824216,load-airplane_package4_plane3_city6-2,7824216,8,0,0,0,0
8_4030861,load-airplane_package4_plane4_city6-2,4030861,8,0,0,0,0
8_4974241,fly-airplane_plane2_city7-2_city4-2,4974241,8,0,0,0,0
8_5236385,fly-airplane_plane2_city7-2_city8-2,5236385,8,0,0,0,0
8_4777633,fly-airplane_plane2_city7-2_city1-2,4777633,8,0,0,0,0
8_5039777,fly-airplane_plane2_city7-2_city5-2,5039777,8,0,0,0,0
8_7120922,fly-airplane_plane2_city7-2_city10-2,7120922,8,0,0,0,0
8_5301921,fly-airplane_plane2_city7-2_city9-2,5301921,8,0,0,0,0
8_4843169,fly-airplane_plane2_city7-2_city2-2,4843169,8,0,0,0,0
8_5105313,fly-airplane_plane2_city7-2_city6-2,5105313,8,0,0,0,0
8_4908705,fly-airplane_plane2_city7-2_city3-2,4908705,8,0,0,0,0
8_565705,at_plane2_city4-2,565705,8,8,0,8,0
8_212645,fly-airplane_plane2_city10-2_city8-2,212645,8,0,0,0,0
8_7885942,fly-airplane_plane2_city10-2_city3-2,7885942,8,0,0,0,0
8_16037,fly-airplane_plane2_city10-2_city5-2,16037,8,0,0,0,0
8_278181,fly-airplane_plane2_city10-2_city9-2,278181,8,0,0,0,0
8_7951478,fly-airplane_plane2_city10-2_city4-2,7951478,8,0,0,0,0
8_81573,fly-airplane_plane2_city10-2_city6-2,81573,8,0,0,0,0
8_7754870,fly-airplane_plane2_city10-2_city1-2,7754870,8,0,0,0,0
8_147109,fly-airplane_plane2_city10-2_city7-2,147109,8,0,0,0,0
8_7820406,fly-airplane_plane2_city10-2_city2-2,7820406,8,0,0,0,0
8_3934994,fly-airplane_plane3_city5-2_city4-2,3934994,8,0,0,0,0
8_4197138,fly-airplane_plane3_city5-2_city8-2,4197138,8,0,0,0,0
8_3738386,fly-airplane_plane3_city5-2_city1-2,3738386,8,0,0,0,0
8_5105931,fly-airplane_plane3_city5-2_city10-2,5105931,8,0,0,0,0
8_4262674,fly-airplane_plane3_city5-2_city9-2,4262674,8,0,0,0,0
8_3803922,fly-airplane_plane3_city5-2_city2-2,3803922,8,0,0,0,0
8_4066066,fly-airplane_plane3_city5-2_city6-2,4066066,8,0,0,0,0
8_3869458,fly-airplane_plane3_city5-2_city3-2,3869458,8,0,0,0,0
8_4131602,fly-airplane_plane3_city5-2_city7-2,4131602,8,0,0,0,0
8_5825845,unload-airplane_package5_plane4_city3-2,5825845,8,0,0,0,0
8_6087989,unload-airplane_package5_plane4_city7-2,6087989,8,0,0,0,0
8_5891381,unload-airplane_package5_plane4_city4-2,5891381,8,0,0,0,0
8_6153525,unload-airplane_package5_plane4_city8-2,6153525,8,0,0,0,0
8_5694773,unload-airplane_package5_plane4_city1-2,5694773,8,0,0,0,0
8_5956917,unload-airplane_package5_plane4_city5-2,5956917,8,0,0,0,0
8_6219061,unload-airplane_package5_plane4_city9-2,6219061,8,0,0,0,0
8_5760309,unload-airplane_package5_plane4_city2-2,5760309,8,0,0,0,0
8_6022453,unload-airplane_package5_plane4_city6-2,6022453,8,0,0,0,0
8_1879452,unload-airplane_package5_plane4_city10-2,1879452,8,0,0,0,0
8_489249,load-airplane_package5_plane2_city4-2,489249,8,1,0,1,0
8_1752286,load-truck_package5_truck4_city4-2,1752286,8,1,0,1,0
8_4696871,load-airplane_package5_plane3_city4-2,4696871,8,1,0,1,0
8_903516,load-airplane_package5_plane4_city4-2,903516,8,1,0,1,0
8_4282604,load-airplane_package5_plane1_city4-2,4282604,8,1,0,1,0
8_5370577,at_truck5_city5-2,5370577,8,2,0,2,0
8_808596,fly-airplane_plane4_city1-2_city4-2,808596,8,0,0,0,0
8_4845743,fly-airplane_plane4_city1-2_city10-2,4845743,8,0,0,0,0
8_1070740,fly-airplane_plane4_city1-2_city8-2,1070740,8,0,0,0,0
8_874132,fly-airplane_plane4_city1-2_city5-2,874132,8,0,0,0,0
8_1136276,fly-airplane_plane4_city1-2_city9-2,1136276,8,0,0,0,0
8_677524,fly-airplane_plane4_city1-2_city2-2,677524,8,0,0,0,0
8_939668,fly-airplane_plane4_city1-2_city6-2,939668,8,0,0,0,0
8_743060,fly-airplane_plane4_city1-2_city3-2,743060,8,0,0,0,0
8_1005204,fly-airplane_plane4_city1-2_city7-2,1005204,8,0,0,0,0
8_7835242,unload-truck_package5_truck10_city10-2,7835242,8,0,0,0,0
8_7835241,unload-truck_package5_truck10_city10-1,7835241,8,0,0,0,0
8_7942119,drive-truck_truck7_city7-1_city7-2_city7,7942119,8,0,0,0,0
8_5915916,at_truck7_city7-2,5915916,8,2,0,2,0
8_745545,load-airplane_package1_plane3_city5-2,745545,8,0,0,0,0
8_2008582,load-truck_package1_truck5_city5-2,2008582,8,0,0,0,0
8_331278,load-airplane_package1_plane1_city5-2,331278,8,0,0,0,0
8_4953167,load-airplane_package1_plane4_city5-2,4953167,8,0,0,0,0
8_4538900,load-airplane_package1_plane2_city5-2,4538900,8,0,0,0,0
8_4309744,fly-airplane_plane4_city8-2_city7-2,4309744,8,0,0,0,0
8_4113136,fly-airplane_plane4_city8-2_city4-2,4113136,8,0,0,0,0
8_3916528,fly-airplane_plane4_city8-2_city1-2,3916528,8,0,0,0,0
8_4178672,fly-airplane_plane4_city8-2_city5-2,4178672,8,0,0,0,0
8_2704421,fly-airplane_plane4_city8-2_city10-2,2704421,8,0,0,0,0
8_4440816,fly-airplane_plane4_city8-2_city9-2,4440816,8,0,0,0,0
8_3982064,fly-airplane_plane4_city8-2_city2-2,3982064,8,0,0,0,0
8_4244208,fly-airplane_plane4_city8-2_city6-2,4244208,8,0,0,0,0
8_4047600,fly-airplane_plane4_city8-2_city3-2,4047600,8,0,0,0,0
8_5184654,drive-truck_truck7_city7-2_city7-1_city7,5184654,8,0,0,0,0
8_1231196,load-airplane_package5_plane4_city9-2,1231196,8,0,0,0,0
8_4610284,load-airplane_package5_plane1_city9-2,4610284,8,0,0,0,0
8_816929,load-airplane_package5_plane2_city9-2,816929,8,0,0,0,0
8_7116122,load-truck_package5_truck9_city9-2,7116122,8,0,0,0,0
8_5024551,load-airplane_package5_plane3_city9-2,5024551,8,0,0,0,0
8_5073838,load-airplane_package2_plane1_city1-2,5073838,8,0,0,0,0
8_1280483,load-airplane_package2_plane2_city1-2,1280483,8,0,0,0,0
8_5922608,load-truck_package2_truck1_city1-2,5922608,8,0,0,0,0
8_5488105,load-airplane_package2_plane3_city1-2,5488105,8,0,0,0,0
8_1694750,load-airplane_package2_plane4_city1-2,1694750,8,0,0,0,0
8_289193,load-truck_package3_truck6_city6-1,289193,8,0,0,0,0
8_2405245,load-airplane_package3_plane1_city6-2,2405245,8,0,0,0,0
8_289194,load-truck_package3_truck6_city6-2,289194,8,0,0,0,0
8_7027134,load-airplane_package3_plane4_city6-2,7027134,8,0,0,0,0
8_6612867,load-airplane_package3_plane2_city6-2,6612867,8,0,0,0,0
8_2819512,load-airplane_package3_plane3_city6-2,2819512,8,0,0,0,0
8_2889739,fly-airplane_plane1_city7-2_city10-2,2889739,8,0,0,0,0
8_3926337,fly-airplane_plane1_city7-2_city4-2,3926337,8,0,0,0,0
8_4188481,fly-airplane_plane1_city7-2_city8-2,4188481,8,0,0,0,0
8_3729729,fly-airplane_plane1_city7-2_city1-2,3729729,8,0,0,0,0
8_3991873,fly-airplane_plane1_city7-2_city5-2,3991873,8,0,0,0,0
8_4254017,fly-airplane_plane1_city7-2_city9-2,4254017,8,0,0,0,0
8_3795265,fly-airplane_plane1_city7-2_city2-2,3795265,8,0,0,0,0
8_4057409,fly-airplane_plane1_city7-2_city6-2,4057409,8,0,0,0,0
8_3860801,fly-airplane_plane1_city7-2_city3-2,3860801,8,0,0,0,0
8_4013645,drive-truck_truck4_city4-1_city4-2_city4,4013645,8,0,0,0,0
8_4203219,load-truck_package4_truck2_city2-1,4203219,8,0,0,0,0
8_5532590,load-airplane_package2_plane1_city8-2,5532590,8,0,0,0,0
8_1739235,load-airplane_package2_plane2_city8-2,1739235,8,0,0,0,0
8_5946857,load-airplane_package2_plane3_city8-2,5946857,8,0,0,0,0
8_3830806,load-truck_package2_truck8_city8-2,3830806,8,0,0,0,0
8_2153502,load-airplane_package2_plane4_city8-2,2153502,8,0,0,0,0
8_7562072,load-airplane_package4_plane3_city2-2,7562072,8,0,0,0,0
8_4203220,load-truck_package4_truck2_city2-2,4203220,8,0,0,0,0
8_3768717,load-airplane_package4_plane4_city2-2,3768717,8,0,0,0,0
8_7147805,load-airplane_package4_plane1_city2-2,7147805,8,0,0,0,0
8_3354450,load-airplane_package4_plane2_city2-2,3354450,8,0,0,0,0
8_7630597,fly-airplane_plane3_city1-2_city2-2,7630597,8,0,0,0,0
8_7892741,fly-airplane_plane3_city1-2_city6-2,7892741,8,0,0,0,0
8_22836,fly-airplane_plane3_city1-2_city8-2,22836,8,0,0,0,0
8_7696133,fly-airplane_plane3_city1-2_city3-2,7696133,8,0,0,0,0
8_7958277,fly-airplane_plane3_city1-2_city7-2,7958277,8,0,0,0,0
8_88372,fly-airplane_plane3_city1-2_city9-2,88372,8,0,0,0,0
8_7761669,fly-airplane_plane3_city1-2_city4-2,7761669,8,0,0,0,0
8_614560,fly-airplane_plane3_city1-2_city10-2,614560,8,0,0,0,0
8_7827205,fly-airplane_plane3_city1-2_city5-2,7827205,8,0,0,0,0
8_1256180,drive-truck_truck4_city4-2_city4-1_city4,1256180,8,0,0,0,0
8_996547,fly-airplane_plane2_city3-2_city7-2,996547,8,0,0,0,0
8_799939,fly-airplane_plane2_city3-2_city4-2,799939,8,0,0,0,0
8_1062083,fly-airplane_plane2_city3-2_city8-2,1062083,8,0,0,0,0
8_603331,fly-airplane_plane2_city3-2_city1-2,603331,8,0,0,0,0
8_865475,fly-airplane_plane2_city3-2_city5-2,865475,8,0,0,0,0
8_1127619,fly-airplane_plane2_city3-2_city9-2,1127619,8,0,0,0,0
8_668867,fly-airplane_plane2_city3-2_city2-2,668867,8,0,0,0,0
8_931011,fly-airplane_plane2_city3-2_city6-2,931011,8,0,0,0,0
8_2629551,fly-airplane_plane2_city3-2_city10-2,2629551,8,0,0,0,0
8_7656764,drive-truck_truck10_city10-1_city10-2_city10,7656764,8,0,0,0,0
8_3973470,at_truck10_city10-2,3973470,8,2,0,2,0
8_4593445,unload-airplane_package4_plane1_city9-2,4593445,8,0,0,0,0
8_4134693,unload-airplane_package4_plane1_city2-2,4134693,8,0,0,0,0
8_4396837,unload-airplane_package4_plane1_city6-2,4396837,8,0,0,0,0
8_4200229,unload-airplane_package4_plane1_city3-2,4200229,8,0,0,0,0
8_4462373,unload-airplane_package4_plane1_city7-2,4462373,8,0,0,0,0
8_4265765,unload-airplane_package4_plane1_city4-2,4265765,8,0,0,0,0
8_1772560,unload-airplane_package4_plane1_city10-2,1772560,8,0,0,0,0
8_4527909,unload-airplane_package4_plane1_city8-2,4527909,8,0,0,0,0
8_4069157,unload-airplane_package4_plane1_city1-2,4069157,8,0,0,0,0
8_4331301,unload-airplane_package4_plane1_city5-2,4331301,8,0,0,0,0
8_4279899,at_truck1_city1-2,4279899,8,1,0,1,0
8_1874900,drive-truck_truck10_city10-2_city10-1_city10,1874900,8,0,0,0,0
8_3973469,at_truck10_city10-1,3973469,8,0,0,0,0
8_537946,unload-airplane_package4_plane2_city5-2,537946,8,0,0,0,0
8_800090,unload-airplane_package4_plane2_city9-2,800090,8,0,0,0,0
8_341338,unload-airplane_package4_plane2_city2-2,341338,8,0,0,0,0
8_603482,unload-airplane_package4_plane2_city6-2,603482,8,0,0,0,0
8_6792874,unload-airplane_package4_plane2_city10-2,6792874,8,0,0,0,0
8_406874,unload-airplane_package4_plane2_city3-2,406874,8,0,0,0,0
8_669018,unload-airplane_package4_plane2_city7-2,669018,8,0,0,0,0
8_472410,unload-airplane_package4_plane2_city4-2,472410,8,0,0,0,0
8_734554,unload-airplane_package4_plane2_city8-2,734554,8,0,0,0,0
8_275802,unload-airplane_package4_plane2_city1-2,275802,8,0,0,0,0
8_2111417,load-truck_package4_truck9_city9-1,2111417,8,0,0,0,0
8_19847,load-airplane_package4_plane3_city9-2,19847,8,0,0,0,0
8_4227469,load-airplane_package4_plane4_city9-2,4227469,8,0,0,0,0
8_2111418,load-truck_package4_truck9_city9-2,2111418,8,0,0,0,0
8_7606557,load-airplane_package4_plane1_city9-2,7606557,8,0,0,0,0
8_3813202,load-airplane_package4_plane2_city9-2,3813202,8,0,0,0,0
8_2999696,fly-airplane_plane3_city8-2_city3-2,2999696,8,0,0,0,0
8_3261840,fly-airplane_plane3_city8-2_city7-2,3261840,8,0,0,0,0
8_3065232,fly-airplane_plane3_city8-2_city4-2,3065232,8,0,0,0,0
8_2868624,fly-airplane_plane3_city8-2_city1-2,2868624,8,0,0,0,0
8_3130768,fly-airplane_plane3_city8-2_city5-2,3130768,8,0,0,0,0
8_6474215,fly-airplane_plane3_city8-2_city10-2,6474215,8,0,0,0,0
8_3392912,fly-airplane_plane3_city8-2_city9-2,3392912,8,0,0,0,0
8_2934160,fly-airplane_plane3_city8-2_city2-2,2934160,8,0,0,0,0
8_3196304,fly-airplane_plane3_city8-2_city6-2,3196304,8,0,0,0,0
8_4614496,unload-airplane_package4_plane3_city3-2,4614496,8,0,0,0,0
8_4876640,unload-airplane_package4_plane3_city7-2,4876640,8,0,0,0,0
8_4680032,unload-airplane_package4_plane3_city4-2,4680032,8,0,0,0,0
8_4942176,unload-airplane_package4_plane3_city8-2,4942176,8,0,0,0,0
8_4483424,unload-airplane_package4_plane3_city1-2,4483424,8,0,0,0,0
8_4745568,unload-airplane_package4_plane3_city5-2,4745568,8,0,0,0,0
8_5007712,unload-airplane_package4_plane3_city9-2,5007712,8,0,0,0,0
8_3812211,unload-airplane_package4_plane3_city10-2,3812211,8,0,0,0,0
8_4548960,unload-airplane_package4_plane3_city2-2,4548960,8,0,0,0,0
8_4811104,unload-airplane_package4_plane3_city6-2,4811104,8,0,0,0,0
8_6570783,load-truck_package5_truck7_city7-2,6570783,8,0,0,0,0
8_4893479,load-airplane_package5_plane3_city7-2,4893479,8,0,0,0,0
8_1100124,load-airplane_package5_plane4_city7-2,1100124,8,0,0,0,0
8_4479212,load-airplane_package5_plane1_city7-2,4479212,8,0,0,0,0
8_685857,load-airplane_package5_plane2_city7-2,685857,8,0,0,0,0
8_69134,load-airplane_package1_plane1_city1-2,69134,8,0,0,0,0
8_4691023,load-airplane_package1_plane4_city1-2,4691023,8,0,0,0,0
8_4276756,load-airplane_package1_plane2_city1-2,4276756,8,0,0,0,0
8_917904,load-truck_package1_truck1_city1-2,917904,8,0,0,0,0
8_483401,load-airplane_package1_plane3_city1-2,483401,8,0,0,0,0
8_2188097,at_truck8_city8-2,2188097,8,2,0,2,0
8_135442,fly-airplane_plane4_city4-2_city7-2,135442,8,0,0,0,0
8_7808739,fly-airplane_plane4_city4-2_city2-2,7808739,8,0,0,0,0
8_200978,fly-airplane_plane4_city4-2_city8-2,200978,8,0,0,0,0
8_6214027,fly-airplane_plane4_city4-2_city10-2,6214027,8,0,0,0,0
8_7874275,fly-airplane_plane4_city4-2_city3-2,7874275,8,0,0,0,0
8_4370,fly-airplane_plane4_city4-2_city5-2,4370,8,0,0,0,0
8_266514,fly-airplane_plane4_city4-2_city9-2,266514,8,0,0,0,0
8_69906,fly-airplane_plane4_city4-2_city6-2,69906,8,0,0,0,0
8_7743203,fly-airplane_plane4_city4-2_city1-2,7743203,8,0,0,0,0
8_1017749,unload-airplane_package4_plane4_city6-2,1017749,8,0,0,0,0
8_831548,unload-airplane_package4_plane4_city10-2,831548,8,0,0,0,0
8_821141,unload-airplane_package4_plane4_city3-2,821141,8,0,0,0,0
8_1083285,unload-airplane_package4_plane4_city7-2,1083285,8,0,0,0,0
8_886677,unload-airplane_package4_plane4_city4-2,886677,8,0,0,0,0
8_1148821,unload-airplane_package4_plane4_city8-2,1148821,8,0,0,0,0
8_690069,unload-airplane_package4_plane4_city1-2,690069,8,0,0,0,0
8_952213,unload-airplane_package4_plane4_city5-2,952213,8,0,0,0,0
8_1214357,unload-airplane_package4_plane4_city9-2,1214357,8,0,0,0,0
8_755605,unload-airplane_package4_plane4_city2-2,755605,8,0,0,0,0
8_6912042,load-airplane_package1_plane2_city10-2,6912042,8,0,0,0,0
8_3931379,load-airplane_package1_plane3_city10-2,3931379,8,0,0,0,0
8_1891728,load-airplane_package1_plane1_city10-2,1891728,8,0,0,0,0
8_3173776,load-truck_package1_truck10_city10-2,3173776,8,0,0,0,0
8_950716,load-airplane_package1_plane4_city10-2,950716,8,0,0,0,0
8_3635164,load-truck_package3_truck10_city10-1,3635164,8,0,0,0,0
8_6027187,load-airplane_package3_plane3_city10-2,6027187,8,0,0,0,0
8_3987536,load-airplane_package3_plane1_city10-2,3987536,8,0,0,0,0
8_3046524,load-airplane_package3_plane4_city10-2,3046524,8,0,0,0,0
8_1006873,load-airplane_package3_plane2_city10-2,1006873,8,0,0,0,0
8_3635165,load-truck_package3_truck10_city10-2,3635165,8,0,0,0,0
8_4176918,unload-truck_package5_truck1_city1-2,4176918,8,0,0,0,0
8_4176917,unload-truck_package5_truck1_city1-1,4176917,8,0,0,0,0
8_527886,load-airplane_package1_plane1_city8-2,527886,8,0,0,0,0
8_6827079,load-truck_package1_truck8_city8-2,6827079,8,0,0,0,0
8_5149775,load-airplane_package1_plane4_city8-2,5149775,8,0,0,0,0
8_4735508,load-airplane_package1_plane2_city8-2,4735508,8,0,0,0,0
8_942153,load-airplane_package1_plane3_city8-2,942153,8,0,0,0,0
8_7199492,load-truck_package3_truck2_city2-1,7199492,8,0,0,0,0
8_449099,unload-truck_package5_truck2_city2-2,449099,8,0,0,0,0
8_449098,unload-truck_package5_truck2_city2-1,449098,8,0,0,0,0
8_7199493,load-truck_package3_truck2_city2-2,7199493,8,0,0,0,0
8_6764990,load-airplane_package3_plane4_city2-2,6764990,8,0,0,0,0
8_6350723,load-airplane_package3_plane2_city2-2,6350723,8,0,0,0,0
8_2557368,load-airplane_package3_plane3_city2-2,2557368,8,0,0,0,0
8_2143101,load-airplane_package3_plane1_city2-2,2143101,8,0,0,0,0
8_7818548,fly-airplane_plane1_city3-2_city5-2,7818548,8,0,0,0,0
8_6399345,fly-airplane_plane1_city3-2_city10-2,6399345,8,0,0,0,0
8_7621940,fly-airplane_plane1_city3-2_city2-2,7621940,8,0,0,0,0
8_7884084,fly-airplane_plane1_city3-2_city6-2,7884084,8,0,0,0,0
8_14179,fly-airplane_plane1_city3-2_city8-2,14179,8,0,0,0,0
8_7949620,fly-airplane_plane1_city3-2_city7-2,7949620,8,0,0,0,0
8_79715,fly-airplane_plane1_city3-2_city9-2,79715,8,0,0,0,0
8_7753012,fly-airplane_plane1_city3-2_city4-2,7753012,8,0,0,0,0
8_7556404,fly-airplane_plane1_city3-2_city1-2,7556404,8,0,0,0,0
8_6083344,load-airplane_package5_plane1_city10-2,6083344,8,0,0,0,0
8_5142332,load-airplane_package5_plane4_city10-2,5142332,8,0,0,0,0
8_3102681,load-airplane_package5_plane2_city10-2,3102681,8,0,0,0,0
8_122018,load-airplane_package5_plane3_city10-2,122018,8,0,0,0,0
8_4096554,load-truck_package5_truck10_city10-2,4096554,8,0,0,0,0
8_5270446,load-airplane_package2_plane1_city4-2,5270446,8,0,0,0,0
8_1477091,load-airplane_package2_plane2_city4-2,1477091,8,0,0,0,0
8_2740128,load-truck_package2_truck4_city4-2,2740128,8,0,0,0,0
8_5684713,load-airplane_package2_plane3_city4-2,5684713,8,0,0,0,0
8_1891358,load-airplane_package2_plane4_city4-2,1891358,8,0,0,0,0
8_4722257,unload-truck_package5_truck3_city3-2,4722257,8,0,0,0,0
8_4722256,unload-truck_package5_truck3_city3-1,4722256,8,0,0,0,0
8_5107690,load-truck_package3_truck9_city9-1,5107690,8,0,0,0,0
8_4825238,at_truck3_city3-2,4825238,8,2,0,2,0
8_994438,unload-truck_package5_truck4_city4-2,994438,8,0,0,0,0
8_994437,unload-truck_package5_truck4_city4-1,994437,8,0,0,0,0
8_7223742,load-airplane_package3_plane4_city9-2,7223742,8,0,0,0,0
8_5107691,load-truck_package3_truck9_city9-2,5107691,8,0,0,0,0
8_6809475,load-airplane_package3_plane2_city9-2,6809475,8,0,0,0,0
8_3016120,load-airplane_package3_plane3_city9-2,3016120,8,0,0,0,0
8_2601853,load-airplane_package3_plane1_city9-2,2601853,8,0,0,0,0
8_3142670,unload-truck_package2_truck10_city10-2,3142670,8,0,0,0,0
8_3142669,unload-truck_package2_truck10_city10-1,3142669,8,0,0,0,0
8_2656144,drive-truck_truck5_city5-1_city5-2_city5,2656144,8,0,0,0,0
8_1020739,load-truck_package4_truck5_city5-1,1020739,8,0,0,0,0
8_5267596,unload-truck_package5_truck5_city5-2,5267596,8,0,0,0,0
8_5267595,unload-truck_package5_truck5_city5-1,5267595,8,0,0,0,0
8_1020740,load-truck_package4_truck5_city5-2,1020740,8,0,0,0,0
8_7758680,load-airplane_package4_plane3_city5-2,7758680,8,0,0,0,0
8_3965325,load-airplane_package4_plane4_city5-2,3965325,8,0,0,0,0
8_7344413,load-airplane_package4_plane1_city5-2,7344413,8,0,0,0,0
8_3551058,load-airplane_package4_plane2_city5-2,3551058,8,0,0,0,0
8_7734546,fly-airplane_plane2_city6-2_city1-2,7734546,8,0,0,0,0
8_7996690,fly-airplane_plane2_city6-2_city5-2,7996690,8,0,0,0,0
8_3997835,fly-airplane_plane2_city6-2_city10-2,3997835,8,0,0,0,0
8_126785,fly-airplane_plane2_city6-2_city7-2,126785,8,0,0,0,0
8_7800082,fly-airplane_plane2_city6-2_city2-2,7800082,8,0,0,0,0
8_192321,fly-airplane_plane2_city6-2_city8-2,192321,8,0,0,0,0
8_7865618,fly-airplane_plane2_city6-2_city3-2,7865618,8,0,0,0,0
8_257857,fly-airplane_plane2_city6-2_city9-2,257857,8,0,0,0,0
8_7931154,fly-airplane_plane2_city6-2_city4-2,7931154,8,0,0,0,0
8_6695299,fly-airplane_plane3_city4-2_city1-2,6695299,8,0,0,0,0
8_1982844,fly-airplane_plane3_city4-2_city10-2,1982844,8,0,0,0,0
8_6957443,fly-airplane_plane3_city4-2_city5-2,6957443,8,0,0,0,0
8_7219587,fly-airplane_plane3_city4-2_city9-2,7219587,8,0,0,0,0
8_6760835,fly-airplane_plane3_city4-2_city2-2,6760835,8,0,0,0,0
8_7022979,fly-airplane_plane3_city4-2_city6-2,7022979,8,0,0,0,0
8_6826371,fly-airplane_plane3_city4-2_city3-2,6826371,8,0,0,0,0
8_7088515,fly-airplane_plane3_city4-2_city7-2,7088515,8,0,0,0,0
8_7154051,fly-airplane_plane3_city4-2_city8-2,7154051,8,0,0,0,0
8_7899656,drive-truck_truck5_city5-2_city5-1_city5,7899656,8,0,0,0,0
8_4631335,load-airplane_package5_plane3_city3-2,4631335,8,0,0,0,0
8_837980,load-airplane_package5_plane4_city3-2,837980,8,0,0,0,0
8_4217068,load-airplane_package5_plane1_city3-2,4217068,8,0,0,0,0
8_423713,load-airplane_package5_plane2_city3-2,423713,8,0,0,0,0
8_5480105,load-truck_package5_truck3_city3-2,5480105,8,0,0,0,0
8_1539777,unload-truck_package5_truck6_city6-2,1539777,8,0,0,0,0
8_1539776,unload-truck_package5_truck6_city6-1,1539776,8,0,0,0,0
8_7458646,unload-airplane_package3_plane1_city7-2,7458646,8,0,0,0,0
8_7262038,unload-airplane_package3_plane1_city4-2,7262038,8,0,0,0,0
8_7524182,unload-airplane_package3_plane1_city8-2,7524182,8,0,0,0,0
8_7065430,unload-airplane_package3_plane1_city1-2,7065430,8,0,0,0,0
8_7327574,unload-airplane_package3_plane1_city5-2,7327574,8,0,0,0,0
8_7589718,unload-airplane_package3_plane1_city9-2,7589718,8,0,0,0,0
8_7130966,unload-airplane_package3_plane1_city2-2,7130966,8,0,0,0,0
8_7393110,unload-airplane_package3_plane1_city6-2,7393110,8,0,0,0,0
8_724656,unload-airplane_package3_plane1_city10-2,724656,8,0,0,0,0
8_7196502,unload-airplane_package3_plane1_city3-2,7196502,8,0,0,0,0
8_5812935,unload-truck_package5_truck7_city7-2,5812935,8,0,0,0,0
8_5812934,unload-truck_package5_truck7_city7-1,5812934,8,0,0,0,0
8_3403147,unload-airplane_package3_plane2_city3-2,3403147,8,0,0,0,0
8_3665291,unload-airplane_package3_plane2_city7-2,3665291,8,0,0,0,0
8_3468683,unload-airplane_package3_plane2_city4-2,3468683,8,0,0,0,0
8_3730827,unload-airplane_package3_plane2_city8-2,3730827,8,0,0,0,0
8_3272075,unload-airplane_package3_plane2_city1-2,3272075,8,0,0,0,0
8_5744970,unload-airplane_package3_plane2_city10-2,5744970,8,0,0,0,0
8_3534219,unload-airplane_package3_plane2_city5-2,3534219,8,0,0,0,0
8_3796363,unload-airplane_package3_plane2_city9-2,3796363,8,0,0,0,0
8_3337611,unload-airplane_package3_plane2_city2-2,3337611,8,0,0,0,0
8_3599755,unload-airplane_package3_plane2_city6-2,3599755,8,0,0,0,0
8_6728647,drive-truck_truck2_city2-1_city2-2_city2,6728647,8,0,0,0,0
8_552080,at_truck2_city2-2,552080,8,1,0,1,0
8_265742,load-airplane_package1_plane1_city4-2,265742,8,0,0,0,0
8_4887631,load-airplane_package1_plane4_city4-2,4887631,8,0,0,0,0
8_4473364,load-airplane_package1_plane2_city4-2,4473364,8,0,0,0,0
8_680009,load-airplane_package1_plane3_city4-2,680009,8,0,0,0,0
8_5736401,load-truck_package1_truck4_city4-2,5736401,8,0,0,0,0
8_2085116,unload-truck_package5_truck8_city8-2,2085116,8,0,0,0,0
8_2085115,unload-truck_package5_truck8_city8-1,2085115,8,0,0,0,0
8_7070049,fly-airplane_plane4_city7-2_city4-2,7070049,8,0,0,0,0
8_7332193,fly-airplane_plane4_city7-2_city8-2,7332193,8,0,0,0,0
8_6873441,fly-airplane_plane4_city7-2_city1-2,6873441,8,0,0,0,0
8_7135585,fly-airplane_plane4_city7-2_city5-2,7135585,8,0,0,0,0
8_7397729,fly-airplane_plane4_city7-2_city9-2,7397729,8,0,0,0,0
8_6938977,fly-airplane_plane4_city7-2_city2-2,6938977,8,0,0,0,0
8_7201121,fly-airplane_plane4_city7-2_city6-2,7201121,8,0,0,0,0
8_7004513,fly-airplane_plane4_city7-2_city3-2,7004513,8,0,0,0,0
8_7582311,fly-airplane_plane4_city7-2_city10-2,7582311,8,0,0,0,0
8_3971182,drive-truck_truck2_city2-2_city2-1_city2,3971182,8,0,0,0,0
8_7938449,unload-airplane_package3_plane3_city8-2,7938449,8,0,0,0,0
8_7479697,unload-airplane_package3_plane3_city1-2,7479697,8,0,0,0,0
8_7741841,unload-airplane_package3_plane3_city5-2,7741841,8,0,0,0,0
8_7545233,unload-airplane_package3_plane3_city2-2,7545233,8,0,0,0,0
8_7807377,unload-airplane_package3_plane3_city6-2,7807377,8,0,0,0,0
8_7610769,unload-airplane_package3_plane3_city3-2,7610769,8,0,0,0,0
8_7872913,unload-airplane_package3_plane3_city7-2,7872913,8,0,0,0,0
8_3008,unload-airplane_package3_plane3_city9-2,3008,8,0,0,0,0
8_2764307,unload-airplane_package3_plane3_city10-2,2764307,8,0,0,0,0
8_7676305,unload-airplane_package3_plane3_city4-2,7676305,8,0,0,0,0
8_4544748,load-airplane_package5_plane1_city8-2,4544748,8,0,0,0,0
8_751393,load-airplane_package5_plane2_city8-2,751393,8,0,0,0,0
8_4959015,load-airplane_package5_plane3_city8-2,4959015,8,0,0,0,0
8_2842964,load-truck_package5_truck8_city8-2,2842964,8,0,0,0,0
8_1165660,load-airplane_package5_plane4_city8-2,1165660,8,0,0,0,0
8_6912464,unload-truck_package1_truck10_city10-2,6912464,8,0,0,0,0
8_6912463,unload-truck_package1_truck10_city10-1,6912463,8,0,0,0,0
8_6358274,unload-truck_package5_truck9_city9-2,6358274,8,0,0,0,0
8_6358273,unload-truck_package5_truck9_city9-1,6358273,8,0,0,0,0
8_4145094,unload-airplane_package3_plane4_city8-2,4145094,8,0,0,0,0
8_3686342,unload-airplane_package3_plane4_city1-2,3686342,8,0,0,0,0
8_3948486,unload-airplane_package3_plane4_city5-2,3948486,8,0,0,0,0
8_4210630,unload-airplane_package3_plane4_city9-2,4210630,8,0,0,0,0
8_3751878,unload-airplane_package3_plane4_city2-2,3751878,8,0,0,0,0
8_4014022,unload-airplane_package3_plane4_city6-2,4014022,8,0,0,0,0
8_7784621,unload-airplane_package3_plane4_city10-2,7784621,8,0,0,0,0
8_3817414,unload-airplane_package3_plane4_city3-2,3817414,8,0,0,0,0
8_4079558,unload-airplane_package3_plane4_city7-2,4079558,8,0,0,0,0
8_3882950,unload-airplane_package3_plane4_city4-2,3882950,8,0,0,0,0
8_4017012,load-truck_package3_truck5_city5-1,4017012,8,0,0,0,0
8_160056,unload-truck_package1_truck1_city1-2,160056,8,0,0,0,0
8_160055,unload-truck_package1_truck1_city1-1,160055,8,0,0,0,0
8_6961598,load-airplane_package3_plane4_city5-2,6961598,8,0,0,0,0
8_6547331,load-airplane_package3_plane2_city5-2,6547331,8,0,0,0,0
8_2753976,load-airplane_package3_plane3_city5-2,2753976,8,0,0,0,0
8_4017013,load-truck_package3_truck5_city5-2,4017013,8,0,0,0,0
8_2339709,load-airplane_package3_plane1_city5-2,2339709,8,0,0,0,0
8_7145394,fly-airplane_plane1_city6-2_city8-2,7145394,8,0,0,0,0
8_6686642,fly-airplane_plane1_city6-2_city1-2,6686642,8,0,0,0,0
8_6948786,fly-airplane_plane1_city6-2_city5-2,6948786,8,0,0,0,0
8_7210930,fly-airplane_plane1_city6-2_city9-2,7210930,8,0,0,0,0
8_7767629,fly-airplane_plane1_city6-2_city10-2,7767629,8,0,0,0,0
8_6752178,fly-airplane_plane1_city6-2_city2-2,6752178,8,0,0,0,0
8_6817714,fly-airplane_plane1_city6-2_city3-2,6817714,8,0,0,0,0
8_7079858,fly-airplane_plane1_city6-2_city7-2,7079858,8,0,0,0,0
8_6883250,fly-airplane_plane1_city6-2_city4-2,6883250,8,0,0,0,0
8_7173191,unload-truck_package4_truck1_city1-2,7173191,8,0,0,0,0
8_7173190,unload-truck_package4_truck1_city1-1,7173190,8,0,0,0,0
8_7931038,load-truck_package4_truck1_city1-1,7931038,8,0,0,0,0
8_1673699,load-airplane_package2_plane2_city7-2,1673699,8,0,0,0,0
8_7558625,load-truck_package2_truck7_city7-2,7558625,8,0,0,0,0
8_5881321,load-airplane_package2_plane3_city7-2,5881321,8,0,0,0,0
8_2087966,load-airplane_package2_plane4_city7-2,2087966,8,0,0,0,0
8_5467054,load-airplane_package2_plane1_city7-2,5467054,8,0,0,0,0
8_7931039,load-truck_package4_truck1_city1-2,7931039,8,0,0,0,0
8_7496536,load-airplane_package4_plane3_city1-2,7496536,8,0,0,0,0
8_3703181,load-airplane_package4_plane4_city1-2,3703181,8,0,0,0,0
8_7082269,load-airplane_package4_plane1_city1-2,7082269,8,0,0,0,0
8_3288914,load-airplane_package4_plane2_city1-2,3288914,8,0,0,0,0
8_4018996,fly-airplane_plane2_city2-2_city8-2,4018996,8,0,0,0,0
8_3560244,fly-airplane_plane2_city2-2_city1-2,3560244,8,0,0,0,0
8_7507441,fly-airplane_plane2_city2-2_city10-2,7507441,8,0,0,0,0
8_3822388,fly-airplane_plane2_city2-2_city5-2,3822388,8,0,0,0,0
8_4084532,fly-airplane_plane2_city2-2_city9-2,4084532,8,0,0,0,0
8_3887924,fly-airplane_plane2_city2-2_city6-2,3887924,8,0,0,0,0
8_3691316,fly-airplane_plane2_city2-2_city3-2,3691316,8,0,0,0,0
8_3953460,fly-airplane_plane2_city2-2_city7-2,3953460,8,0,0,0,0
8_3756852,fly-airplane_plane2_city2-2_city4-2,3756852,8,0,0,0,0
8_4433214,unload-truck_package1_truck2_city2-2,4433214,8,0,0,0,0
8_4433213,unload-truck_package1_truck2_city2-1,4433213,8,0,0,0,0
8_3445372,unload-truck_package4_truck2_city2-2,3445372,8,0,0,0,0
8_3445371,unload-truck_package4_truck2_city2-1,3445371,8,0,0,0,0
8_705395,unload-truck_package1_truck3_city3-2,705395,8,0,0,0,0
8_705394,unload-truck_package1_truck3_city3-1,705394,8,0,0,0,0
8_7718530,unload-truck_package4_truck3_city3-2,7718530,8,0,0,0,0
8_7718529,unload-truck_package4_truck3_city3-1,7718529,8,0,0,0,0
8_5839236,load-truck_package4_truck8_city8-1,5839236,8,0,0,0,0
8_4978553,unload-truck_package1_truck4_city4-2,4978553,8,0,0,0,0
8_4978552,unload-truck_package1_truck4_city4-1,4978552,8,0,0,0,0
8_7955288,load-airplane_package4_plane3_city8-2,7955288,8,0,0,0,0
8_5839237,load-truck_package4_truck8_city8-2,5839237,8,0,0,0,0
8_4161933,load-airplane_package4_plane4_city8-2,4161933,8,0,0,0,0
8_7541021,load-airplane_package4_plane1_city8-2,7541021,8,0,0,0,0
8_3747666,load-airplane_package4_plane2_city8-2,3747666,8,0,0,0,0
8_7061392,fly-airplane_plane2_city9-2_city4-2,7061392,8,0,0,0,0
8_7323536,fly-airplane_plane2_city9-2_city8-2,7323536,8,0,0,0,0
8_6864784,fly-airplane_plane2_city9-2_city1-2,6864784,8,0,0,0,0
8_7126928,fly-airplane_plane2_city9-2_city5-2,7126928,8,0,0,0,0
8_6930320,fly-airplane_plane2_city9-2_city2-2,6930320,8,0,0,0,0
8_5366119,fly-airplane_plane2_city9-2_city10-2,5366119,8,0,0,0,0
8_7192464,fly-airplane_plane2_city9-2_city6-2,7192464,8,0,0,0,0
8_6995856,fly-airplane_plane2_city9-2_city3-2,6995856,8,0,0,0,0
8_7258000,fly-airplane_plane2_city9-2_city7-2,7258000,8,0,0,0,0
8_6022145,fly-airplane_plane3_city7-2_city4-2,6022145,8,0,0,0,0
8_6284289,fly-airplane_plane3_city7-2_city8-2,6284289,8,0,0,0,0
8_5825537,fly-airplane_plane3_city7-2_city1-2,5825537,8,0,0,0,0
8_6087681,fly-airplane_plane3_city7-2_city5-2,6087681,8,0,0,0,0
8_3351128,fly-airplane_plane3_city7-2_city10-2,3351128,8,0,0,0,0
8_6349825,fly-airplane_plane3_city7-2_city9-2,6349825,8,0,0,0,0
8_5891073,fly-airplane_plane3_city7-2_city2-2,5891073,8,0,0,0,0
8_6153217,fly-airplane_plane3_city7-2_city6-2,6153217,8,0,0,0,0
8_5956609,fly-airplane_plane3_city7-2_city3-2,5956609,8,0,0,0,0
8_7404958,load-truck_package2_truck10_city10-1,7404958,8,0,0,0,0
8_3990711,unload-truck_package4_truck4_city4-2,3990711,8,0,0,0,0
8_3990710,unload-truck_package4_truck4_city4-1,3990710,8,0,0,0,0
8_4827943,load-airplane_package5_plane3_city6-2,4827943,8,0,0,0,0
8_1034588,load-airplane_package5_plane4_city6-2,1034588,8,0,0,0,0
8_4413676,load-airplane_package5_plane1_city6-2,4413676,8,0,0,0,0
8_2297625,load-truck_package5_truck6_city6-2,2297625,8,0,0,0,0
8_620321,load-airplane_package5_plane2_city6-2,620321,8,0,0,0,0
8_1250734,unload-truck_package1_truck5_city5-2,1250734,8,0,0,0,0
8_1250733,unload-truck_package1_truck5_city5-1,1250733,8,0,0,0,0
8_7959946,load-airplane_package2_plane2_city10-2,7959946,8,0,0,0,0
8_4979283,load-airplane_package2_plane3_city10-2,4979283,8,0,0,0,0
8_2939632,load-airplane_package2_plane1_city10-2,2939632,8,0,0,0,0
8_1998620,load-airplane_package2_plane4_city10-2,1998620,8,0,0,0,0
8_7404959,load-truck_package2_truck10_city10-2,7404959,8,0,0,0,0
8_2895747,fly-airplane_plane4_city3-2_city4-2,2895747,8,0,0,0,0
8_3157891,fly-airplane_plane4_city3-2_city8-2,3157891,8,0,0,0,0
8_3090940,fly-airplane_plane4_city3-2_city10-2,3090940,8,0,0,0,0
8_2699139,fly-airplane_plane4_city3-2_city1-2,2699139,8,0,0,0,0
8_2961283,fly-airplane_plane4_city3-2_city5-2,2961283,8,0,0,0,0
8_3223427,fly-airplane_plane4_city3-2_city9-2,3223427,8,0,0,0,0
8_2764675,fly-airplane_plane4_city3-2_city2-2,2764675,8,0,0,0,0
8_3026819,fly-airplane_plane4_city3-2_city6-2,3026819,8,0,0,0,0
8_3092355,fly-airplane_plane4_city3-2_city7-2,3092355,8,0,0,0,0
8_262892,unload-truck_package4_truck5_city5-2,262892,8,0,0,0,0
8_262891,unload-truck_package4_truck5_city5-1,262891,8,0,0,0,0
8_5523892,unload-truck_package1_truck6_city6-2,5523892,8,0,0,0,0
8_5523891,unload-truck_package1_truck6_city6-1,5523891,8,0,0,0,0
8_608498,fly-airplane_plane4_city10-2_city7-2,608498,8,0,0,0,0
8_411890,fly-airplane_plane4_city10-2_city4-2,411890,8,0,0,0,0
8_674034,fly-airplane_plane4_city10-2_city8-2,674034,8,0,0,0,0
8_215282,fly-airplane_plane4_city10-2_city1-2,215282,8,0,0,0,0
8_477426,fly-airplane_plane4_city10-2_city5-2,477426,8,0,0,0,0
8_739570,fly-airplane_plane4_city10-2_city9-2,739570,8,0,0,0,0
8_280818,fly-airplane_plane4_city10-2_city2-2,280818,8,0,0,0,0
8_542962,fly-airplane_plane4_city10-2_city6-2,542962,8,0,0,0,0
8_346354,fly-airplane_plane4_city10-2_city3-2,346354,8,0,0,0,0
8_5371146,drive-truck_truck3_city3-1_city3-2_city3,5371146,8,0,0,0,0
8_4536049,unload-truck_package4_truck6_city6-1,4536049,8,0,0,0,0
8_4536050,unload-truck_package4_truck6_city6-2,4536050,8,0,0,0,0
8_2191798,unload-airplane_package2_plane1_city3-2,2191798,8,0,0,0,0
8_2453942,unload-airplane_package2_plane1_city7-2,2453942,8,0,0,0,0
8_2257334,unload-airplane_package2_plane1_city4-2,2257334,8,0,0,0,0
8_7677729,unload-airplane_package2_plane1_city10-2,7677729,8,0,0,0,0
8_2519478,unload-airplane_package2_plane1_city8-2,2519478,8,0,0,0,0
8_2060726,unload-airplane_package2_plane1_city1-2,2060726,8,0,0,0,0
8_2322870,unload-airplane_package2_plane1_city5-2,2322870,8,0,0,0,0
8_2585014,unload-airplane_package2_plane1_city9-2,2585014,8,0,0,0,0
8_2126262,unload-airplane_package2_plane1_city2-2,2126262,8,0,0,0,0
8_2388406,unload-airplane_package2_plane1_city6-2,2388406,8,0,0,0,0
8_5084239,load-airplane_package1_plane4_city7-2,5084239,8,0,0,0,0
8_4669972,load-airplane_package1_plane2_city7-2,4669972,8,0,0,0,0
8_2553921,load-truck_package1_truck7_city7-2,2553921,8,0,0,0,0
8_876617,load-airplane_package1_plane3_city7-2,876617,8,0,0,0,0
8_462350,load-airplane_package1_plane1_city7-2,462350,8,0,0,0,0
8_2926334,load-truck_package3_truck1_city1-1,2926334,8,1,0,1,0
8_1796073,unload-truck_package1_truck7_city7-2,1796073,8,0,0,0,0
8_1796072,unload-truck_package1_truck7_city7-1,1796072,8,0,0,0,0
8_6285187,load-airplane_package3_plane2_city1-2,6285187,8,0,0,0,0
8_2926335,load-truck_package3_truck1_city1-2,2926335,8,0,0,0,0
8_2491832,load-airplane_package3_plane3_city1-2,2491832,8,0,0,0,0
8_2077565,load-airplane_package3_plane1_city1-2,2077565,8,0,0,0,0
8_6699454,load-airplane_package3_plane4_city1-2,6699454,8,0,0,0,0
8_2708948,fly-airplane_plane1_city2-2_city4-2,2708948,8,0,0,0,0
8_2971092,fly-airplane_plane1_city2-2_city8-2,2971092,8,0,0,0,0
8_2512340,fly-airplane_plane1_city2-2_city1-2,2512340,8,0,0,0,0
8_2774484,fly-airplane_plane1_city2-2_city5-2,2774484,8,0,0,0,0
8_3036628,fly-airplane_plane1_city2-2_city9-2,3036628,8,0,0,0,0
8_2840020,fly-airplane_plane1_city2-2_city6-2,2840020,8,0,0,0,0
8_2643412,fly-airplane_plane1_city2-2_city3-2,2643412,8,0,0,0,0
8_3276258,fly-airplane_plane1_city2-2_city10-2,3276258,8,0,0,0,0
8_2905556,fly-airplane_plane1_city2-2_city7-2,2905556,8,0,0,0,0
8_2613681,drive-truck_truck3_city3-2_city3-1_city3,2613681,8,0,0,0,0
8_808231,unload-truck_package4_truck7_city7-2,808231,8,0,0,0,0
8_808230,unload-truck_package4_truck7_city7-1,808230,8,0,0,0,0
8_6268348,unload-airplane_package2_plane2_city1-2,6268348,8,0,0,0,0
8_6530492,unload-airplane_package2_plane2_city5-2,6530492,8,0,0,0,0
8_6792636,unload-airplane_package2_plane2_city9-2,6792636,8,0,0,0,0
8_6333884,unload-airplane_package2_plane2_city2-2,6333884,8,0,0,0,0
8_6596028,unload-airplane_package2_plane2_city6-2,6596028,8,0,0,0,0
8_6399420,unload-airplane_package2_plane2_city3-2,6399420,8,0,0,0,0
8_4697066,unload-airplane_package2_plane2_city10-2,4697066,8,0,0,0,0
8_6661564,unload-airplane_package2_plane2_city7-2,6661564,8,0,0,0,0
8_6464956,unload-airplane_package2_plane2_city4-2,6464956,8,0,0,0,0
8_6727100,unload-airplane_package2_plane2_city8-2,6727100,8,0,0,0,0
8_6467947,load-truck_package2_truck3_city3-2,6467947,8,0,0,0,0
8_5619177,load-airplane_package2_plane3_city3-2,5619177,8,0,0,0,0
8_1825822,load-airplane_package2_plane4_city3-2,1825822,8,0,0,0,0
8_5204910,load-airplane_package2_plane1_city3-2,5204910,8,0,0,0,0
8_1411555,load-airplane_package2_plane2_city3-2,1411555,8,0,0,0,0
8_6069231,unload-truck_package1_truck8_city8-2,6069231,8,0,0,0,0
8_6069230,unload-truck_package1_truck8_city8-1,6069230,8,0,0,0,0
8_5081389,unload-truck_package4_truck8_city8-2,5081389,8,0,0,0,0
8_5081388,unload-truck_package4_truck8_city8-1,5081388,8,0,0,0,0
8_2933745,unload-airplane_package2_plane3_city8-2,2933745,8,0,0,0,0
8_2474993,unload-airplane_package2_plane3_city1-2,2474993,8,0,0,0,0
8_2737137,unload-airplane_package2_plane3_city5-2,2737137,8,0,0,0,0
8_2999281,unload-airplane_package2_plane3_city9-2,2999281,8,0,0,0,0
8_2540529,unload-airplane_package2_plane3_city2-2,2540529,8,0,0,0,0
8_2802673,unload-airplane_package2_plane3_city6-2,2802673,8,0,0,0,0
8_2606065,unload-airplane_package2_plane3_city3-2,2606065,8,0,0,0,0
8_2868209,unload-airplane_package2_plane3_city7-2,2868209,8,0,0,0,0
8_1716403,unload-airplane_package2_plane3_city10-2,1716403,8,0,0,0,0
8_2671601,unload-airplane_package2_plane3_city4-2,2671601,8,0,0,0,0
8_834532,load-truck_package3_truck8_city8-1,834532,8,0,0,0,0
8_2341412,unload-truck_package1_truck9_city9-2,2341412,8,0,0,0,0
8_2341411,unload-truck_package1_truck9_city9-1,2341411,8,0,0,0,0
8_6743939,load-airplane_package3_plane2_city8-2,6743939,8,0,0,0,0
8_2950584,load-airplane_package3_plane3_city8-2,2950584,8,0,0,0,0
8_834533,load-truck_package3_truck8_city8-2,834533,8,0,0,0,0
8_2536317,load-airplane_package3_plane1_city8-2,2536317,8,0,0,0,0
8_7158206,load-airplane_package3_plane4_city8-2,7158206,8,0,0,0,0
8_6210096,fly-airplane_plane1_city9-2_city7-2,6210096,8,0,0,0,0
8_6013488,fly-airplane_plane1_city9-2_city4-2,6013488,8,0,0,0,0
8_1134936,fly-airplane_plane1_city9-2_city10-2,1134936,8,0,0,0,0
8_6275632,fly-airplane_plane1_city9-2_city8-2,6275632,8,0,0,0,0
8_5816880,fly-airplane_plane1_city9-2_city1-2,5816880,8,0,0,0,0
8_6079024,fly-airplane_plane1_city9-2_city5-2,6079024,8,0,0,0,0
8_5882416,fly-airplane_plane1_city9-2_city2-2,5882416,8,0,0,0,0
8_6144560,fly-airplane_plane1_city9-2_city6-2,6144560,8,0,0,0,0
8_5947952,fly-airplane_plane1_city9-2_city3-2,5947952,8,0,0,0,0
8_1353570,unload-truck_package4_truck9_city9-2,1353570,8,0,0,0,0
8_1353569,unload-truck_package4_truck9_city9-1,1353569,8,0,0,0,0
8_7010295,unload-airplane_package2_plane4_city6-2,7010295,8,0,0,0,0
8_6813687,unload-airplane_package2_plane4_city3-2,6813687,8,0,0,0,0
8_7075831,unload-airplane_package2_plane4_city7-2,7075831,8,0,0,0,0
8_6879223,unload-airplane_package2_plane4_city4-2,6879223,8,0,0,0,0
8_6736717,unload-airplane_package2_plane4_city10-2,6736717,8,0,0,0,0
8_7141367,unload-airplane_package2_plane4_city8-2,7141367,8,0,0,0,0
8_6682615,unload-airplane_package2_plane4_city1-2,6682615,8,0,0,0,0
8_6944759,unload-airplane_package2_plane4_city5-2,6944759,8,0,0,0,0
8_7206903,unload-airplane_package2_plane4_city9-2,7206903,8,0,0,0,0
8_6748151,unload-airplane_package2_plane4_city2-2,6748151,8,0,0,0,0
8_4748558,load-truck_package4_truck4_city4-1,4748558,8,0,0,0,0
8_7693144,load-airplane_package4_plane3_city4-2,7693144,8,0,0,0,0
8_3899789,load-airplane_package4_plane4_city4-2,3899789,8,0,0,0,0
8_7278877,load-airplane_package4_plane1_city4-2,7278877,8,0,0,0,0
8_3485522,load-airplane_package4_plane2_city4-2,3485522,8,0,0,0,0
8_4748559,load-truck_package4_truck4_city4-2,4748559,8,0,0,0,0
8_874748,fly-airplane_plane2_city5-2_city10-2,874748,8,0,0,0,0
8_3083698,fly-airplane_plane2_city5-2_city7-2,3083698,8,0,0,0,0
8_2887090,fly-airplane_plane2_city5-2_city4-2,2887090,8,0,0,0,0
8_3149234,fly-airplane_plane2_city5-2_city8-2,3149234,8,0,0,0,0
8_2690482,fly-airplane_plane2_city5-2_city1-2,2690482,8,0,0,0,0
8_3214770,fly-airplane_plane2_city5-2_city9-2,3214770,8,0,0,0,0
8_2756018,fly-airplane_plane2_city5-2_city2-2,2756018,8,0,0,0,0
8_3018162,fly-airplane_plane2_city5-2_city6-2,3018162,8,0,0,0,0
8_2821554,fly-airplane_plane2_city5-2_city3-2,2821554,8,0,0,0,0
8_1847843,fly-airplane_plane3_city3-2_city4-2,1847843,8,0,0,0,0
8_2109987,fly-airplane_plane3_city3-2_city8-2,2109987,8,0,0,0,0
8_1651235,fly-airplane_plane3_city3-2_city1-2,1651235,8,0,0,0,0
8_6860734,fly-airplane_plane3_city3-2_city10-2,6860734,8,0,0,0,0
8_1913379,fly-airplane_plane3_city3-2_city5-2,1913379,8,0,0,0,0
8_2175523,fly-airplane_plane3_city3-2_city9-2,2175523,8,0,0,0,0
8_1716771,fly-airplane_plane3_city3-2_city2-2,1716771,8,0,0,0,0
8_1978915,fly-airplane_plane3_city3-2_city6-2,1978915,8,0,0,0,0
8_2044451,fly-airplane_plane3_city3-2_city7-2,2044451,8,0,0,0,0
8_2168487,unload-truck_package3_truck1_city1-2,2168487,8,0,0,0,0
8_2168486,unload-truck_package3_truck1_city1-1,2168486,8,0,0,0,0
8_4565799,load-airplane_package5_plane3_city2-2,4565799,8,0,0,0,0
8_1206947,load-truck_package5_truck2_city2-2,1206947,8,0,0,0,0
8_772444,load-airplane_package5_plane4_city2-2,772444,8,0,0,0,0
8_4151532,load-airplane_package5_plane1_city2-2,4151532,8,0,0,0,0
8_358177,load-airplane_package5_plane2_city2-2,358177,8,0,0,0,0
8_6441645,unload-truck_package3_truck2_city2-2,6441645,8,0,0,0,0
8_6441644,unload-truck_package3_truck2_city2-1,6441644,8,0,0,0,0
8_2713826,unload-truck_package3_truck3_city3-2,2713826,8,0,0,0,0
8_2713825,unload-truck_package3_truck3_city3-1,2713825,8,0,0,0,0
8_3604059,unload-truck_package4_truck10_city10-2,3604059,8,0,0,0,0
8_3604058,unload-truck_package4_truck10_city10-1,3604058,8,0,0,0,0
8_4822095,load-airplane_package1_plane4_city3-2,4822095,8,0,0,0,0
8_1463243,load-truck_package1_truck3_city3-2,1463243,8,0,0,0,0
8_4407828,load-airplane_package1_plane2_city3-2,4407828,8,0,0,0,0
8_614473,load-airplane_package1_plane3_city3-2,614473,8,0,0,0,0
8_200206,load-airplane_package1_plane1_city3-2,200206,8,0,0,0,0
8_1960449,fly-airplane_plane4_city6-2_city3-2,1960449,8,0,0,0,0
8_2222593,fly-airplane_plane4_city6-2_city7-2,2222593,8,0,0,0,0
8_2025985,fly-airplane_plane4_city6-2_city4-2,2025985,8,0,0,0,0
8_2288129,fly-airplane_plane4_city6-2_city8-2,2288129,8,0,0,0,0
8_1829377,fly-airplane_plane4_city6-2_city1-2,1829377,8,0,0,0,0
8_4459224,fly-airplane_plane4_city6-2_city10-2,4459224,8,0,0,0,0
8_2091521,fly-airplane_plane4_city6-2_city5-2,2091521,8,0,0,0,0
8_2353665,fly-airplane_plane4_city6-2_city9-2,2353665,8,0,0,0,0
8_1894913,fly-airplane_plane4_city6-2_city2-2,1894913,8,0,0,0,0
8_6986984,unload-truck_package3_truck4_city4-2,6986984,8,0,0,0,0
8_6986983,unload-truck_package3_truck4_city4-1,6986983,8,0,0,0,0
8_3259165,unload-truck_package3_truck5_city5-2,3259165,8,0,0,0,0
8_3259164,unload-truck_package3_truck5_city5-1,3259164,8,0,0,0,0
8_7744831,load-truck_package3_truck4_city4-1,7744831,8,0,0,0,0
8_6481795,load-airplane_package3_plane2_city4-2,6481795,8,0,0,0,0
8_2688440,load-airplane_package3_plane3_city4-2,2688440,8,0,0,0,0
8_7744832,load-truck_package3_truck4_city4-2,7744832,8,0,0,0,0
8_2274173,load-airplane_package3_plane1_city4-2,2274173,8,0,0,0,0
8_6896062,load-airplane_package3_plane4_city4-2,6896062,8,0,0,0,0
8_2035794,fly-airplane_plane1_city5-2_city7-2,2035794,8,0,0,0,0
8_4644542,fly-airplane_plane1_city5-2_city10-2,4644542,8,0,0,0,0
8_1839186,fly-airplane_plane1_city5-2_city4-2,1839186,8,0,0,0,0
8_2101330,fly-airplane_plane1_city5-2_city8-2,2101330,8,0,0,0,0
8_1642578,fly-airplane_plane1_city5-2_city1-2,1642578,8,0,0,0,0
8_2166866,fly-airplane_plane1_city5-2_city9-2,2166866,8,0,0,0,0
8_1708114,fly-airplane_plane1_city5-2_city2-2,1708114,8,0,0,0,0
8_1970258,fly-airplane_plane1_city5-2_city6-2,1970258,8,0,0,0,0
8_1773650,fly-airplane_plane1_city5-2_city3-2,1773650,8,0,0,0,0
8_6584618,drive-truck_truck8_city8-1_city8-2_city8,6584618,8,0,0,0,0
8_5056999,unload-airplane_package1_plane1_city1-2,5056999,8,0,0,0,0
8_5319143,unload-airplane_package1_plane1_city5-2,5319143,8,0,0,0,0
8_5581287,unload-airplane_package1_plane1_city9-2,5581287,8,0,0,0,0
8_5122535,unload-airplane_package1_plane1_city2-2,5122535,8,0,0,0,0
8_5384679,unload-airplane_package1_plane1_city6-2,5384679,8,0,0,0,0
8_6629825,unload-airplane_package1_plane1_city10-2,6629825,8,0,0,0,0
8_5188071,unload-airplane_package1_plane1_city3-2,5188071,8,0,0,0,0
8_5450215,unload-airplane_package1_plane1_city7-2,5450215,8,0,0,0,0
8_5253607,unload-airplane_package1_plane1_city4-2,5253607,8,0,0,0,0
8_5515751,unload-airplane_package1_plane1_city8-2,5515751,8,0,0,0,0
8_7532323,unload-truck_package3_truck6_city6-2,7532323,8,0,0,0,0
8_7532322,unload-truck_package3_truck6_city6-1,7532322,8,0,0,0,0
8_5815785,load-airplane_package2_plane3_city6-2,5815785,8,0,0,0,0
8_2022430,load-airplane_package2_plane4_city6-2,2022430,8,0,0,0,0
8_5401518,load-airplane_package2_plane1_city6-2,5401518,8,0,0,0,0
8_3285467,load-truck_package2_truck6_city6-2,3285467,8,0,0,0,0
8_1608163,load-airplane_package2_plane2_city6-2,1608163,8,0,0,0,0
8_7041445,fly-airplane_plane2_city1-2_city9-2,7041445,8,0,0,0,0
8_6582693,fly-airplane_plane2_city1-2_city2-2,6582693,8,0,0,0,0
8_6844837,fly-airplane_plane2_city1-2_city6-2,6844837,8,0,0,0,0
8_6648229,fly-airplane_plane2_city1-2_city3-2,6648229,8,0,0,0,0
8_6910373,fly-airplane_plane2_city1-2_city7-2,6910373,8,0,0,0,0
8_6713765,fly-airplane_plane2_city1-2_city4-2,6713765,8,0,0,0,0
8_6975909,fly-airplane_plane2_city1-2_city8-2,6975909,8,0,0,0,0
8_4384354,fly-airplane_plane2_city1-2_city10-2,4384354,8,0,0,0,0
8_6779301,fly-airplane_plane2_city1-2_city5-2,6779301,8,0,0,0,0
8_3827153,drive-truck_truck8_city8-2_city8-1_city8,3827153,8,0,0,0,0
8_1722396,unload-airplane_package1_plane2_city8-2,1722396,8,0,0,0,0
8_1263644,unload-airplane_package1_plane2_city1-2,1263644,8,0,0,0,0
8_1525788,unload-airplane_package1_plane2_city5-2,1525788,8,0,0,0,0
8_1787932,unload-airplane_package1_plane2_city9-2,1787932,8,0,0,0,0
8_1329180,unload-airplane_package1_plane2_city2-2,1329180,8,0,0,0,0
8_1591324,unload-airplane_package1_plane2_city6-2,1591324,8,0,0,0,0
8_1394716,unload-airplane_package1_plane2_city3-2,1394716,8,0,0,0,0
8_3649162,unload-airplane_package1_plane2_city10-2,3649162,8,0,0,0,0
8_1656860,unload-airplane_package1_plane2_city7-2,1656860,8,0,0,0,0
8_1460252,unload-airplane_package1_plane2_city4-2,1460252,8,0,0,0,0
8_3804504,unload-truck_package3_truck7_city7-2,3804504,8,0,0,0,0
8_3804503,unload-truck_package3_truck7_city7-1,3804503,8,0,0,0,0
8_85171,drive-truck_truck1_city1-1_city1-2_city1,85171,8,0,0,0,0
8_668499,unload-airplane_package1_plane3_city10-2,668499,8,0,0,0,0
8_5798946,unload-airplane_package1_plane3_city6-2,5798946,8,0,0,0,0
8_5602338,unload-airplane_package1_plane3_city3-2,5602338,8,0,0,0,0
8_5864482,unload-airplane_package1_plane3_city7-2,5864482,8,0,0,0,0
8_5667874,unload-airplane_package1_plane3_city4-2,5667874,8,0,0,0,0
8_5930018,unload-airplane_package1_plane3_city8-2,5930018,8,0,0,0,0
8_5471266,unload-airplane_package1_plane3_city1-2,5471266,8,0,0,0,0
8_5733410,unload-airplane_package1_plane3_city5-2,5733410,8,0,0,0,0
8_5995554,unload-airplane_package1_plane3_city9-2,5995554,8,0,0,0,0
8_5536802,unload-airplane_package1_plane3_city2-2,5536802,8,0,0,0,0
8_76685,unload-truck_package3_truck8_city8-2,76685,8,0,0,0,0
8_76684,unload-truck_package3_truck8_city8-1,76684,8,0,0,0,0
8_7373853,unload-truck_package3_truck10_city10-2,7373853,8,0,0,0,0
8_7373852,unload-truck_package3_truck10_city10-1,7373852,8,0,0,0,0
8_1566078,load-truck_package4_truck7_city7-1,1566078,8,0,0,0,0
8_3720295,fly-airplane_plane1_city10-2_city4-2,3720295,8,0,0,0,0
8_3982439,fly-airplane_plane1_city10-2_city8-2,3982439,8,0,0,0,0
8_3523687,fly-airplane_plane1_city10-2_city1-2,3523687,8,0,0,0,0
8_3785831,fly-airplane_plane1_city10-2_city5-2,3785831,8,0,0,0,0
8_4047975,fly-airplane_plane1_city10-2_city9-2,4047975,8,0,0,0,0
8_3589223,fly-airplane_plane1_city10-2_city2-2,3589223,8,0,0,0,0
8_3851367,fly-airplane_plane1_city10-2_city6-2,3851367,8,0,0,0,0
8_3654759,fly-airplane_plane1_city10-2_city3-2,3654759,8,0,0,0,0
8_3916903,fly-airplane_plane1_city10-2_city7-2,3916903,8,0,0,0,0
8_1951792,fly-airplane_plane2_city8-2_city3-2,1951792,8,0,0,0,0
8_2213936,fly-airplane_plane2_city8-2_city7-2,2213936,8,0,0,0,0
8_2243032,fly-airplane_plane2_city8-2_city10-2,2243032,8,0,0,0,0
8_2017328,fly-airplane_plane2_city8-2_city4-2,2017328,8,0,0,0,0
8_1820720,fly-airplane_plane2_city8-2_city1-2,1820720,8,0,0,0,0
8_2082864,fly-airplane_plane2_city8-2_city5-2,2082864,8,0,0,0,0
8_2345008,fly-airplane_plane2_city8-2_city9-2,2345008,8,0,0,0,0
8_1886256,fly-airplane_plane2_city8-2_city2-2,1886256,8,0,0,0,0
8_2148400,fly-airplane_plane2_city8-2_city6-2,2148400,8,0,0,0,0
8_912545,fly-airplane_plane3_city6-2_city3-2,912545,8,0,0,0,0
8_228041,fly-airplane_plane3_city6-2_city10-2,228041,8,0,0,0,0
8_1174689,fly-airplane_plane3_city6-2_city7-2,1174689,8,0,0,0,0
8_978081,fly-airplane_plane3_city6-2_city4-2,978081,8,0,0,0,0
8_1240225,fly-airplane_plane3_city6-2_city8-2,1240225,8,0,0,0,0
8_781473,fly-airplane_plane3_city6-2_city1-2,781473,8,0,0,0,0
8_1043617,fly-airplane_plane3_city6-2_city5-2,1043617,8,0,0,0,0
8_1305761,fly-airplane_plane3_city6-2_city9-2,1305761,8,0,0,0,0
8_847009,fly-airplane_plane3_city6-2_city2-2,847009,8,0,0,0,0
8_5328683,drive-truck_truck1_city1-2_city1-1_city1,5328683,8,0,0,0,0
8_4096397,load-airplane_package4_plane4_city7-2,4096397,8,0,0,0,0
8_7475485,load-airplane_package4_plane1_city7-2,7475485,8,0,0,0,0
8_3682130,load-airplane_package4_plane2_city7-2,3682130,8,0,0,0,0
8_1566079,load-truck_package4_truck7_city7-2,1566079,8,0,0,0,0
8_7889752,load-airplane_package4_plane3_city7-2,7889752,8,0,0,0,0
8_2202199,unload-airplane_package1_plane4_city9-2,2202199,8,0,0,0,0
8_1743447,unload-airplane_package1_plane4_city2-2,1743447,8,0,0,0,0
8_2005591,unload-airplane_package1_plane4_city6-2,2005591,8,0,0,0,0
8_1808983,unload-airplane_package1_plane4_city3-2,1808983,8,0,0,0,0
8_2071127,unload-airplane_package1_plane4_city7-2,2071127,8,0,0,0,0
8_1874519,unload-airplane_package1_plane4_city4-2,1874519,8,0,0,0,0
8_5688813,unload-airplane_package1_plane4_city10-2,5688813,8,0,0,0,0
8_2136663,unload-airplane_package1_plane4_city8-2,2136663,8,0,0,0,0
8_1677911,unload-airplane_package1_plane4_city1-2,1677911,8,0,0,0,0
8_1940055,unload-airplane_package1_plane4_city5-2,1940055,8,0,0,0,0
8_4349843,unload-truck_package3_truck9_city9-2,4349843,8,0,0,0,0
8_4349842,unload-truck_package3_truck9_city9-1,4349842,8,0,0,0,0
8_6025444,load-truck_package5_truck5_city5-2,6025444,8,0,0,0,0
8_4348140,load-airplane_package5_plane1_city5-2,4348140,8,0,0,0,0
8_554785,load-airplane_package5_plane2_city5-2,554785,8,0,0,0,0
8_4762407,load-airplane_package5_plane3_city5-2,4762407,8,0,0,0,0
8_969052,load-airplane_package5_plane4_city5-2,969052,8,0,0,0,0
