id,name,hash,time,ind,otd,ad,bc
0_4312550,harmony_intoxication_uranus,4312550,0,0,5,5,0
1_2182175,noop_harmony_intoxication_uranus,2182175,1,2,8,10,0
1_7805069,overcome_boils-1_intoxication_arugula_earth_uranus,7805069,1,13,29,42,0
0_4203350,craves_intoxication_arugula,4203350,0,0,5,5,0
1_2072975,noop_craves_intoxication_arugula,2072975,1,3,20,23,0
1_3592004,feast_intoxication_arugula_wonderbread_alsace_surrey,3592004,1,11,28,39,0
1_7519785,feast_intoxication_arugula_potato_alsace_surrey,7519785,1,11,28,39,0
0_4452600,pain_depression-7,4452600,0,0,1,1,0
1_1499025,noop_pain_depression-7,1499025,1,1,1,2,0
0_6843000,pain_abrasion-4,6843000,0,0,3,3,0
1_145726,noop_pain_abrasion-4,145726,1,1,1,2,0
1_6459978,overcome_abrasion-4_rest_ham_mercury_saturn,6459978,1,15,30,45,0
0_918250,pain_boils,918250,0,0,4,4,0
1_6427428,noop_pain_boils,6427428,1,1,1,2,0
1_7796944,overcome_boils_lubricity_shrimp_earth_uranus,7796944,1,14,33,47,0
0_7897051,eats_turkey_shrimp,7897051,0,0,2,2,0
1_3873689,noop_eats_turkey_shrimp,3873689,1,1,1,2,0
0_365501,orbits_earth_uranus,365501,0,0,25,25,0
1_2510862,noop_orbits_earth_uranus,2510862,1,1,1,2,0
1_3572660,overcome_hangover_excitement_papaya_earth_uranus,3572660,1,14,30,44,0
1_5230030,overcome_prostatitis_entertainment_wurst_earth_uranus,5230030,1,11,11,22,0
1_4911427,overcome_jealousy_love_rice_earth_uranus,4911427,1,14,44,58,0
1_3292190,overcome_dread_excitement_papaya_earth_uranus,3292190,1,14,30,44,0
0_4332901,eats_mutton_ham,4332901,0,0,2,2,0
1_5636604,noop_eats_mutton_ham,5636604,1,1,1,2,0
0_3715801,orbits_saturn_earth,3715801,0,0,9,9,0
1_5861162,noop_orbits_saturn_earth,5861162,1,1,1,2,0
1_6252085,overcome_depression_achievement_endive_saturn_earth,6252085,1,14,30,44,0
1_6230834,overcome_grief_achievement_endive_saturn_earth,6230834,1,14,30,44,0
0_6759901,locale_yogurt_bosnia,6759901,0,0,3,3,0
1_3904904,noop_locale_yogurt_bosnia,3904904,1,1,3,4,0
0_3609901,province_surrey,3609901,0,0,1,1,0
1_4913604,noop_province_surrey,4913604,1,1,1,2,0
0_4317552,eats_marzipan_onion,4317552,0,0,3,3,0
1_6462913,noop_eats_marzipan_onion,6462913,1,1,1,2,0
0_676602,eats_marzipan_haroset,676602,0,0,3,3,0
1_5887254,noop_eats_marzipan_haroset,5887254,1,1,1,2,0
0_3095552,pain_boils-1,3095552,0,0,4,4,0
1_496858,noop_pain_boils-1,496858,1,1,1,2,0
0_6188452,food_ham,6188452,0,0,13,13,0
1_1903589,noop_food_ham,1903589,1,1,1,2,0
1_3561603,feast_rest_ham_onion_bavaria_guanabara,3561603,1,13,27,40,0
1_3876999,feast_rest_ham_mutton_bavaria_guanabara,3876999,1,13,27,40,0
1_1961477,feast_rest_ham_wonderbread_bavaria_guanabara,1961477,1,13,27,40,0
1_5941935,overcome_loneliness-3_rest_ham_mercury_saturn,5941935,1,15,30,45,0
0_2200903,pleasure_love,2200903,0,0,26,26,0
1_1016330,noop_pleasure_love,1016330,1,1,1,2,0
1_537240,feast_love_rice_papaya_bosnia_alsace,537240,1,12,46,58,0
1_7422623,feast_love_rice_marzipan_bosnia_alsace,7422623,1,12,46,58,0
1_6275620,feast_love_rice_cherry_bosnia_alsace,6275620,1,12,46,58,0
0_1833554,eats_yogurt_wonderbread,1833554,0,0,2,2,0
1_5424666,noop_eats_yogurt_wonderbread,5424666,1,1,1,2,0
0_3412554,food_marzipan,3412554,0,0,28,28,0
1_2227981,noop_food_marzipan,2227981,1,1,1,2,0
1_4153561,feast_satiety_cherry_marzipan_bosnia_alsace,4153561,1,12,46,58,0
0_1694955,craves_depression-7_haroset,1694955,0,0,1,1,0
1_7565557,noop_craves_depression-7_haroset,7565557,1,1,1,2,0
0_7894655,eats_arugula_wonderbread,7894655,0,0,4,4,0
1_7106972,noop_eats_arugula_wonderbread,7106972,1,1,1,2,0
0_4379955,locale_mutton_guanabara,4379955,0,0,3,3,0
1_7971067,noop_locale_mutton_guanabara,7971067,1,1,3,4,0
0_1473805,food_papaya,1473805,0,0,20,20,0
1_3651421,noop_food_papaya,3651421,1,1,1,2,0
1_7101164,feast_excitement_papaya_rice_bosnia_alsace,7101164,1,12,28,40,0
1_6885942,feast_excitement_papaya_wurst_bosnia_alsace,6885942,1,12,28,40,0
0_4380956,eats_marzipan_mutton,4380956,0,0,3,3,0
1_1525959,noop_eats_marzipan_mutton,1525959,1,1,1,2,0
0_2180706,eats_ham_onion,2180706,0,0,2,2,0
1_2967144,noop_eats_ham_onion,2967144,1,1,1,2,0
0_5423156,food_endive,5423156,0,0,20,20,0
1_7600772,noop_food_endive,7600772,1,1,1,2,0
1_2718660,feast_satiety_cherry_endive_bosnia_alsace,2718660,1,12,46,58,0
1_6269771,feast_achievement_endive_cherry_bosnia_alsace,6269771,1,12,28,40,0
1_2494215,feast_achievement_endive_wurst_bosnia_alsace,2494215,1,12,28,40,0
0_6551857,craves_jealousy-2_wonderbread,6551857,0,0,3,3,0
1_7344507,noop_craves_jealousy-2_wonderbread,7344507,1,1,3,4,0
0_2879007,craves_grief_endive,2879007,0,0,4,4,0
1_5024368,noop_craves_grief_endive,5024368,1,2,6,8,0
0_1766507,locale_shrimp_alsace,1766507,0,0,7,7,0
1_6912487,noop_locale_shrimp_alsace,6912487,1,4,27,31,0
1_7516608,feast_lubricity_shrimp_onion_bosnia_alsace,7516608,1,12,33,45,0
1_3474193,feast_lubricity_shrimp_turkey_bosnia_alsace,3474193,1,12,33,45,0
1_225428,feast_lubricity_shrimp_potato_bosnia_alsace,225428,1,12,33,45,0
0_541159,locale_rice_alsace,541159,0,0,10,10,0
1_4518774,noop_locale_rice_alsace,4518774,1,4,40,44,0
0_1126409,locale_ham_guanabara,1126409,0,0,4,4,0
1_6272389,noop_locale_ham_guanabara,6272389,1,4,19,23,0
0_197009,eats_wonderbread_ham,197009,0,0,3,3,0
1_5342989,noop_eats_wonderbread_ham,5342989,1,1,1,2,0
0_4985459,pain_sciatica,4985459,0,0,3,3,0
1_3800886,noop_pain_sciatica,3800886,1,1,1,2,0
0_7763559,pain_jealousy-2,7763559,0,0,3,3,0
1_1066285,noop_pain_jealousy-2,1066285,1,1,1,2,0
0_6432009,food_arugula,6432009,0,0,17,17,0
1_3833315,noop_food_arugula,3833315,1,1,1,2,0
1_7874447,feast_satisfaction_potato_arugula_guanabara_bosnia,7874447,1,12,41,53,0
0_7801210,eats_wurst_papaya,7801210,0,0,1,1,0
1_4847635,noop_eats_wurst_papaya,4847635,1,1,1,2,0
0_1370260,pain_anxiety,1370260,0,0,3,3,0
1_6772543,noop_pain_anxiety,6772543,1,1,1,2,0
0_3516611,harmony_excitement_uranus,3516611,0,0,5,5,0
1_1894188,noop_harmony_excitement_uranus,1894188,1,3,12,15,0
0_4565062,craves_prostatitis_wurst,4565062,0,0,4,4,0
1_3777379,noop_craves_prostatitis_wurst,3777379,1,2,7,9,0
0_6196362,pleasure_rest,6196362,0,0,19,19,0
1_5011789,noop_pleasure_rest,5011789,1,1,1,2,0
0_4744512,food_shrimp,4744512,0,0,21,21,0
1_6922128,noop_food_shrimp,6922128,1,1,1,2,0
1_7248052,feast_satisfaction_potato_shrimp_guanabara_bosnia,7248052,1,12,41,53,0
0_2456363,locale_haroset_guanabara,2456363,0,0,1,1,0
1_1668680,noop_locale_haroset_guanabara,1668680,1,1,1,2,0
0_3474113,pain_laceration-8,3474113,0,0,1,1,0
1_520538,noop_pain_laceration-8,520538,1,1,1,2,0
0_2459414,locale_marzipan_surrey,2459414,0,0,11,11,0
1_223167,noop_locale_marzipan_surrey,223167,1,1,11,12,0
0_5509864,eats_rice_papaya,5509864,0,0,6,6,0
1_3216798,noop_eats_rice_papaya,3216798,1,1,1,2,0
0_3163114,planet_earth,3163114,0,0,25,25,0
1_564420,noop_planet_earth,564420,1,1,1,2,0
0_7998514,pain_loneliness-3,7998514,0,0,3,3,0
1_5044939,noop_pain_loneliness-3,5044939,1,1,1,2,0
0_7991065,eats_mutton_marzipan,7991065,0,0,2,2,0
1_5136068,noop_eats_mutton_marzipan,5136068,1,1,1,2,0
0_4531615,harmony_satiety_saturn,4531615,0,0,7,7,0
1_2295368,noop_harmony_satiety_saturn,2295368,1,2,10,12,0
1_5890937,overcome_laceration_satiety_cherry_mercury_saturn,5890937,1,14,44,58,0
0_5397415,food_cherry,5397415,0,0,30,30,0
1_7575031,noop_food_cherry,7575031,1,1,1,2,0
1_622134,feast_satiety_cherry_rice_bosnia_alsace,622134,1,12,46,58,0
0_3282766,craves_jealousy_rice,3282766,0,0,4,4,0
1_427769,noop_craves_jealousy_rice,427769,1,2,7,9,0
0_1006816,craves_laceration-8_haroset,1006816,0,0,1,1,0
1_6877418,noop_craves_laceration-8_haroset,6877418,1,1,1,2,0
0_1414816,eats_ham_mutton,1414816,0,0,2,2,0
1_2718519,noop_eats_ham_mutton,2718519,1,1,1,2,0
0_131867,harmony_satisfaction_saturn,131867,0,0,5,5,0
1_6002469,noop_harmony_satisfaction_saturn,6002469,1,2,8,10,0
1_1387483,overcome_loneliness_satisfaction_potato_mercury_saturn,1387483,1,14,39,53,0
0_942867,craves_anger_marzipan,942867,0,0,3,3,0
1_6153519,noop_craves_anger_marzipan,6153519,1,1,3,4,0
0_1795018,eats_endive_cherry,1795018,0,0,4,4,0
1_5772633,noop_eats_endive_cherry,5772633,1,1,1,2,0
0_2216718,eats_potato_shrimp,2216718,0,0,6,6,0
1_6194333,noop_eats_potato_shrimp,6194333,1,1,1,2,0
0_7477118,locale_papaya_alsace,7477118,0,0,5,5,0
1_4622121,noop_locale_papaya_alsace,4622121,1,3,18,21,0
0_1840068,food_wonderbread,1840068,0,0,16,16,0
1_7547979,noop_food_wonderbread,7547979,1,1,1,2,0
0_7323719,craves_anxiety_marzipan,7323719,0,0,3,3,0
1_2913854,noop_craves_anxiety_marzipan,2913854,1,1,3,4,0
0_4439469,eats_ham_wonderbread,4439469,0,0,2,2,0
1_1584472,noop_eats_ham_wonderbread,1584472,1,1,1,2,0
0_4018670,eats_shrimp_onion,4018670,0,0,4,4,0
1_1065095,noop_eats_shrimp_onion,1065095,1,1,1,2,0
0_7813070,pain_abrasion,7813070,0,0,2,2,0
1_6628497,noop_pain_abrasion,6628497,1,1,1,2,0
0_1112071,craves_loneliness_potato,1112071,0,0,4,4,0
1_324388,noop_craves_loneliness_potato,324388,1,2,7,9,0
0_7367121,harmony_lubricity_uranus,7367121,0,0,4,4,0
1_6579438,noop_harmony_lubricity_uranus,6579438,1,2,7,9,0
0_7480922,planet_uranus,7480922,0,0,19,19,0
1_6296349,noop_planet_uranus,6296349,1,1,1,2,0
0_3933873,province_bavaria,3933873,0,0,1,1,0
1_1640807,noop_province_bavaria,1640807,1,1,1,2,0
0_1486223,pain_angina,1486223,0,0,3,3,0
1_3663839,noop_pain_angina,3663839,1,1,1,2,0
0_7159023,pain_depression,7159023,0,0,5,5,0
1_461749,noop_pain_depression,461749,1,1,1,2,0
0_5961424,province_guanabara,5961424,0,0,1,1,0
1_1938062,noop_province_guanabara,1938062,1,1,1,2,0
0_4866225,craves_satiety_cherry,4866225,0,0,6,6,0
1_2075900,noop_craves_satiety_cherry,2075900,1,4,34,38,0
0_3223975,eats_haroset_marzipan,3223975,0,0,1,1,0
1_433650,noop_eats_haroset_marzipan,433650,1,1,1,2,0
0_778475,pain_hangover,778475,0,0,5,5,0
1_7594879,noop_pain_hangover,7594879,1,1,1,2,0
0_5524126,eats_papaya_rice,5524126,0,0,4,4,0
1_3231060,noop_eats_papaya_rice,3231060,1,1,1,2,0
0_1567476,pain_anger,1567476,0,0,3,3,0
1_7076654,noop_pain_anger,7076654,1,1,1,2,0
0_6773576,food_potato,6773576,0,0,27,27,0
1_950215,noop_food_potato,950215,1,1,1,2,0
1_5584884,feast_satisfaction_potato_yogurt_guanabara_bosnia,5584884,1,12,41,53,0
0_1737877,attacks_bosnia_alsace,1737877,0,0,47,47,0
1_6948529,noop_attacks_bosnia_alsace,6948529,1,1,1,2,0
0_1682327,craves_boils_shrimp,1682327,0,0,3,3,0
1_3827688,noop_craves_boils_shrimp,3827688,1,2,6,8,0
0_6892927,attacks_guanabara_bosnia,6892927,0,0,31,31,0
1_6105244,noop_attacks_guanabara_bosnia,6105244,1,1,1,2,0
0_4737077,craves_loneliness-3_ham,4737077,0,0,2,2,0
1_327212,noop_craves_loneliness-3_ham,327212,1,2,4,6,0
0_3639227,locale_wonderbread_alsace,3639227,0,0,7,7,0
1_2016804,noop_locale_wonderbread_alsace,2016804,1,1,7,8,0
0_7775927,eats_potato_yogurt,7775927,0,0,6,6,0
1_3752565,noop_eats_potato_yogurt,3752565,1,1,1,2,0
0_6161127,locale_arugula_surrey,6161127,0,0,5,5,0
1_3370802,noop_locale_arugula_surrey,3370802,1,3,22,25,0
0_5370277,food_wurst,5370277,0,0,11,11,0
1_2878478,noop_food_wurst,2878478,1,1,1,2,0
0_1272578,locale_cherry_alsace,1272578,0,0,10,10,0
1_6418558,noop_locale_cherry_alsace,6418558,1,4,40,44,0
0_6951528,eats_marzipan_rice,6951528,0,0,3,3,0
1_2928166,noop_eats_marzipan_rice,2928166,1,1,1,2,0
0_2937679,craves_angina_onion,2937679,0,0,3,3,0
1_5083040,noop_craves_angina_onion,5083040,1,1,3,4,0
0_7203479,eats_marzipan_cherry,7203479,0,0,3,3,0
1_4348482,noop_eats_marzipan_cherry,4348482,1,1,1,2,0
0_6527729,orbits_mercury_saturn,6527729,0,0,22,22,0
1_3737404,noop_orbits_mercury_saturn,3737404,1,1,1,2,0
0_4462730,craves_abrasion-4_ham,4462730,0,0,2,2,0
1_1672405,noop_craves_abrasion-4_ham,1672405,1,2,4,6,0
0_492931,locale_wurst_goias,492931,0,0,1,1,0
1_4470546,noop_locale_wurst_goias,4470546,1,1,1,2,0
0_5428931,eats_cherry_marzipan,5428931,0,0,6,6,0
1_2573934,noop_eats_cherry_marzipan,2573934,1,1,1,2,0
0_3477531,harmony_entertainment_uranus,3477531,0,0,2,2,0
1_2167967,noop_harmony_entertainment_uranus,2167967,1,2,5,7,0
0_2996931,craves_dread_papaya,2996931,0,0,4,4,0
1_5142292,noop_craves_dread_papaya,5142292,1,2,6,8,0
0_3305631,craves_lubricity_shrimp,3305631,0,0,6,6,0
1_6896743,noop_craves_lubricity_shrimp,6896743,1,4,24,28,0
0_6406031,planet_saturn,6406031,0,0,24,24,0
1_5221458,noop_planet_saturn,5221458,1,1,1,2,0
0_5711881,pain_prostatitis,5711881,0,0,5,5,0
1_3418815,noop_pain_prostatitis,3418815,1,1,1,2,0
0_7395882,eats_potato_arugula,7395882,0,0,6,6,0
1_1540266,noop_eats_potato_arugula,1540266,1,1,1,2,0
0_3933582,pain_jealousy,3933582,0,0,5,5,0
1_2749009,noop_pain_jealousy,2749009,1,1,1,2,0
0_7865332,pain_dread,7865332,0,0,5,5,0
1_5373533,noop_pain_dread,5373533,1,1,1,2,0
0_601332,pleasure_achievement,601332,0,0,17,17,0
1_5747312,noop_pleasure_achievement,5747312,1,1,1,2,0
0_2932032,pleasure_excitement,2932032,0,0,17,17,0
1_5077393,noop_pleasure_excitement,5077393,1,1,1,2,0
0_1024883,locale_turkey_bavaria,1024883,0,0,3,3,0
1_6235535,noop_locale_turkey_bavaria,6235535,1,1,3,4,0
0_7920783,craves_entertainment_wurst,7920783,0,0,3,3,0
1_630322,noop_craves_entertainment_wurst,630322,1,1,1,2,0
0_5021833,eats_onion_ham,5021833,0,0,3,3,0
1_5808271,noop_eats_onion_ham,5808271,1,1,1,2,0
0_1830183,province_goias,1830183,0,0,1,1,0
1_2616621,noop_province_goias,2616621,1,1,1,2,0
0_1766033,pleasure_intoxication,1766033,0,0,17,17,0
1_6976685,noop_pleasure_intoxication,6976685,1,1,1,2,0
0_7298434,eats_shrimp_turkey,7298434,0,0,4,4,0
1_3275072,noop_eats_shrimp_turkey,3275072,1,1,1,2,0
0_5753084,craves_satisfaction_potato,5753084,0,0,6,6,0
1_6463600,noop_craves_satisfaction_potato,6463600,1,4,29,33,0
0_3749584,eats_wurst_endive,3749584,0,0,1,1,0
1_796009,noop_eats_wurst_endive,796009,1,1,1,2,0
0_7730434,harmony_rest_saturn,7730434,0,0,6,6,0
1_1874818,noop_harmony_rest_saturn,1874818,1,3,11,14,0
0_2380884,food_haroset,2380884,0,0,4,4,0
1_7783167,noop_food_haroset,7783167,1,1,1,2,0
0_6276535,eats_rice_marzipan,6276535,0,0,6,6,0
1_2253173,noop_eats_rice_marzipan,2253173,1,1,1,2,0
0_725535,craves_love_rice,725535,0,0,6,6,0
1_6433446,noop_craves_love_rice,6433446,1,4,34,38,0
0_3324635,craves_laceration_cherry,3324635,0,0,4,4,0
1_2536952,noop_craves_laceration_cherry,2536952,1,2,7,9,0
0_3519135,eats_yogurt_potato,3519135,0,0,2,2,0
1_7496750,noop_eats_yogurt_potato,7496750,1,1,1,2,0
0_1243086,pleasure_entertainment,1243086,0,0,3,3,0
1_7007816,noop_pleasure_entertainment,7007816,1,1,1,2,0
0_3810436,food_onion,3810436,0,0,15,15,0
1_1318637,noop_food_onion,1318637,1,1,1,2,0
0_346337,eats_arugula_potato,346337,0,0,4,4,0
1_2491698,noop_eats_arugula_potato,2491698,1,1,1,2,0
0_6318237,craves_depression_endive,6318237,0,0,4,4,0
1_5530554,noop_craves_depression_endive,5530554,1,2,6,8,0
0_2211538,eats_onion_marzipan,2211538,0,0,3,3,0
1_4356899,noop_eats_onion_marzipan,4356899,1,1,1,2,0
0_6280238,pleasure_satiety,6280238,0,0,26,26,0
1_3987172,noop_pleasure_satiety,3987172,1,1,1,2,0
0_323738,food_rice,323738,0,0,30,30,0
1_7533636,noop_food_rice,7533636,1,1,1,2,0
0_1180739,pain_laceration,1180739,0,0,5,5,0
1_2484442,noop_pain_laceration,2484442,1,1,1,2,0
0_7806391,eats_onion_shrimp,7806391,0,0,3,3,0
1_4852816,noop_eats_onion_shrimp,4852816,1,1,1,2,0
0_4074641,eats_shrimp_potato,4074641,0,0,4,4,0
1_51279,noop_eats_shrimp_potato,51279,1,1,1,2,0
0_4228691,attacks_bavaria_guanabara,4228691,0,0,12,12,0
1_2606268,noop_attacks_bavaria_guanabara,2606268,1,1,1,2,0
0_1332191,eats_turkey_haroset,1332191,0,0,2,2,0
1_3477552,noop_eats_turkey_haroset,3477552,1,1,1,2,0
0_4444941,attacks_goias_bavaria,4444941,0,0,3,3,0
1_1654616,noop_attacks_goias_bavaria,1654616,1,1,1,2,0
0_5631791,pain_loneliness,5631791,0,0,5,5,0
1_6935494,noop_pain_loneliness,6935494,1,1,1,2,0
0_4864341,pleasure_satisfaction,4864341,0,0,21,21,0
1_2074016,noop_pleasure_satisfaction,2074016,1,1,1,2,0
0_3135292,craves_hangover_papaya,3135292,0,0,4,4,0
1_899045,noop_craves_hangover_papaya,899045,1,2,6,8,0
0_2230292,eats_cherry_endive,2230292,0,0,6,6,0
1_6207907,noop_eats_cherry_endive,6207907,1,1,1,2,0
0_2407942,craves_excitement_papaya,2407942,0,0,9,9,0
1_1620259,noop_craves_excitement_papaya,1620259,1,3,16,19,0
0_1996392,food_turkey,1996392,0,0,6,6,0
1_4174008,noop_food_turkey,4174008,1,1,1,2,0
0_2574892,food_mutton,2574892,0,0,6,6,0
1_4752508,noop_food_mutton,4752508,1,1,1,2,0
0_2928243,harmony_love_uranus,2928243,0,0,7,7,0
1_5073604,noop_harmony_love_uranus,5073604,1,2,10,12,0
0_3456443,pain_grief,3456443,0,0,5,5,0
1_964644,noop_pain_grief,964644,1,1,1,2,0
0_6284244,craves_rest_ham,6284244,0,0,8,8,0
1_7587947,noop_craves_rest_ham,7587947,1,4,19,23,0
0_2302744,food_yogurt,2302744,0,0,11,11,0
1_4480360,noop_food_yogurt,4480360,1,1,1,2,0
0_7928595,craves_achievement_endive,7928595,0,0,9,9,0
1_6306172,noop_craves_achievement_endive,6306172,1,3,16,19,0
0_863045,locale_endive_alsace,863045,0,0,5,5,0
1_6009025,noop_locale_endive_alsace,6009025,1,3,18,21,0
0_5051695,craves_abrasion_yogurt,5051695,0,0,2,2,0
1_2815448,noop_craves_abrasion_yogurt,2815448,1,1,2,3,0
0_2252646,eats_haroset_turkey,2252646,0,0,1,1,0
1_4398007,noop_eats_haroset_turkey,4398007,1,1,1,2,0
0_506446,eats_papaya_wurst,506446,0,0,4,4,0
1_5553848,noop_eats_papaya_wurst,5553848,1,1,1,2,0
0_3962347,harmony_achievement_earth,3962347,0,0,5,5,0
1_2339924,noop_harmony_achievement_earth,2339924,1,3,12,15,0
0_7131947,locale_onion_alsace,7131947,0,0,7,7,0
1_1276331,noop_locale_onion_alsace,1276331,1,1,7,8,0
0_1432497,eats_rice_cherry,1432497,0,0,6,6,0
1_7140408,noop_eats_rice_cherry,7140408,1,1,1,2,0
0_6255097,craves_sciatica_wonderbread,6255097,0,0,3,3,0
1_4124722,noop_craves_sciatica_wonderbread,4124722,1,1,3,4,0
0_7414097,eats_wonderbread_yogurt,7414097,0,0,3,3,0
1_3004232,noop_eats_wonderbread_yogurt,3004232,1,1,1,2,0
0_690997,province_alsace,690997,0,0,1,1,0
1_1994700,noop_province_alsace,1994700,1,1,1,2,0
0_6239897,province_bosnia,6239897,0,0,1,1,0
1_7543600,noop_province_bosnia,7543600,1,1,1,2,0
0_7486548,locale_potato_bosnia,7486548,0,0,10,10,0
1_4631551,noop_locale_potato_bosnia,4631551,1,4,35,39,0
0_5173398,craves_boils-1_arugula,5173398,0,0,3,3,0
1_2937151,noop_craves_boils-1_arugula,2937151,1,2,6,8,0
0_7908898,planet_mercury,7908898,0,0,18,18,0
1_694359,noop_planet_mercury,694359,1,1,1,2,0
0_4692999,attacks_alsace_surrey,4692999,0,0,15,15,0
1_1902674,noop_attacks_alsace_surrey,1902674,1,1,1,2,0
0_2778149,eats_wonderbread_arugula,2778149,0,0,3,3,0
1_1990466,noop_eats_wonderbread_arugula,1990466,1,1,1,2,0
0_5265699,eats_cherry_rice,5265699,0,0,6,6,0
1_2972633,noop_eats_cherry_rice,2972633,1,1,1,2,0
0_7762749,eats_endive_wurst,7762749,0,0,4,4,0
1_4809174,noop_eats_endive_wurst,4809174,1,1,1,2,0
0_6440549,pleasure_lubricity,6440549,0,0,19,19,0
1_2417187,noop_pleasure_lubricity,2417187,1,1,1,2,0
0_7543600,noop_province_bosnia,7543600,0,0,1,1,0
1_6239897,province_bosnia,6239897,1,1,1,2,0
0_1994700,noop_province_alsace,1994700,0,0,1,1,0
1_690997,province_alsace,690997,1,1,1,2,0
0_7496750,noop_eats_yogurt_potato,7496750,0,0,1,1,0
1_3519135,eats_yogurt_potato,3519135,1,1,8,9,0
0_6463600,noop_craves_satisfaction_potato,6463600,0,0,4,4,0
1_5753084,craves_satisfaction_potato,5753084,1,4,16,20,0
0_433650,noop_eats_haroset_marzipan,433650,0,0,1,1,0
1_3223975,eats_haroset_marzipan,3223975,1,1,4,5,0
0_2075900,noop_craves_satiety_cherry,2075900,0,0,4,4,0
1_4866225,craves_satiety_cherry,4866225,1,4,16,20,0
0_2937151,noop_craves_boils-1_arugula,2937151,0,0,2,2,0
1_5173398,craves_boils-1_arugula,5173398,1,2,8,10,0
0_4631551,noop_locale_potato_bosnia,4631551,0,0,4,4,0
1_7486548,locale_potato_bosnia,7486548,1,4,14,18,0
0_3477552,noop_eats_turkey_haroset,3477552,0,0,1,1,0
1_1332191,eats_turkey_haroset,1332191,1,1,3,4,0
0_2536952,noop_craves_laceration_cherry,2536952,0,0,2,2,0
1_3324635,craves_laceration_cherry,3324635,1,2,9,11,0
0_3370802,noop_locale_arugula_surrey,3370802,0,0,3,3,0
1_6161127,locale_arugula_surrey,6161127,1,3,12,15,0
0_7248052,feast_satisfaction_potato_shrimp_guanabara_bosnia,7248052,0,0,9,9,0
1_1091294,locale_potato_guanabara,1091294,1,3,14,17,0
1_3724020,craves_satisfaction_shrimp,3724020,1,1,16,17,0
0_3561603,feast_rest_ham_onion_bavaria_guanabara,3561603,0,0,8,8,0
1_3967861,locale_ham_bavaria,3967861,1,3,15,18,0
1_868003,craves_rest_onion,868003,1,1,11,12,0
1_6284244,craves_rest_ham,6284244,1,3,15,18,0
1_1126409,locale_ham_guanabara,1126409,1,3,14,17,0
0_5073604,noop_harmony_love_uranus,5073604,0,0,2,2,0
1_2928243,harmony_love_uranus,2928243,1,2,15,17,0
0_5530554,noop_craves_depression_endive,5530554,0,0,2,2,0
1_6318237,craves_depression_endive,6318237,1,2,6,8,0
0_3737404,noop_orbits_mercury_saturn,3737404,0,0,1,1,0
1_6527729,orbits_mercury_saturn,6527729,1,1,65,66,0
0_2016804,noop_locale_wonderbread_alsace,2016804,0,0,1,1,0
1_3639227,locale_wonderbread_alsace,3639227,1,1,10,11,0
0_7076654,noop_pain_anger,7076654,0,0,1,1,0
1_1567476,pain_anger,1567476,1,1,10,11,0
0_2913854,noop_craves_anxiety_marzipan,2913854,0,0,1,1,0
1_7323719,craves_anxiety_marzipan,7323719,1,1,8,9,0
0_5887254,noop_eats_marzipan_haroset,5887254,0,0,1,1,0
1_676602,eats_marzipan_haroset,676602,1,1,13,14,0
0_4913604,noop_province_surrey,4913604,0,0,1,1,0
1_3609901,province_surrey,3609901,1,1,1,2,0
0_3904904,noop_locale_yogurt_bosnia,3904904,0,0,1,1,0
1_6759901,locale_yogurt_bosnia,6759901,1,1,9,10,0
0_5636604,noop_eats_mutton_ham,5636604,0,0,1,1,0
1_4332901,eats_mutton_ham,4332901,1,1,6,7,0
0_3592004,feast_intoxication_arugula_wonderbread_alsace_surrey,3592004,0,0,7,7,0
1_3242223,locale_arugula_alsace,3242223,1,2,11,13,0
1_2799049,craves_intoxication_wonderbread,2799049,1,1,19,20,0
1_4203350,craves_intoxication_arugula,4203350,1,2,10,12,0
0_1672405,noop_craves_abrasion-4_ham,1672405,0,0,2,2,0
1_4462730,craves_abrasion-4_ham,4462730,1,2,5,7,0
0_4398007,noop_eats_haroset_turkey,4398007,0,0,1,1,0
1_2252646,eats_haroset_turkey,2252646,1,1,4,5,0
0_6207907,noop_eats_cherry_endive,6207907,0,0,1,1,0
1_2230292,eats_cherry_endive,2230292,1,1,13,14,0
0_1640807,noop_province_bavaria,1640807,0,0,1,1,0
1_3933873,province_bavaria,3933873,1,1,1,2,0
0_7344507,noop_craves_jealousy-2_wonderbread,7344507,0,0,1,1,0
1_6551857,craves_jealousy-2_wonderbread,6551857,1,1,5,6,0
0_7565557,noop_craves_depression-7_haroset,7565557,0,0,1,1,0
1_1694955,craves_depression-7_haroset,1694955,1,1,4,5,0
0_7140408,noop_eats_rice_cherry,7140408,0,0,1,1,0
1_1432497,eats_rice_cherry,1432497,1,1,13,14,0
0_4752508,noop_food_mutton,4752508,0,0,1,1,0
1_2574892,food_mutton,2574892,1,1,31,32,0
0_4174008,noop_food_turkey,4174008,0,0,1,1,0
1_1996392,food_turkey,1996392,1,1,20,21,0
0_5221458,noop_planet_saturn,5221458,0,0,1,1,0
1_6406031,planet_saturn,6406031,1,1,60,61,0
0_6418558,noop_locale_cherry_alsace,6418558,0,0,4,4,0
1_1272578,locale_cherry_alsace,1272578,1,4,17,21,0
0_496858,noop_pain_boils-1,496858,0,0,1,1,0
1_3095552,pain_boils-1,3095552,1,1,10,11,0
0_7516608,feast_lubricity_shrimp_onion_bosnia_alsace,7516608,0,0,7,7,0
1_7315407,locale_shrimp_bosnia,7315407,1,3,13,16,0
1_2335886,craves_lubricity_onion,2335886,1,1,17,18,0
1_3305631,craves_lubricity_shrimp,3305631,1,3,17,20,0
1_1766507,locale_shrimp_alsace,1766507,1,3,17,20,0
0_694359,noop_planet_mercury,694359,0,0,1,1,0
1_7908898,planet_mercury,7908898,1,1,36,37,0
0_1620259,noop_craves_excitement_papaya,1620259,0,0,3,3,0
1_2407942,craves_excitement_papaya,2407942,1,3,20,23,0
0_796009,noop_eats_wurst_endive,796009,0,0,1,1,0
1_3749584,eats_wurst_endive,3749584,1,1,1,2,0
0_2749009,noop_pain_jealousy,2749009,0,0,1,1,0
1_3933582,pain_jealousy,3933582,1,1,13,14,0
0_1525959,noop_eats_marzipan_mutton,1525959,0,0,1,1,0
1_4380956,eats_marzipan_mutton,4380956,1,1,13,14,0
0_4480360,noop_food_yogurt,4480360,0,0,1,1,0
1_2302744,food_yogurt,2302744,1,1,36,37,0
0_3231060,noop_eats_papaya_rice,3231060,0,0,1,1,0
1_5524126,eats_papaya_rice,5524126,1,1,9,10,0
0_2718660,feast_satiety_cherry_endive_bosnia_alsace,2718660,0,0,9,9,0
1_6821478,locale_cherry_bosnia,6821478,1,3,17,20,0
1_4891966,craves_satiety_endive,4891966,1,1,15,16,0
0_3572660,overcome_hangover_excitement_papaya_earth_uranus,3572660,0,0,7,7,0
1_2366283,harmony_excitement_earth,2366283,1,2,17,19,0
1_3206743,fears_hangover_excitement,3206743,1,1,10,11,0
1_3135292,craves_hangover_papaya,3135292,1,1,8,9,0
1_3516611,harmony_excitement_uranus,3516611,1,2,8,10,0
0_4153561,feast_satiety_cherry_marzipan_bosnia_alsace,4153561,0,0,9,9,0
1_3595641,craves_satiety_marzipan,3595641,1,1,22,23,0
0_5747312,noop_pleasure_achievement,5747312,0,0,1,1,0
1_601332,pleasure_achievement,601332,1,1,56,57,0
0_327212,noop_craves_loneliness-3_ham,327212,0,0,2,2,0
1_4737077,craves_loneliness-3_ham,4737077,1,2,5,7,0
0_1938062,noop_province_guanabara,1938062,0,0,1,1,0
1_5961424,province_guanabara,5961424,1,1,1,2,0
0_5861162,noop_orbits_saturn_earth,5861162,0,0,1,1,0
1_3715801,orbits_saturn_earth,3715801,1,1,35,36,0
0_2510862,noop_orbits_earth_uranus,2510862,0,0,1,1,0
1_365501,orbits_earth_uranus,365501,1,1,70,71,0
0_6462913,noop_eats_marzipan_onion,6462913,0,0,1,1,0
1_4317552,eats_marzipan_onion,4317552,1,1,13,14,0
0_7101164,feast_excitement_papaya_rice_bosnia_alsace,7101164,0,0,8,8,0
1_5025041,locale_papaya_bosnia,5025041,1,2,12,14,0
1_2490887,craves_excitement_rice,2490887,1,1,21,22,0
1_7477118,locale_papaya_alsace,7477118,1,2,10,12,0
0_3418815,noop_pain_prostatitis,3418815,0,0,1,1,0
1_5711881,pain_prostatitis,5711881,1,1,11,12,0
0_3752565,noop_eats_potato_yogurt,3752565,0,0,1,1,0
1_7775927,eats_potato_yogurt,7775927,1,1,10,11,0
0_950215,noop_food_potato,950215,0,0,1,1,0
1_6773576,food_potato,6773576,1,1,67,68,0
0_3833315,noop_food_arugula,3833315,0,0,1,1,0
1_6432009,food_arugula,6432009,1,1,46,47,0
0_2494215,feast_achievement_endive_wurst_bosnia_alsace,2494215,0,0,7,7,0
1_6411945,locale_endive_bosnia,6411945,1,2,12,14,0
1_7911623,craves_achievement_wurst,7911623,1,1,11,12,0
1_7928595,craves_achievement_endive,7928595,1,2,18,20,0
1_863045,locale_endive_alsace,863045,1,2,10,12,0
0_1990466,noop_eats_wonderbread_arugula,1990466,0,0,1,1,0
1_2778149,eats_wonderbread_arugula,2778149,1,1,7,8,0
0_2074016,noop_pleasure_satisfaction,2074016,0,0,1,1,0
1_4864341,pleasure_satisfaction,4864341,1,1,50,51,0
0_1654616,noop_attacks_goias_bavaria,1654616,0,0,1,1,0
1_4444941,attacks_goias_bavaria,4444941,1,1,27,28,0
0_4852816,noop_eats_onion_shrimp,4852816,0,0,1,1,0
1_7806391,eats_onion_shrimp,7806391,1,1,11,12,0
0_7007816,noop_pleasure_entertainment,7007816,0,0,1,1,0
1_1243086,pleasure_entertainment,1243086,1,1,3,4,0
0_1540266,noop_eats_potato_arugula,1540266,0,0,1,1,0
1_7395882,eats_potato_arugula,7395882,1,1,10,11,0
0_2928166,noop_eats_marzipan_rice,2928166,0,0,1,1,0
1_6951528,eats_marzipan_rice,6951528,1,1,13,14,0
0_5424666,noop_eats_yogurt_wonderbread,5424666,0,0,1,1,0
1_1833554,eats_yogurt_wonderbread,1833554,1,1,8,9,0
0_7783167,noop_food_haroset,7783167,0,0,1,1,0
1_2380884,food_haroset,2380884,1,1,27,28,0
0_2167967,noop_harmony_entertainment_uranus,2167967,0,0,2,2,0
1_3477531,harmony_entertainment_uranus,3477531,1,2,4,6,0
0_223167,noop_locale_marzipan_surrey,223167,0,0,1,1,0
1_2459414,locale_marzipan_surrey,2459414,1,1,31,32,0
0_7971067,noop_locale_mutton_guanabara,7971067,0,0,1,1,0
1_4379955,locale_mutton_guanabara,4379955,1,1,7,8,0
0_2606268,noop_attacks_bavaria_guanabara,2606268,0,0,1,1,0
1_4228691,attacks_bavaria_guanabara,4228691,1,1,78,79,0
0_1874818,noop_harmony_rest_saturn,1874818,0,0,3,3,0
1_7730434,harmony_rest_saturn,7730434,1,3,14,17,0
0_6877418,noop_craves_laceration-8_haroset,6877418,0,0,1,1,0
1_1006816,craves_laceration-8_haroset,1006816,1,1,4,5,0
0_2295368,noop_harmony_satiety_saturn,2295368,0,0,2,2,0
1_4531615,harmony_satiety_saturn,4531615,1,2,15,17,0
0_5136068,noop_eats_mutton_marzipan,5136068,0,0,1,1,0
1_7991065,eats_mutton_marzipan,7991065,1,1,6,7,0
0_5024368,noop_craves_grief_endive,5024368,0,0,2,2,0
1_2879007,craves_grief_endive,2879007,1,2,6,8,0
0_6153519,noop_craves_anger_marzipan,6153519,0,0,1,1,0
1_942867,craves_anger_marzipan,942867,1,1,8,9,0
0_6002469,noop_harmony_satisfaction_saturn,6002469,0,0,2,2,0
1_131867,harmony_satisfaction_saturn,131867,1,2,10,12,0
0_2718519,noop_eats_ham_mutton,2718519,0,0,1,1,0
1_1414816,eats_ham_mutton,1414816,1,1,7,8,0
0_427769,noop_craves_jealousy_rice,427769,0,0,2,2,0
1_3282766,craves_jealousy_rice,3282766,1,2,9,11,0
0_7805069,overcome_boils-1_intoxication_arugula_earth_uranus,7805069,0,0,7,7,0
1_4775936,harmony_intoxication_earth,4775936,1,1,16,17,0
1_4731683,fears_boils-1_intoxication,4731683,1,1,7,8,0
1_4312550,harmony_intoxication_uranus,4312550,1,1,9,10,0
0_564420,noop_planet_earth,564420,0,0,1,1,0
1_3163114,planet_earth,3163114,1,1,64,65,0
0_6275620,feast_love_rice_cherry_bosnia_alsace,6275620,0,0,7,7,0
1_6090059,locale_rice_bosnia,6090059,1,3,17,20,0
1_6350300,craves_love_cherry,6350300,1,1,14,15,0
1_725535,craves_love_rice,725535,1,3,17,20,0
1_541159,locale_rice_alsace,541159,1,3,15,18,0
0_2616621,noop_province_goias,2616621,0,0,1,1,0
1_1830183,province_goias,1830183,1,1,1,2,0
0_5808271,noop_eats_onion_ham,5808271,0,0,1,1,0
1_5021833,eats_onion_ham,5021833,1,1,11,12,0
0_4622121,noop_locale_papaya_alsace,4622121,0,0,3,3,0
0_3651421,noop_food_papaya,3651421,0,0,1,1,0
1_1473805,food_papaya,1473805,1,1,48,49,0
0_6269771,feast_achievement_endive_cherry_bosnia_alsace,6269771,0,0,9,9,0
1_7902854,craves_achievement_cherry,7902854,1,1,15,16,0
0_4124722,noop_craves_sciatica_wonderbread,4124722,0,0,1,1,0
1_6255097,craves_sciatica_wonderbread,6255097,1,1,5,6,0
0_6306172,noop_craves_achievement_endive,6306172,0,0,3,3,0
0_3987172,noop_pleasure_satiety,3987172,0,0,1,1,0
1_6280238,pleasure_satiety,6280238,1,1,72,73,0
0_3275072,noop_eats_shrimp_turkey,3275072,0,0,1,1,0
1_7298434,eats_shrimp_turkey,7298434,1,1,12,13,0
0_630322,noop_craves_entertainment_wurst,630322,0,0,1,1,0
1_7920783,craves_entertainment_wurst,7920783,1,1,3,4,0
0_1584472,noop_eats_ham_wonderbread,1584472,0,0,1,1,0
1_4439469,eats_ham_wonderbread,4439469,1,1,7,8,0
0_7600772,noop_food_endive,7600772,0,0,1,1,0
1_5423156,food_endive,5423156,1,1,44,45,0
0_7106972,noop_eats_arugula_wonderbread,7106972,0,0,1,1,0
1_7894655,eats_arugula_wonderbread,7894655,1,1,12,13,0
0_2253173,noop_eats_rice_marzipan,2253173,0,0,1,1,0
1_6276535,eats_rice_marzipan,6276535,1,1,13,14,0
0_7422623,feast_love_rice_marzipan_bosnia_alsace,7422623,0,0,9,9,0
1_4058429,craves_love_marzipan,4058429,1,1,24,25,0
0_4809174,noop_eats_endive_wurst,4809174,0,0,1,1,0
1_7762749,eats_endive_wurst,7762749,1,1,9,10,0
0_1902674,noop_attacks_alsace_surrey,1902674,0,0,1,1,0
1_4692999,attacks_alsace_surrey,4692999,1,1,39,40,0
0_2339924,noop_harmony_achievement_earth,2339924,0,0,3,3,0
1_3962347,harmony_achievement_earth,3962347,1,3,11,14,0
0_4518774,noop_locale_rice_alsace,4518774,0,0,4,4,0
0_6009025,noop_locale_endive_alsace,6009025,0,0,3,3,0
0_1499025,noop_pain_depression-7,1499025,0,0,1,1,0
1_4452600,pain_depression-7,4452600,1,1,4,5,0
0_2072975,noop_craves_intoxication_arugula,2072975,0,0,3,3,0
0_2182175,noop_harmony_intoxication_uranus,2182175,0,0,2,2,0
0_145726,noop_pain_abrasion-4,145726,0,0,1,1,0
1_6843000,pain_abrasion-4,6843000,1,1,8,9,0
0_1961477,feast_rest_ham_wonderbread_bavaria_guanabara,1961477,0,0,10,10,0
1_1149340,craves_rest_wonderbread,1149340,1,1,20,21,0
0_4911427,overcome_jealousy_love_rice_earth_uranus,4911427,0,0,9,9,0
1_4864290,harmony_love_earth,4864290,1,1,22,23,0
1_4484680,fears_jealousy_love,4484680,1,1,9,10,0
0_2878478,noop_food_wurst,2878478,0,0,1,1,0
1_5370277,food_wurst,5370277,1,1,31,32,0
0_6922128,noop_food_shrimp,6922128,0,0,1,1,0
1_4744512,food_shrimp,4744512,1,1,63,64,0
0_6427428,noop_pain_boils,6427428,0,0,1,1,0
1_918250,pain_boils,918250,1,1,11,12,0
0_225428,feast_lubricity_shrimp_potato_bosnia_alsace,225428,0,0,9,9,0
1_5334695,craves_lubricity_potato,5334695,1,1,20,21,0
0_6459978,overcome_abrasion-4_rest_ham_mercury_saturn,6459978,0,0,10,10,0
1_2914055,harmony_rest_mercury,2914055,1,2,14,16,0
1_164979,fears_abrasion-4_rest,164979,1,1,11,12,0
0_51279,noop_eats_shrimp_potato,51279,0,0,1,1,0
1_4074641,eats_shrimp_potato,4074641,1,1,12,13,0
0_6948529,noop_attacks_bosnia_alsace,6948529,0,0,1,1,0
1_1737877,attacks_bosnia_alsace,1737877,1,1,111,112,0
0_7594879,noop_pain_hangover,7594879,0,0,1,1,0
1_778475,pain_hangover,778475,1,1,12,13,0
0_7547979,noop_food_wonderbread,7547979,0,0,1,1,0
1_1840068,food_wonderbread,1840068,1,1,58,59,0
0_3777379,noop_craves_prostatitis_wurst,3777379,0,0,2,2,0
1_4565062,craves_prostatitis_wurst,4565062,1,2,8,10,0
0_1668680,noop_locale_haroset_guanabara,1668680,0,0,1,1,0
1_2456363,locale_haroset_guanabara,2456363,1,1,7,8,0
0_1016330,noop_pleasure_love,1016330,0,0,1,1,0
1_2200903,pleasure_love,2200903,1,1,78,79,0
0_5230030,overcome_prostatitis_entertainment_wurst_earth_uranus,5230030,0,0,6,6,0
1_3616283,harmony_entertainment_earth,3616283,1,1,4,5,0
1_2810155,fears_prostatitis_entertainment,2810155,1,1,2,3,0
0_1276331,noop_locale_onion_alsace,1276331,0,0,1,1,0
1_7131947,locale_onion_alsace,7131947,1,1,16,17,0
0_7575031,noop_food_cherry,7575031,0,0,1,1,0
1_5397415,food_cherry,5397415,1,1,81,82,0
0_2227981,noop_food_marzipan,2227981,0,0,1,1,0
1_3412554,food_marzipan,3412554,1,1,123,124,0
0_3004232,noop_eats_wonderbread_yogurt,3004232,0,0,1,1,0
1_7414097,eats_wonderbread_yogurt,7414097,1,1,7,8,0
0_4348482,noop_eats_marzipan_cherry,4348482,0,0,1,1,0
1_7203479,eats_marzipan_cherry,7203479,1,1,13,14,0
0_2972633,noop_eats_cherry_rice,2972633,0,0,1,1,0
1_5265699,eats_cherry_rice,5265699,1,1,13,14,0
0_5373533,noop_pain_dread,5373533,0,0,1,1,0
1_7865332,pain_dread,7865332,1,1,12,13,0
0_6194333,noop_eats_potato_shrimp,6194333,0,0,1,1,0
1_2216718,eats_potato_shrimp,2216718,1,1,10,11,0
0_5772633,noop_eats_endive_cherry,5772633,0,0,1,1,0
1_1795018,eats_endive_cherry,1795018,1,1,9,10,0
0_1387483,overcome_loneliness_satisfaction_potato_mercury_saturn,1387483,0,0,8,8,0
1_1918314,harmony_satisfaction_mercury,1918314,1,1,14,15,0
1_6982256,fears_loneliness_satisfaction,6982256,1,1,7,8,0
1_1112071,craves_loneliness_potato,1112071,1,1,8,9,0
0_2573934,noop_eats_cherry_marzipan,2573934,0,0,1,1,0
1_5428931,eats_cherry_marzipan,5428931,1,1,13,14,0
0_622134,feast_satiety_cherry_rice_bosnia_alsace,622134,0,0,9,9,0
1_2670452,craves_satiety_rice,2670452,1,1,13,14,0
0_5584884,feast_satisfaction_potato_yogurt_guanabara_bosnia,5584884,0,0,9,9,0
1_1282252,craves_satisfaction_yogurt,1282252,1,1,6,7,0
0_6230834,overcome_grief_achievement_endive_saturn_earth,6230834,0,0,9,9,0
1_2984277,harmony_achievement_saturn,2984277,1,2,17,19,0
1_3723475,fears_grief_achievement,3723475,1,1,8,9,0
0_6976685,noop_pleasure_intoxication,6976685,0,0,1,1,0
1_1766033,pleasure_intoxication,1766033,1,1,59,60,0
0_6235535,noop_locale_turkey_bavaria,6235535,0,0,1,1,0
1_1024883,locale_turkey_bavaria,1024883,1,1,5,6,0
0_4847635,noop_eats_wurst_papaya,4847635,0,0,1,1,0
1_7801210,eats_wurst_papaya,7801210,1,1,1,2,0
0_1066285,noop_pain_jealousy-2,1066285,0,0,1,1,0
1_7763559,pain_jealousy-2,7763559,1,1,7,8,0
0_7519785,feast_intoxication_arugula_potato_alsace_surrey,7519785,0,0,8,8,0
1_857899,craves_intoxication_potato,857899,1,1,19,20,0
0_5941935,overcome_loneliness-3_rest_ham_mercury_saturn,5941935,0,0,10,10,0
1_1105319,fears_loneliness-3_rest,1105319,1,1,11,12,0
0_6252085,overcome_depression_achievement_endive_saturn_earth,6252085,0,0,9,9,0
1_1976428,fears_depression_achievement,1976428,1,1,10,11,0
0_7533636,noop_food_rice,7533636,0,0,1,1,0
1_323738,food_rice,323738,1,1,81,82,0
0_3800886,noop_pain_sciatica,3800886,0,0,1,1,0
1_4985459,pain_sciatica,4985459,1,1,7,8,0
0_2417187,noop_pleasure_lubricity,2417187,0,0,1,1,0
1_6440549,pleasure_lubricity,6440549,1,1,75,76,0
0_1318637,noop_food_onion,1318637,0,0,1,1,0
1_3810436,food_onion,3810436,1,1,71,72,0
0_6912487,noop_locale_shrimp_alsace,6912487,0,0,4,4,0
0_5890937,overcome_laceration_satiety_cherry_mercury_saturn,5890937,0,0,9,9,0
1_116045,harmony_satiety_mercury,116045,1,1,16,17,0
1_2484468,fears_laceration_satiety,2484468,1,1,8,9,0
0_3827688,noop_craves_boils_shrimp,3827688,0,0,2,2,0
1_1682327,craves_boils_shrimp,1682327,1,2,8,10,0
0_6579438,noop_harmony_lubricity_uranus,6579438,0,0,2,2,0
1_7367121,harmony_lubricity_uranus,7367121,1,2,14,16,0
0_324388,noop_craves_loneliness_potato,324388,0,0,2,2,0
0_520538,noop_pain_laceration-8,520538,0,0,1,1,0
1_3474113,pain_laceration-8,3474113,1,1,4,5,0
0_1894188,noop_harmony_excitement_uranus,1894188,0,0,3,3,0
0_3663839,noop_pain_angina,3663839,0,0,1,1,0
1_1486223,pain_angina,1486223,1,1,9,10,0
0_5044939,noop_pain_loneliness-3,5044939,0,0,1,1,0
1_7998514,pain_loneliness-3,7998514,1,1,8,9,0
0_5011789,noop_pleasure_rest,5011789,0,0,1,1,0
1_6196362,pleasure_rest,6196362,1,1,71,72,0
0_5342989,noop_eats_wonderbread_ham,5342989,0,0,1,1,0
1_197009,eats_wonderbread_ham,197009,1,1,7,8,0
0_6272389,noop_locale_ham_guanabara,6272389,0,0,4,4,0
0_1903589,noop_food_ham,1903589,0,0,1,1,0
1_6188452,food_ham,6188452,1,1,48,49,0
0_3873689,noop_eats_turkey_shrimp,3873689,0,0,1,1,0
1_7897051,eats_turkey_shrimp,7897051,1,1,3,4,0
0_5083040,noop_craves_angina_onion,5083040,0,0,1,1,0
1_2937679,craves_angina_onion,2937679,1,1,7,8,0
0_537240,feast_love_rice_papaya_bosnia_alsace,537240,0,0,9,9,0
1_2426690,craves_love_papaya,2426690,1,1,18,19,0
0_3292190,overcome_dread_excitement_papaya_earth_uranus,3292190,0,0,8,8,0
1_4020164,fears_dread_excitement,4020164,1,1,6,7,0
1_2996931,craves_dread_papaya,2996931,1,1,8,9,0
0_2484442,noop_pain_laceration,2484442,0,0,1,1,0
1_1180739,pain_laceration,1180739,1,1,13,14,0
0_5142292,noop_craves_dread_papaya,5142292,0,0,2,2,0
0_6885942,feast_excitement_papaya_wurst_bosnia_alsace,6885942,0,0,9,9,0
1_92031,craves_excitement_wurst,92031,1,1,10,11,0
0_5077393,noop_pleasure_excitement,5077393,0,0,1,1,0
1_2932032,pleasure_excitement,2932032,1,1,58,59,0
0_6896743,noop_craves_lubricity_shrimp,6896743,0,0,4,4,0
0_6772543,noop_pain_anxiety,6772543,0,0,1,1,0
1_1370260,pain_anxiety,1370260,1,1,10,11,0
0_3474193,feast_lubricity_shrimp_turkey_bosnia_alsace,3474193,0,0,9,9,0
1_557511,craves_lubricity_turkey,557511,1,1,10,11,0
0_964644,noop_pain_grief,964644,0,0,1,1,0
1_3456443,pain_grief,3456443,1,1,10,11,0
0_6935494,noop_pain_loneliness,6935494,0,0,1,1,0
1_5631791,pain_loneliness,5631791,1,1,12,13,0
0_6105244,noop_attacks_guanabara_bosnia,6105244,0,0,1,1,0
1_6892927,attacks_guanabara_bosnia,6892927,1,1,96,97,0
0_2967144,noop_eats_ham_onion,2967144,0,0,1,1,0
1_2180706,eats_ham_onion,2180706,1,1,7,8,0
0_7796944,overcome_boils_lubricity_shrimp_earth_uranus,7796944,0,0,9,9,0
1_4944137,harmony_lubricity_earth,4944137,1,1,16,17,0
1_5022204,fears_boils_lubricity,5022204,1,1,5,6,0
0_899045,noop_craves_hangover_papaya,899045,0,0,2,2,0
0_1065095,noop_eats_shrimp_onion,1065095,0,0,1,1,0
1_4018670,eats_shrimp_onion,4018670,1,1,12,13,0
0_6433446,noop_craves_love_rice,6433446,0,0,4,4,0
0_4470546,noop_locale_wurst_goias,4470546,0,0,1,1,0
1_492931,locale_wurst_goias,492931,1,1,1,2,0
0_7587947,noop_craves_rest_ham,7587947,0,0,4,4,0
0_6628497,noop_pain_abrasion,6628497,0,0,1,1,0
1_7813070,pain_abrasion,7813070,1,1,6,7,0
0_7874447,feast_satisfaction_potato_arugula_guanabara_bosnia,7874447,0,0,9,9,0
1_1217321,craves_satisfaction_arugula,1217321,1,1,14,15,0
0_5553848,noop_eats_papaya_wurst,5553848,0,0,1,1,0
1_506446,eats_papaya_wurst,506446,1,1,9,10,0
0_2815448,noop_craves_abrasion_yogurt,2815448,0,0,1,1,0
1_5051695,craves_abrasion_yogurt,5051695,1,1,5,6,0
0_2491698,noop_eats_arugula_potato,2491698,0,0,1,1,0
1_346337,eats_arugula_potato,346337,1,1,12,13,0
0_3216798,noop_eats_rice_papaya,3216798,0,0,1,1,0
1_5509864,eats_rice_papaya,5509864,1,1,13,14,0
0_4356899,noop_eats_onion_marzipan,4356899,0,0,1,1,0
1_2211538,eats_onion_marzipan,2211538,1,1,11,12,0
0_461749,noop_pain_depression,461749,0,0,1,1,0
1_7159023,pain_depression,7159023,1,1,10,11,0
0_6296349,noop_planet_uranus,6296349,0,0,1,1,0
1_7480922,planet_uranus,7480922,1,1,40,41,0
0_3876999,feast_rest_ham_mutton_bavaria_guanabara,3876999,0,0,10,10,0
1_1403882,craves_rest_mutton,1403882,1,1,12,13,0
2_2326938,noop_craves_love_cherry,2326938,2,37,101,138,0
2_5600709,feast_love_cherry_marzipan_guanabara_bosnia,5600709,2,60,138,198,0
2_959535,feast_love_cherry_marzipan_bosnia_alsace,959535,2,75,230,305,0
2_4263853,feast_love_cherry_endive_guanabara_bosnia,4263853,2,60,138,198,0
2_1547814,feast_love_cherry_endive_bosnia_alsace,1547814,2,75,230,305,0
2_3667281,feast_love_cherry_rice_guanabara_bosnia,3667281,2,60,138,198,0
2_4786443,feast_love_cherry_rice_bosnia_alsace,4786443,2,75,230,305,0
2_4950594,overcome_laceration_love_cherry_earth_uranus,4950594,2,52,123,175,0
2_4864290,harmony_love_earth,4864290,2,13,73,86,0
2_2426690,craves_love_papaya,2426690,2,11,35,46,0
2_725535,craves_love_rice,725535,2,12,50,62,0
2_4484680,fears_jealousy_love,4484680,2,8,30,38,0
2_4058429,craves_love_marzipan,4058429,2,14,47,61,0
2_541159,locale_rice_alsace,541159,2,13,37,50,0
2_6427428,noop_pain_boils,6427428,2,1,1,2,0
2_6865444,succumb_boils_lubricity_shrimp_earth_uranus,6865444,2,36,104,140,0
2_4805169,overcome_boils_satisfaction_shrimp_mercury_saturn,4805169,2,46,105,151,0
2_7796944,overcome_boils_lubricity_shrimp_earth_uranus,7796944,2,38,96,134,0
2_145726,noop_pain_abrasion-4,145726,2,1,1,2,0
2_5831263,succumb_abrasion-4_rest_ham_mercury_saturn,5831263,2,33,95,128,0
2_6459978,overcome_abrasion-4_rest_ham_mercury_saturn,6459978,2,35,90,125,0
2_1499025,noop_pain_depression-7,1499025,2,1,1,2,0
2_2072975,noop_craves_intoxication_arugula,2072975,2,20,64,84,0
2_2554286,succumb_boils-1_intoxication_arugula_earth_uranus,2554286,2,32,83,115,0
2_3592004,feast_intoxication_arugula_wonderbread_alsace_surrey,3592004,2,31,89,120,0
2_7519785,feast_intoxication_arugula_potato_alsace_surrey,7519785,2,31,89,120,0
2_7805069,overcome_boils-1_intoxication_arugula_earth_uranus,7805069,2,34,78,112,0
2_857899,craves_intoxication_potato,857899,2,12,29,41,0
2_2799049,craves_intoxication_wonderbread,2799049,2,9,36,45,0
2_3242223,locale_arugula_alsace,3242223,2,10,11,21,0
2_2182175,noop_harmony_intoxication_uranus,2182175,2,8,24,32,0
2_1345384,overcome_jealousy-2_intoxication_wonderbread_earth_uranus,1345384,2,34,84,118,0
2_1304243,overcome_sciatica_intoxication_wonderbread_earth_uranus,1304243,2,34,84,118,0
2_7676246,overcome_loneliness_intoxication_potato_earth_uranus,7676246,2,38,90,128,0
2_4775936,harmony_intoxication_earth,4775936,2,10,41,51,0
2_4731683,fears_boils-1_intoxication,4731683,2,7,19,26,0
2_4913604,noop_province_surrey,4913604,2,1,1,2,0
2_3904904,noop_locale_yogurt_bosnia,3904904,2,3,16,19,0
2_5254895,feast_satisfaction_yogurt_wonderbread_guanabara_bosnia,5254895,2,40,99,139,0
2_2996889,feast_satisfaction_yogurt_potato_guanabara_bosnia,2996889,2,40,99,139,0
2_5861162,noop_orbits_saturn_earth,5861162,2,1,1,2,0
2_6901344,succumb_grief_achievement_endive_saturn_earth,6901344,2,33,76,109,0
2_6215773,succumb_depression_achievement_endive_saturn_earth,6215773,2,33,76,109,0
2_6252085,overcome_depression_achievement_endive_saturn_earth,6252085,2,35,74,109,0
2_6922960,overcome_hangover_excitement_papaya_saturn_earth,6922960,2,34,76,110,0
2_279197,overcome_prostatitis_achievement_wurst_saturn_earth,279197,2,39,85,124,0
2_6642490,overcome_dread_excitement_papaya_saturn_earth,6642490,2,34,76,110,0
2_4671043,overcome_laceration_achievement_cherry_saturn_earth,4671043,2,39,86,125,0
2_6230834,overcome_grief_achievement_endive_saturn_earth,6230834,2,35,74,109,0
2_5636604,noop_eats_mutton_ham,5636604,2,1,1,2,0
2_922840,feast_rest_mutton_ham_bavaria_guanabara,922840,2,33,101,134,0
2_2510862,noop_orbits_earth_uranus,2510862,2,1,1,2,0
2_1776967,succumb_prostatitis_entertainment_wurst_earth_uranus,1776967,2,14,19,33,0
2_4857500,succumb_dread_excitement_papaya_earth_uranus,4857500,2,33,79,112,0
2_1784700,succumb_jealousy_love_rice_earth_uranus,1784700,2,47,120,167,0
2_4750336,succumb_hangover_excitement_papaya_earth_uranus,4750336,2,33,79,112,0
2_4157067,overcome_anxiety_love_marzipan_earth_uranus,4157067,2,48,119,167,0
2_4923450,overcome_angina_lubricity_onion_earth_uranus,4923450,2,38,108,146,0
2_7956354,overcome_hangover_love_papaya_earth_uranus,7956354,2,51,121,172,0
2_3572660,overcome_hangover_excitement_papaya_earth_uranus,3572660,2,35,77,112,0
2_1221816,overcome_anger_love_marzipan_earth_uranus,1221816,2,48,119,167,0
2_790639,overcome_prostatitis_excitement_wurst_earth_uranus,790639,2,39,87,126,0
2_5230030,overcome_prostatitis_entertainment_wurst_earth_uranus,5230030,2,16,19,35,0
2_4290586,overcome_dread_love_papaya_earth_uranus,4290586,2,51,121,172,0
2_3292190,overcome_dread_excitement_papaya_earth_uranus,3292190,2,35,77,112,0
2_4911427,overcome_jealousy_love_rice_earth_uranus,4911427,2,49,105,154,0
2_2807634,overcome_jealousy_excitement_rice_earth_uranus,2807634,2,39,88,127,0
2_160254,overcome_loneliness_lubricity_potato_earth_uranus,160254,2,42,112,154,0
2_3873689,noop_eats_turkey_shrimp,3873689,2,1,1,2,0
2_6490141,feast_lubricity_turkey_shrimp_goias_bavaria,6490141,2,35,102,137,0
2_4815813,noop_craves_satiety_rice,4815813,2,37,96,133,0
2_4011732,feast_satiety_rice_papaya_guanabara_bosnia,4011732,2,60,132,192,0
2_4373908,feast_satiety_rice_papaya_bosnia_alsace,4373908,2,75,229,304,0
2_5857448,feast_satiety_rice_marzipan_guanabara_bosnia,5857448,2,60,132,192,0
2_592492,feast_satiety_rice_marzipan_bosnia_alsace,592492,2,75,229,304,0
2_729890,feast_satiety_rice_cherry_guanabara_bosnia,729890,2,60,132,192,0
2_2111311,feast_satiety_rice_cherry_bosnia_alsace,2111311,2,75,229,304,0
2_5533913,overcome_jealousy_satiety_rice_mercury_saturn,5533913,2,52,118,170,0
2_116045,harmony_satiety_mercury,116045,2,13,45,58,0
2_3595641,craves_satiety_marzipan,3595641,2,14,37,51,0
2_1272578,locale_cherry_alsace,1272578,2,13,38,51,0
2_4866225,craves_satiety_cherry,4866225,2,12,36,48,0
2_2484468,fears_laceration_satiety,2484468,2,8,25,33,0
2_4891966,craves_satiety_endive,4891966,2,11,28,39,0
2_1992768,noop_craves_satisfaction_yogurt,1992768,2,32,86,118,0
2_7610369,overcome_abrasion_satisfaction_yogurt_mercury_saturn,7610369,2,42,99,141,0
2_7486548,locale_potato_bosnia,7486548,2,13,29,42,0
2_5753084,craves_satisfaction_potato,5753084,2,12,26,38,0
2_1217321,craves_satisfaction_arugula,1217321,2,11,25,36,0
2_3724020,craves_satisfaction_shrimp,3724020,2,13,29,42,0
2_1918314,harmony_satisfaction_mercury,1918314,2,11,28,39,0
2_6982256,fears_loneliness_satisfaction,6982256,2,8,19,27,0
2_1903589,noop_food_ham,1903589,2,1,1,2,0
2_7507245,succumb_loneliness-3_rest_ham_mercury_saturn,7507245,2,33,95,128,0
2_5995026,feast_rest_onion_ham_bosnia_alsace,5995026,2,36,140,176,0
2_4680578,feast_lubricity_onion_ham_bosnia_alsace,4680578,2,38,132,170,0
2_2926233,feast_rest_wonderbread_ham_bosnia_alsace,2926233,2,36,114,150,0
2_3561603,feast_rest_ham_onion_bavaria_guanabara,3561603,2,30,103,133,0
2_3876999,feast_rest_ham_mutton_bavaria_guanabara,3876999,2,30,103,133,0
2_1961477,feast_rest_ham_wonderbread_bavaria_guanabara,1961477,2,30,103,133,0
2_7026343,feast_intoxication_wonderbread_ham_bosnia_alsace,7026343,2,34,101,135,0
2_5941935,overcome_loneliness-3_rest_ham_mercury_saturn,5941935,2,35,90,125,0
2_496858,noop_pain_boils-1,496858,2,1,1,2,0
2_4076027,overcome_boils-1_satisfaction_arugula_mercury_saturn,4076027,2,46,104,150,0
2_5887254,noop_eats_marzipan_haroset,5887254,2,1,1,2,0
2_4476418,feast_love_marzipan_haroset_alsace_surrey,4476418,2,50,177,227,0
2_6047420,feast_satiety_marzipan_haroset_alsace_surrey,6047420,2,50,171,221,0
2_6462913,noop_eats_marzipan_onion,6462913,2,1,1,2,0
2_6203209,feast_love_marzipan_onion_alsace_surrey,6203209,2,50,177,227,0
2_1902659,feast_satiety_marzipan_onion_alsace_surrey,1902659,2,50,171,221,0
2_5915405,noop_craves_rest_onion,5915405,2,25,88,113,0
2_513134,feast_rest_onion_marzipan_bosnia_alsace,513134,2,36,140,176,0
2_7149765,feast_rest_onion_shrimp_bosnia_alsace,7149765,2,36,140,176,0
2_4026357,overcome_angina_rest_onion_mercury_saturn,4026357,2,36,107,143,0
2_6284244,craves_rest_ham,6284244,2,10,24,34,0
2_1149340,craves_rest_wonderbread,1149340,2,11,29,40,0
2_1403882,craves_rest_mutton,1403882,2,10,21,31,0
2_164979,fears_abrasion-4_rest,164979,2,9,19,28,0
2_1105319,fears_loneliness-3_rest,1105319,2,9,19,28,0
2_1126409,locale_ham_guanabara,1126409,2,7,30,37,0
2_2914055,harmony_rest_mercury,2914055,2,12,40,52,0
2_1016330,noop_pleasure_love,1016330,2,1,1,2,0
2_1897884,feast_love_marzipan_mutton_alsace_surrey,1897884,2,50,177,227,0
2_7626089,feast_love_marzipan_rice_alsace_surrey,7626089,2,50,177,227,0
2_7426818,feast_love_marzipan_cherry_alsace_surrey,7426818,2,50,177,227,0
2_537240,feast_love_rice_papaya_bosnia_alsace,537240,2,49,160,209,0
2_7422623,feast_love_rice_marzipan_bosnia_alsace,7422623,2,49,160,209,0
2_6275620,feast_love_rice_cherry_bosnia_alsace,6275620,2,49,160,209,0
2_1320041,feast_love_papaya_rice_bosnia_alsace,1320041,2,55,161,216,0
2_2074717,feast_love_papaya_rice_guanabara_bosnia,2074717,2,58,117,175,0
2_7099199,feast_love_papaya_wurst_bosnia_alsace,7099199,2,55,161,216,0
2_566584,feast_love_papaya_wurst_guanabara_bosnia,566584,2,58,117,175,0
2_6280431,noop_craves_achievement_cherry,6280431,2,24,62,86,0
2_1522839,feast_achievement_cherry_marzipan_guanabara_bosnia,1522839,2,47,100,147,0
2_3013961,feast_achievement_cherry_marzipan_bosnia_alsace,3013961,2,63,179,242,0
2_2132427,feast_achievement_cherry_endive_guanabara_bosnia,2132427,2,47,100,147,0
2_673471,feast_achievement_cherry_endive_bosnia_alsace,673471,2,63,179,242,0
2_3862829,feast_achievement_cherry_rice_guanabara_bosnia,3862829,2,47,100,147,0
2_1277090,feast_achievement_cherry_rice_bosnia_alsace,1277090,2,63,179,242,0
2_7928595,craves_achievement_endive,7928595,2,7,29,36,0
2_863045,locale_endive_alsace,863045,2,7,18,25,0
2_1976428,fears_depression_achievement,1976428,2,9,22,31,0
2_2984277,harmony_achievement_saturn,2984277,2,12,39,51,0
2_3723475,fears_grief_achievement,3723475,2,9,21,30,0
2_7911623,craves_achievement_wurst,7911623,2,7,24,31,0
2_2231879,noop_fears_boils_lubricity,2231879,2,26,72,98,0
2_5334695,craves_lubricity_potato,5334695,2,13,32,45,0
2_2335886,craves_lubricity_onion,2335886,2,10,35,45,0
2_1682327,craves_boils_shrimp,1682327,2,5,12,17,0
2_7367121,harmony_lubricity_uranus,7367121,2,6,42,48,0
2_557511,craves_lubricity_turkey,557511,2,9,17,26,0
2_7315407,locale_shrimp_bosnia,7315407,2,13,21,34,0
2_2227981,noop_food_marzipan,2227981,2,1,1,2,0
2_4153561,feast_satiety_cherry_marzipan_bosnia_alsace,4153561,2,49,154,203,0
2_7278434,feast_rest_mutton_marzipan_bavaria_guanabara,7278434,2,33,101,134,0
2_2311836,feast_lubricity_onion_marzipan_bosnia_alsace,2311836,2,38,132,170,0
2_159897,feast_excitement_rice_marzipan_guanabara_bosnia,159897,2,47,102,149,0
2_834693,feast_excitement_rice_marzipan_bosnia_alsace,834693,2,63,186,249,0
2_5091910,feast_satiety_marzipan_mutton_alsace_surrey,5091910,2,50,171,221,0
2_795958,feast_satiety_marzipan_rice_alsace_surrey,795958,2,50,171,221,0
2_2619867,feast_satiety_marzipan_cherry_alsace_surrey,2619867,2,50,171,221,0
2_6457823,overcome_anxiety_satiety_marzipan_mercury_saturn,6457823,2,48,114,162,0
2_579734,overcome_anger_satiety_marzipan_mercury_saturn,579734,2,48,114,162,0
2_5424666,noop_eats_yogurt_wonderbread,5424666,2,1,1,2,0
2_59058,noop_harmony_rest_mercury,59058,2,21,61,82,0
2_7730434,harmony_rest_saturn,7730434,2,10,44,54,0
2_3967861,locale_ham_bavaria,3967861,2,8,20,28,0
2_868003,craves_rest_onion,868003,2,11,28,39,0
2_7577871,noop_fears_prostatitis_entertainment,7577871,2,7,15,22,0
2_3477531,harmony_entertainment_uranus,3477531,2,4,8,12,0
2_4565062,craves_prostatitis_wurst,4565062,2,6,12,18,0
2_3651421,noop_food_papaya,3651421,2,1,1,2,0
2_2007372,feast_excitement_rice_papaya_guanabara_bosnia,2007372,2,47,102,149,0
2_6318363,feast_excitement_rice_papaya_bosnia_alsace,6318363,2,63,186,249,0
2_7101164,feast_excitement_papaya_rice_bosnia_alsace,7101164,2,31,82,113,0
2_6885942,feast_excitement_papaya_wurst_bosnia_alsace,6885942,2,31,82,113,0
2_7971067,noop_locale_mutton_guanabara,7971067,2,3,12,15,0
2_7106972,noop_eats_arugula_wonderbread,7106972,2,1,1,2,0
2_478796,feast_satisfaction_arugula_wonderbread_bosnia_alsace,478796,2,48,106,154,0
2_3433918,feast_satisfaction_arugula_wonderbread_alsace_surrey,3433918,2,54,155,209,0
2_7565557,noop_craves_depression-7_haroset,7565557,2,1,4,5,0
2_7774906,noop_fears_loneliness_satisfaction,7774906,2,32,79,111,0
2_5511802,succumb_loneliness_satisfaction_potato_mercury_saturn,5511802,2,42,104,146,0
2_1091294,locale_potato_guanabara,1091294,2,19,15,34,0
2_1112071,craves_loneliness_potato,1112071,2,6,12,18,0
2_131867,harmony_satisfaction_saturn,131867,2,7,33,40,0
2_1282252,craves_satisfaction_yogurt,1282252,2,9,21,30,0
2_7600772,noop_food_endive,7600772,2,1,1,2,0
2_2778412,feast_satiety_endive_cherry_guanabara_bosnia,2778412,2,58,111,169,0
2_313983,feast_satiety_endive_cherry_bosnia_alsace,313983,2,55,155,210,0
2_541684,feast_satiety_endive_wurst_guanabara_bosnia,541684,2,58,111,169,0
2_2845996,feast_satiety_endive_wurst_bosnia_alsace,2845996,2,55,155,210,0
2_2718660,feast_satiety_cherry_endive_bosnia_alsace,2718660,2,49,154,203,0
2_6269771,feast_achievement_endive_cherry_bosnia_alsace,6269771,2,31,80,111,0
2_2494215,feast_achievement_endive_wurst_bosnia_alsace,2494215,2,31,80,111,0
2_4138778,overcome_depression_achievement_endive_mercury_saturn,4138778,2,34,73,107,0
2_5075933,overcome_depression_satiety_endive_mercury_saturn,5075933,2,51,114,165,0
2_3603240,overcome_grief_achievement_endive_mercury_saturn,3603240,2,34,73,107,0
2_5468925,overcome_grief_satiety_endive_mercury_saturn,5468925,2,51,114,165,0
2_2967144,noop_eats_ham_onion,2967144,2,1,1,2,0
2_1525959,noop_eats_marzipan_mutton,1525959,2,1,1,2,0
2_4460410,noop_locale_shrimp_bosnia,4460410,2,16,36,52,0
2_4191681,feast_satisfaction_shrimp_onion_guanabara_bosnia,4191681,2,49,112,161,0
2_4026843,feast_satisfaction_shrimp_turkey_guanabara_bosnia,4026843,2,49,112,161,0
2_3527197,feast_satisfaction_shrimp_potato_guanabara_bosnia,3527197,2,49,112,161,0
2_4944137,harmony_lubricity_earth,4944137,2,10,52,62,0
2_3305631,craves_lubricity_shrimp,3305631,2,11,35,46,0
2_1766507,locale_shrimp_alsace,1766507,2,10,32,42,0
2_5022204,fears_boils_lubricity,5022204,2,8,23,31,0
2_6912487,noop_locale_shrimp_alsace,6912487,2,27,120,147,0
2_179748,feast_satisfaction_shrimp_onion_bosnia_alsace,179748,2,57,178,235,0
2_5467628,feast_satisfaction_shrimp_turkey_bosnia_alsace,5467628,2,57,178,235,0
2_2218863,feast_satisfaction_shrimp_potato_bosnia_alsace,2218863,2,57,178,235,0
2_7516608,feast_lubricity_shrimp_onion_bosnia_alsace,7516608,2,36,127,163,0
2_3474193,feast_lubricity_shrimp_turkey_bosnia_alsace,3474193,2,36,127,163,0
2_225428,feast_lubricity_shrimp_potato_bosnia_alsace,225428,2,36,127,163,0
2_5024368,noop_craves_grief_endive,5024368,2,6,12,18,0
2_7344507,noop_craves_jealousy-2_wonderbread,7344507,2,3,9,12,0
2_4810659,overcome_jealousy-2_rest_wonderbread_mercury_saturn,4810659,2,36,105,141,0
2_2066697,noop_locale_rice_bosnia,2066697,2,22,39,61,0
2_6726507,feast_excitement_rice_cherry_guanabara_bosnia,6726507,2,47,102,149,0
2_3833315,noop_food_arugula,3833315,2,1,1,2,0
2_2041368,feast_satisfaction_arugula_potato_bosnia_alsace,2041368,2,48,106,154,0
2_4996490,feast_satisfaction_arugula_potato_alsace_surrey,4996490,2,54,155,209,0
2_7874447,feast_satisfaction_potato_arugula_guanabara_bosnia,7874447,2,44,125,169,0
2_7975341,feast_rest_wonderbread_arugula_bosnia_alsace,7975341,2,36,114,150,0
2_3048343,feast_lubricity_potato_arugula_bavaria_guanabara,3048343,2,50,119,169,0
2_6763301,feast_lubricity_potato_arugula_guanabara_bosnia,6763301,2,60,185,245,0
2_5077970,feast_intoxication_wonderbread_arugula_bosnia_alsace,5077970,2,34,101,135,0
2_2280008,feast_intoxication_potato_arugula_bavaria_guanabara,2280008,2,46,97,143,0
2_7729168,feast_intoxication_potato_arugula_guanabara_bosnia,7729168,2,57,167,224,0
2_1066285,noop_pain_jealousy-2,1066285,2,1,1,2,0
2_3800886,noop_pain_sciatica,3800886,2,1,1,2,0
2_7825528,overcome_sciatica_rest_wonderbread_mercury_saturn,7825528,2,36,105,141,0
2_5342989,noop_eats_wonderbread_ham,5342989,2,1,1,2,0
2_6272389,noop_locale_ham_guanabara,6272389,2,19,95,114,0
2_4518774,noop_locale_rice_alsace,4518774,2,40,153,193,0
2_4055766,feast_excitement_rice_cherry_bosnia_alsace,4055766,2,63,186,249,0
2_6090059,locale_rice_bosnia,6090059,2,19,21,40,0
2_6350300,craves_love_cherry,6350300,2,14,31,45,0
2_6772543,noop_pain_anxiety,6772543,2,1,1,2,0
2_4847635,noop_eats_wurst_papaya,4847635,2,1,1,2,0
2_4148623,noop_craves_lubricity_turkey,4148623,2,28,95,123,0
2_7214256,feast_lubricity_turkey_haroset_goias_bavaria,7214256,2,35,102,137,0
2_7945476,noop_locale_ham_bavaria,7945476,2,13,20,33,0
2_1894188,noop_harmony_excitement_uranus,1894188,2,12,30,42,0
2_3206743,fears_hangover_excitement,3206743,2,9,17,26,0
2_2366283,harmony_excitement_earth,2366283,2,12,39,51,0
2_4020164,fears_dread_excitement,4020164,2,9,17,26,0
2_6922128,noop_food_shrimp,6922128,2,1,1,2,0
2_7248052,feast_satisfaction_potato_shrimp_guanabara_bosnia,7248052,2,44,125,169,0
2_1999017,feast_lubricity_onion_shrimp_bosnia_alsace,1999017,2,38,132,170,0
2_6018798,feast_lubricity_potato_shrimp_bavaria_guanabara,6018798,2,50,119,169,0
2_1555517,feast_lubricity_potato_shrimp_guanabara_bosnia,1555517,2,60,185,245,0
2_6984665,feast_intoxication_potato_shrimp_bavaria_guanabara,6984665,2,46,97,143,0
2_1715559,feast_intoxication_potato_shrimp_guanabara_bosnia,1715559,2,57,167,224,0
2_5011789,noop_pleasure_rest,5011789,2,1,1,2,0
2_1244925,feast_rest_wonderbread_yogurt_bosnia_alsace,1244925,2,36,114,150,0
2_3777379,noop_craves_prostatitis_wurst,3777379,2,7,15,22,0
2_3616283,harmony_entertainment_earth,3616283,2,4,10,14,0
2_2810155,fears_prostatitis_entertainment,2810155,2,4,4,8,0
2_520538,noop_pain_laceration-8,520538,2,1,1,2,0
2_1668680,noop_locale_haroset_guanabara,1668680,2,1,7,8,0
2_1783917,noop_fears_dread_excitement,1783917,2,23,51,74,0
2_5025041,locale_papaya_bosnia,5025041,2,11,11,22,0
2_2490887,craves_excitement_rice,2490887,2,13,34,47,0
2_2996931,craves_dread_papaya,2996931,2,5,11,16,0
2_92031,craves_excitement_wurst,92031,2,7,25,32,0
2_3516611,harmony_excitement_uranus,3516611,2,9,38,47,0
2_608750,noop_harmony_satisfaction_mercury,608750,2,32,57,89,0
2_5044939,noop_pain_loneliness-3,5044939,2,1,1,2,0
2_564420,noop_planet_earth,564420,2,1,1,2,0
2_3216798,noop_eats_rice_papaya,3216798,2,1,1,2,0
2_223167,noop_locale_marzipan_surrey,223167,2,11,98,109,0
2_7575031,noop_food_cherry,7575031,2,1,1,2,0
2_3338867,succumb_laceration_satiety_cherry_mercury_saturn,3338867,2,47,115,162,0
2_622134,feast_satiety_cherry_rice_bosnia_alsace,622134,2,49,154,203,0
2_5890937,overcome_laceration_satiety_cherry_mercury_saturn,5890937,2,49,100,149,0
2_2295368,noop_harmony_satiety_saturn,2295368,2,10,29,39,0
2_5136068,noop_eats_mutton_marzipan,5136068,2,1,1,2,0
2_2101641,noop_craves_satiety_endive,2101641,2,36,93,129,0
2_2670452,craves_satiety_rice,2670452,2,14,34,48,0
2_2718519,noop_eats_ham_mutton,2718519,2,1,1,2,0
2_6877418,noop_craves_laceration-8_haroset,6877418,2,1,4,5,0
2_427769,noop_craves_jealousy_rice,427769,2,7,16,23,0
2_6153519,noop_craves_anger_marzipan,6153519,2,3,12,15,0
2_6002469,noop_harmony_satisfaction_saturn,6002469,2,8,20,28,0
2_1387483,overcome_loneliness_satisfaction_potato_mercury_saturn,1387483,2,44,73,117,0
2_1696785,noop_fears_laceration_satiety,1696785,2,37,79,116,0
2_3324635,craves_laceration_cherry,3324635,2,6,14,20,0
2_6821478,locale_cherry_bosnia,6821478,2,19,21,40,0
2_4531615,harmony_satiety_saturn,4531615,2,9,44,53,0
2_7547979,noop_food_wonderbread,7547979,2,1,1,2,0
2_577277,feast_intoxication_wonderbread_yogurt_bosnia_alsace,577277,2,34,101,135,0
2_4622121,noop_locale_papaya_alsace,4622121,2,18,68,86,0
2_6194333,noop_eats_potato_shrimp,6194333,2,1,1,2,0
2_5772633,noop_eats_endive_cherry,5772633,2,1,1,2,0
2_4696431,noop_fears_loneliness-3_rest,4696431,2,23,68,91,0
2_4737077,craves_loneliness-3_ham,4737077,2,3,10,13,0
2_1584472,noop_eats_ham_wonderbread,1584472,2,1,1,2,0
2_2913854,noop_craves_anxiety_marzipan,2913854,2,3,12,15,0
2_4434536,noop_craves_satisfaction_shrimp,4434536,2,32,86,118,0
2_6628497,noop_pain_abrasion,6628497,2,1,1,2,0
2_1065095,noop_eats_shrimp_onion,1065095,2,1,1,2,0
2_7087923,noop_craves_satisfaction_arugula,7087923,2,32,86,118,0
2_6579438,noop_harmony_lubricity_uranus,6579438,2,7,25,32,0
2_324388,noop_craves_loneliness_potato,324388,2,7,15,22,0
2_6296349,noop_planet_uranus,6296349,2,1,1,2,0
2_451898,noop_locale_arugula_alsace,451898,2,13,25,38,0
2_6161127,locale_arugula_surrey,6161127,2,7,18,25,0
2_4203350,craves_intoxication_arugula,4203350,2,8,26,34,0
2_7123940,noop_craves_achievement_wurst,7123940,2,24,62,86,0
2_7902854,craves_achievement_cherry,7902854,2,13,27,40,0
2_461749,noop_pain_depression,461749,2,1,1,2,0
2_3663839,noop_pain_angina,3663839,2,1,1,2,0
2_1640807,noop_province_bavaria,1640807,2,1,1,2,0
2_1938062,noop_province_guanabara,1938062,2,1,1,2,0
2_7314587,noop_fears_grief_achievement,7314587,2,23,49,72,0
2_3962347,harmony_achievement_earth,3962347,2,9,48,57,0
2_6411945,locale_endive_bosnia,6411945,2,11,11,22,0
2_2879007,craves_grief_endive,2879007,2,5,8,13,0
2_7594879,noop_pain_hangover,7594879,2,1,1,2,0
2_433650,noop_eats_haroset_marzipan,433650,2,1,1,2,0
2_2075900,noop_craves_satiety_cherry,2075900,2,34,83,117,0
2_950215,noop_food_potato,950215,2,1,1,2,0
2_5584884,feast_satisfaction_potato_yogurt_guanabara_bosnia,5584884,2,44,125,169,0
2_4299571,feast_lubricity_potato_yogurt_bavaria_guanabara,4299571,2,50,119,169,0
2_7893326,feast_lubricity_potato_yogurt_guanabara_bosnia,7893326,2,60,185,245,0
2_5265438,feast_intoxication_potato_yogurt_bavaria_guanabara,5265438,2,46,97,143,0
2_52391,feast_intoxication_potato_yogurt_guanabara_bosnia,52391,2,57,167,224,0
2_7076654,noop_pain_anger,7076654,2,1,1,2,0
2_3231060,noop_eats_papaya_rice,3231060,2,1,1,2,0
2_3694793,noop_harmony_achievement_saturn,3694793,2,21,45,66,0
2_2878478,noop_food_wurst,2878478,2,1,1,2,0
2_3370802,noop_locale_arugula_surrey,3370802,2,22,82,104,0
2_3752565,noop_eats_potato_yogurt,3752565,2,1,1,2,0
2_2016804,noop_locale_wonderbread_alsace,2016804,2,7,43,50,0
2_327212,noop_craves_loneliness-3_ham,327212,2,4,9,13,0
2_6105244,noop_attacks_guanabara_bosnia,6105244,2,1,1,2,0
2_3827688,noop_craves_boils_shrimp,3827688,2,6,13,19,0
2_6948529,noop_attacks_bosnia_alsace,6948529,2,1,1,2,0
2_3966481,noop_locale_cherry_bosnia,3966481,2,22,39,61,0
2_666864,noop_fears_depression_achievement,666864,2,23,49,72,0
2_6318237,craves_depression_endive,6318237,2,5,9,14,0
2_2928166,noop_eats_marzipan_rice,2928166,2,1,1,2,0
2_6418558,noop_locale_cherry_alsace,6418558,2,40,148,188,0
2_1203432,noop_craves_love_marzipan,1203432,2,36,97,133,0
2_5375631,noop_fears_abrasion-4_rest,5375631,2,23,68,91,0
2_4462730,craves_abrasion-4_ham,4462730,2,3,10,13,0
2_3737404,noop_orbits_mercury_saturn,3737404,2,1,1,2,0
2_4348482,noop_eats_marzipan_cherry,4348482,2,1,1,2,0
2_5083040,noop_craves_angina_onion,5083040,2,3,11,14,0
2_6630041,noop_fears_jealousy_love,6630041,2,37,79,116,0
2_2928243,harmony_love_uranus,2928243,2,9,44,53,0
2_3282766,craves_jealousy_rice,3282766,2,6,15,21,0
2_1672405,noop_craves_abrasion-4_ham,1672405,2,4,9,13,0
2_3683143,noop_craves_excitement_wurst,3683143,2,24,64,88,0
2_2407942,craves_excitement_papaya,2407942,2,7,32,39,0
2_7477118,locale_papaya_alsace,7477118,2,7,17,24,0
2_3418815,noop_pain_prostatitis,3418815,2,1,1,2,0
2_5221458,noop_planet_saturn,5221458,2,1,1,2,0
2_6896743,noop_craves_lubricity_shrimp,6896743,2,24,82,106,0
2_5142292,noop_craves_dread_papaya,5142292,2,6,14,20,0
2_2167967,noop_harmony_entertainment_uranus,2167967,2,5,5,10,0
2_2573934,noop_eats_cherry_marzipan,2573934,2,1,1,2,0
2_4470546,noop_locale_wurst_goias,4470546,2,1,1,2,0
2_5381497,noop_craves_rest_mutton,5381497,2,26,91,117,0
2_5077393,noop_pleasure_excitement,5077393,2,1,1,2,0
2_5747312,noop_pleasure_achievement,5747312,2,1,1,2,0
2_5373533,noop_pain_dread,5373533,2,1,1,2,0
2_2749009,noop_pain_jealousy,2749009,2,1,1,2,0
2_1540266,noop_eats_potato_arugula,1540266,2,1,1,2,0
2_5442199,noop_fears_boils-1_intoxication,5442199,2,23,55,78,0
2_5173398,craves_boils-1_arugula,5173398,2,5,10,15,0
2_4312550,harmony_intoxication_uranus,4312550,2,7,25,32,0
2_1485908,noop_harmony_entertainment_earth,1485908,2,7,15,22,0
2_1578600,noop_harmony_excitement_earth,1578600,2,21,47,68,0
2_6976685,noop_pleasure_intoxication,6976685,2,1,1,2,0
2_2616621,noop_province_goias,2616621,2,1,1,2,0
2_5808271,noop_eats_onion_ham,5808271,2,1,1,2,0
2_630322,noop_craves_entertainment_wurst,630322,2,1,1,2,0
2_6235535,noop_locale_turkey_bavaria,6235535,2,3,11,14,0
2_7783167,noop_food_haroset,7783167,2,1,1,2,0
2_1874818,noop_harmony_rest_saturn,1874818,2,11,28,39,0
2_796009,noop_eats_wurst_endive,796009,2,1,1,2,0
2_6463600,noop_craves_satisfaction_potato,6463600,2,29,57,86,0
2_3275072,noop_eats_shrimp_turkey,3275072,2,1,1,2,0
2_7496750,noop_eats_yogurt_potato,7496750,2,1,1,2,0
2_2536952,noop_craves_laceration_cherry,2536952,2,7,16,23,0
2_6433446,noop_craves_love_rice,6433446,2,34,88,122,0
2_2253173,noop_eats_rice_marzipan,2253173,2,1,1,2,0
2_99639,noop_craves_lubricity_onion,99639,2,27,91,118,0
2_5486452,noop_harmony_intoxication_earth,5486452,2,23,42,65,0
2_1318637,noop_food_onion,1318637,2,1,1,2,0
2_7007816,noop_pleasure_entertainment,7007816,2,1,1,2,0
2_254640,noop_craves_excitement_rice,254640,2,24,64,88,0
2_534272,noop_harmony_lubricity_earth,534272,2,26,56,82,0
2_5530554,noop_craves_depression_endive,5530554,2,6,12,18,0
2_2491698,noop_eats_arugula_potato,2491698,2,1,1,2,0
2_7533636,noop_food_rice,7533636,2,1,1,2,0
2_3987172,noop_pleasure_satiety,3987172,2,1,1,2,0
2_4356899,noop_eats_onion_marzipan,4356899,2,1,1,2,0
2_2484442,noop_pain_laceration,2484442,2,1,1,2,0
2_6404305,noop_craves_love_papaya,6404305,2,36,97,133,0
2_4740452,noop_craves_rest_wonderbread,4740452,2,24,85,109,0
2_840928,noop_harmony_love_earth,840928,2,37,57,94,0
2_7186753,noop_craves_satiety_marzipan,7186753,2,36,93,129,0
2_2170044,noop_locale_papaya_bosnia,2170044,2,18,19,37,0
2_2074016,noop_pleasure_satisfaction,2074016,2,1,1,2,0
2_6935494,noop_pain_loneliness,6935494,2,1,1,2,0
2_1654616,noop_attacks_goias_bavaria,1654616,2,1,1,2,0
2_3477552,noop_eats_turkey_haroset,3477552,2,1,1,2,0
2_2606268,noop_attacks_bavaria_guanabara,2606268,2,1,1,2,0
2_51279,noop_eats_shrimp_potato,51279,2,1,1,2,0
2_4852816,noop_eats_onion_shrimp,4852816,2,1,1,2,0
2_4752508,noop_food_mutton,4752508,2,1,1,2,0
2_4174008,noop_food_turkey,4174008,2,1,1,2,0
2_1620259,noop_craves_excitement_papaya,1620259,2,16,54,70,0
2_6207907,noop_eats_cherry_endive,6207907,2,1,1,2,0
2_899045,noop_craves_hangover_papaya,899045,2,6,14,20,0
2_1584320,noop_fears_hangover_excitement,1584320,2,23,51,74,0
2_3135292,craves_hangover_papaya,3135292,2,5,11,16,0
2_964644,noop_pain_grief,964644,2,1,1,2,0
2_5073604,noop_harmony_love_uranus,5073604,2,10,35,45,0
2_4682406,noop_locale_potato_guanabara,4682406,2,22,30,52,0
2_4480360,noop_food_yogurt,4480360,2,1,1,2,0
2_7587947,noop_craves_rest_ham,7587947,2,19,77,96,0
2_924830,noop_craves_lubricity_potato,924830,2,27,91,118,0
2_3556948,noop_locale_endive_bosnia,3556948,2,18,19,37,0
2_3707157,noop_harmony_satiety_mercury,3707157,2,37,51,88,0
2_2815448,noop_craves_abrasion_yogurt,2815448,2,2,7,9,0
2_6009025,noop_locale_endive_alsace,6009025,2,18,68,86,0
2_6306172,noop_craves_achievement_endive,6306172,2,16,54,70,0
2_5553848,noop_eats_papaya_wurst,5553848,2,1,1,2,0
2_4398007,noop_eats_haroset_turkey,4398007,2,1,1,2,0
2_7543600,noop_province_bosnia,7543600,2,1,1,2,0
2_1994700,noop_province_alsace,1994700,2,1,1,2,0
2_3004232,noop_eats_wonderbread_yogurt,3004232,2,1,1,2,0
2_4124722,noop_craves_sciatica_wonderbread,4124722,2,3,9,12,0
2_7140408,noop_eats_rice_cherry,7140408,2,1,1,2,0
2_1276331,noop_locale_onion_alsace,1276331,2,7,65,72,0
2_2339924,noop_harmony_achievement_earth,2339924,2,12,28,40,0
2_694359,noop_planet_mercury,694359,2,1,1,2,0
2_2937151,noop_craves_boils-1_arugula,2937151,2,6,12,18,0
2_4631551,noop_locale_potato_bosnia,4631551,2,35,119,154,0
2_7566765,noop_craves_intoxication_wonderbread,7566765,2,22,65,87,0
2_1568415,noop_craves_intoxication_potato,1568415,2,23,69,92,0
2_2417187,noop_pleasure_lubricity,2417187,2,1,1,2,0
2_4809174,noop_eats_endive_wurst,4809174,2,1,1,2,0
2_2972633,noop_eats_cherry_rice,2972633,2,1,1,2,0
2_1990466,noop_eats_wonderbread_arugula,1990466,2,1,1,2,0
2_1902674,noop_attacks_alsace_surrey,1902674,2,1,1,2,0
2_690997,province_alsace,690997,2,1,1,2,0
2_6239897,province_bosnia,6239897,2,1,1,2,0
2_3519135,eats_yogurt_potato,3519135,2,1,13,14,0
1_1578600,noop_harmony_excitement_earth,1578600,1,0,21,21,0
0_2366283,harmony_excitement_earth,2366283,0,0,4,4,0
2_3223975,eats_haroset_marzipan,3223975,2,1,15,16,0
1_608750,noop_harmony_satisfaction_mercury,608750,1,0,32,32,0
0_1918314,harmony_satisfaction_mercury,1918314,0,0,1,1,0
1_4857500,succumb_dread_excitement_papaya_earth_uranus,4857500,1,6,30,36,0
0_4020164,fears_dread_excitement,4020164,0,0,1,1,0
1_1784700,succumb_jealousy_love_rice_earth_uranus,1784700,1,5,44,49,0
0_4864290,harmony_love_earth,4864290,0,0,1,1,0
0_4484680,fears_jealousy_love,4484680,0,0,1,1,0
1_4923450,overcome_angina_lubricity_onion_earth_uranus,4923450,1,8,32,40,0
0_2335886,craves_lubricity_onion,2335886,0,0,4,4,0
2_2249450,fears_angina_lubricity,2249450,2,1,9,10,0
2_2937679,craves_angina_onion,2937679,2,2,14,16,0
1_6763301,feast_lubricity_potato_arugula_guanabara_bosnia,6763301,1,6,57,63,0
0_5334695,craves_lubricity_potato,5334695,0,0,7,7,0
2_6123415,craves_lubricity_arugula,6123415,2,2,32,34,0
2_1332191,eats_turkey_haroset,1332191,2,1,7,8,0
1_4740452,noop_craves_rest_wonderbread,4740452,1,0,24,24,0
0_1149340,craves_rest_wonderbread,1149340,0,0,5,5,0
1_5486452,noop_harmony_intoxication_earth,5486452,1,0,23,23,0
0_4775936,harmony_intoxication_earth,4775936,0,0,1,1,0
1_5511802,succumb_loneliness_satisfaction_potato_mercury_saturn,5511802,1,6,39,45,0
0_6982256,fears_loneliness_satisfaction,6982256,0,0,1,1,0
1_7186753,noop_craves_satiety_marzipan,7186753,1,0,36,36,0
0_3595641,craves_satiety_marzipan,3595641,0,0,7,7,0
1_4263853,feast_love_cherry_endive_guanabara_bosnia,4263853,1,5,57,62,0
0_6821478,locale_cherry_bosnia,6821478,0,0,6,6,0
0_6350300,craves_love_cherry,6350300,0,0,7,7,0
2_4553765,locale_cherry_guanabara,4553765,2,6,21,27,0
2_6376041,craves_love_endive,6376041,2,2,39,41,0
2_6527729,orbits_mercury_saturn,6527729,2,1,253,254,0
2_3639227,locale_wonderbread_alsace,3639227,2,7,16,23,0
2_1567476,pain_anger,1567476,2,1,32,33,0
2_7323719,craves_anxiety_marzipan,7323719,2,3,15,18,0
2_676602,eats_marzipan_haroset,676602,2,1,22,23,0
2_4332901,eats_mutton_ham,4332901,2,1,15,16,0
2_6759901,locale_yogurt_bosnia,6759901,2,3,10,13,0
2_3609901,province_surrey,3609901,2,1,1,2,0
1_7956354,overcome_hangover_love_papaya_earth_uranus,7956354,1,8,46,54,0
0_2426690,craves_love_papaya,2426690,0,0,6,6,0
2_6026349,fears_hangover_love,6026349,2,1,24,25,0
1_160254,overcome_loneliness_lubricity_potato_earth_uranus,160254,1,9,37,46,0
2_6847927,fears_loneliness_lubricity,6847927,2,1,23,24,0
1_6404305,noop_craves_love_papaya,6404305,1,1,36,37,0
1_5915405,noop_craves_rest_onion,5915405,1,0,25,25,0
0_868003,craves_rest_onion,868003,0,0,4,4,0
1_4682406,noop_locale_potato_guanabara,4682406,1,0,22,22,0
0_1091294,locale_potato_guanabara,1091294,0,0,6,6,0
1_7774906,noop_fears_loneliness_satisfaction,7774906,1,1,32,33,0
1_7214256,feast_lubricity_turkey_haroset_goias_bavaria,7214256,1,6,31,37,0
0_557511,craves_lubricity_turkey,557511,0,0,2,2,0
2_1607211,locale_turkey_goias,1607211,2,2,13,15,0
2_2072290,craves_lubricity_haroset,2072290,2,1,26,27,0
2_1024883,locale_turkey_bavaria,1024883,2,2,15,17,0
2_2252646,eats_haroset_turkey,2252646,2,1,15,16,0
1_3707157,noop_harmony_satiety_mercury,3707157,1,0,37,37,0
0_116045,harmony_satiety_mercury,116045,0,0,1,1,0
2_2230292,eats_cherry_endive,2230292,2,1,25,26,0
2_3933873,province_bavaria,3933873,2,1,1,2,0
2_6551857,craves_jealousy-2_wonderbread,6551857,2,3,9,12,0
2_1694955,craves_depression-7_haroset,1694955,2,1,10,11,0
1_6726507,feast_excitement_rice_cherry_guanabara_bosnia,6726507,1,5,44,49,0
0_6090059,locale_rice_bosnia,6090059,0,0,6,6,0
0_2490887,craves_excitement_rice,2490887,0,0,7,7,0
2_437954,locale_rice_guanabara,437954,2,6,21,27,0
2_6331552,craves_excitement_cherry,6331552,2,2,26,28,0
1_4026357,overcome_angina_rest_onion_mercury_saturn,4026357,1,9,31,40,0
2_3693926,fears_angina_rest,3693926,2,1,21,22,0
2_1432497,eats_rice_cherry,1432497,2,1,25,26,0
2_1996392,food_turkey,1996392,2,1,60,61,0
2_2574892,food_mutton,2574892,2,1,86,87,0
1_1485908,noop_harmony_entertainment_earth,1485908,1,0,7,7,0
0_3616283,harmony_entertainment_earth,3616283,0,0,1,1,0
2_6406031,planet_saturn,6406031,2,1,264,265,0
1_59058,noop_harmony_rest_mercury,59058,1,0,21,21,0
0_2914055,harmony_rest_mercury,2914055,0,0,2,2,0
2_3095552,pain_boils-1,3095552,2,1,32,33,0
1_4373908,feast_satiety_rice_papaya_bosnia_alsace,4373908,1,6,72,78,0
0_2670452,craves_satiety_rice,2670452,0,0,7,7,0
2_942615,craves_satiety_papaya,942615,2,2,36,38,0
1_795958,feast_satiety_marzipan_rice_alsace_surrey,795958,1,7,46,53,0
2_7541487,locale_marzipan_alsace,7541487,2,10,37,47,0
2_2459414,locale_marzipan_surrey,2459414,2,10,42,52,0
1_2280008,feast_intoxication_potato_arugula_bavaria_guanabara,2280008,1,6,43,49,0
0_857899,craves_intoxication_potato,857899,0,0,7,7,0
2_3037449,locale_potato_bavaria,3037449,2,6,16,22,0
2_7908898,planet_mercury,7908898,2,1,152,153,0
2_3749584,eats_wurst_endive,3749584,2,1,1,2,0
2_3933582,pain_jealousy,3933582,2,1,60,61,0
2_4380956,eats_marzipan_mutton,4380956,2,1,22,23,0
1_5600709,feast_love_cherry_marzipan_guanabara_bosnia,5600709,1,7,57,64,0
1_6203209,feast_love_marzipan_onion_alsace_surrey,6203209,1,6,47,53,0
0_4058429,craves_love_marzipan,4058429,0,0,7,7,0
2_2657767,craves_love_onion,2657767,2,1,43,44,0
1_1902659,feast_satiety_marzipan_onion_alsace_surrey,1902659,1,7,47,54,0
2_4495945,craves_satiety_onion,4495945,2,1,39,40,0
1_1715559,feast_intoxication_potato_shrimp_guanabara_bosnia,1715559,1,7,54,61,0
2_6829812,craves_intoxication_shrimp,6829812,2,2,32,34,0
1_4810659,overcome_jealousy-2_rest_wonderbread_mercury_saturn,4810659,1,9,31,40,0
2_5863500,fears_jealousy-2_rest,5863500,2,1,5,6,0
2_2302744,food_yogurt,2302744,2,1,76,77,0
2_5524126,eats_papaya_rice,5524126,2,1,17,18,0
1_4460410,noop_locale_shrimp_bosnia,4460410,1,0,16,16,0
0_7315407,locale_shrimp_bosnia,7315407,0,0,3,3,0
1_5091910,feast_satiety_marzipan_mutton_alsace_surrey,5091910,1,7,47,54,0
2_2043702,craves_satiety_mutton,2043702,2,1,14,15,0
1_6922960,overcome_hangover_excitement_papaya_saturn_earth,6922960,1,9,29,38,0
2_2441720,harmony_excitement_saturn,2441720,2,2,27,29,0
1_2111311,feast_satiety_rice_cherry_bosnia_alsace,2111311,1,7,72,79,0
1_3013961,feast_achievement_cherry_marzipan_bosnia_alsace,3013961,1,6,60,66,0
0_7902854,craves_achievement_cherry,7902854,0,0,7,7,0
2_3812864,craves_achievement_marzipan,3812864,2,2,42,44,0
2_601332,pleasure_achievement,601332,2,1,157,158,0
2_5961424,province_guanabara,5961424,2,1,1,2,0
2_365501,orbits_earth_uranus,365501,2,1,246,247,0
2_3715801,orbits_saturn_earth,3715801,2,1,173,174,0
1_2778412,feast_satiety_endive_cherry_guanabara_bosnia,2778412,1,5,55,60,0
0_6411945,locale_endive_bosnia,6411945,0,0,2,2,0
0_4891966,craves_satiety_endive,4891966,0,0,6,6,0
2_3950433,locale_endive_guanabara,3950433,2,2,28,30,0
2_4317552,eats_marzipan_onion,4317552,2,1,22,23,0
1_4815813,noop_craves_satiety_rice,4815813,1,1,37,38,0
1_5831263,succumb_abrasion-4_rest_ham_mercury_saturn,5831263,1,6,30,36,0
0_164979,fears_abrasion-4_rest,164979,0,0,1,1,0
1_2218863,feast_satisfaction_shrimp_potato_bosnia_alsace,2218863,1,6,54,60,0
0_3724020,craves_satisfaction_shrimp,3724020,0,0,7,7,0
1_6318363,feast_excitement_rice_papaya_bosnia_alsace,6318363,1,7,60,67,0
1_5533913,overcome_jealousy_satiety_rice_mercury_saturn,5533913,1,9,47,56,0
2_3605459,fears_jealousy_satiety,3605459,2,1,24,25,0
1_666864,noop_fears_depression_achievement,666864,1,0,23,23,0
0_1976428,fears_depression_achievement,1976428,0,0,1,1,0
1_1547814,feast_love_cherry_endive_bosnia_alsace,1547814,1,7,72,79,0
1_1568415,noop_craves_intoxication_potato,1568415,1,1,23,24,0
1_7566765,noop_craves_intoxication_wonderbread,7566765,1,0,22,22,0
0_2799049,craves_intoxication_wonderbread,2799049,0,0,5,5,0
2_5711881,pain_prostatitis,5711881,2,1,17,18,0
2_7775927,eats_potato_yogurt,7775927,2,1,13,14,0
2_6773576,food_potato,6773576,2,1,121,122,0
2_6432009,food_arugula,6432009,2,1,89,90,0
1_7149765,feast_rest_onion_shrimp_bosnia_alsace,7149765,1,7,32,39,0
2_4679870,locale_onion_bosnia,4679870,2,6,26,32,0
2_3573502,craves_rest_shrimp,3573502,2,1,33,34,0
2_7131947,locale_onion_alsace,7131947,2,6,28,34,0
1_6984665,feast_intoxication_potato_shrimp_bavaria_guanabara,6984665,1,7,43,50,0
2_2778149,eats_wonderbread_arugula,2778149,2,1,13,14,0
2_7806391,eats_onion_shrimp,7806391,2,1,25,26,0
2_4444941,attacks_goias_bavaria,4444941,2,1,149,150,0
2_4864341,pleasure_satisfaction,4864341,2,1,128,129,0
2_1243086,pleasure_entertainment,1243086,2,1,11,12,0
2_7395882,eats_potato_arugula,7395882,2,1,13,14,0
2_6951528,eats_marzipan_rice,6951528,2,1,22,23,0
2_1833554,eats_yogurt_wonderbread,1833554,2,1,13,14,0
1_4055766,feast_excitement_rice_cherry_bosnia_alsace,4055766,1,7,60,67,0
1_1221816,overcome_anger_love_marzipan_earth_uranus,1221816,1,9,42,51,0
2_809839,fears_anger_love,809839,2,1,27,28,0
2_942867,craves_anger_marzipan,942867,2,2,15,17,0
2_2380884,food_haroset,2380884,2,1,87,88,0
1_1783917,noop_fears_dread_excitement,1783917,1,1,23,24,0
2_4379955,locale_mutton_guanabara,4379955,2,3,16,19,0
1_1776967,succumb_prostatitis_entertainment_wurst_earth_uranus,1776967,1,6,11,17,0
0_2810155,fears_prostatitis_entertainment,2810155,0,0,1,1,0
1_3338867,succumb_laceration_satiety_cherry_mercury_saturn,3338867,1,6,44,50,0
0_2484468,fears_laceration_satiety,2484468,0,0,1,1,0
1_1999017,feast_lubricity_onion_shrimp_bosnia_alsace,1999017,1,7,35,42,0
1_2074717,feast_love_papaya_rice_guanabara_bosnia,2074717,1,6,55,61,0
0_5025041,locale_papaya_bosnia,5025041,0,0,2,2,0
2_1275730,locale_papaya_guanabara,1275730,2,2,29,31,0
1_2619867,feast_satiety_marzipan_cherry_alsace_surrey,2619867,1,7,47,54,0
1_1555517,feast_lubricity_potato_shrimp_guanabara_bosnia,1555517,1,7,57,64,0
1_4157067,overcome_anxiety_love_marzipan_earth_uranus,4157067,1,9,43,52,0
2_5436552,fears_anxiety_love,5436552,2,1,23,24,0
2_4228691,attacks_bavaria_guanabara,4228691,2,1,181,182,0
2_1006816,craves_laceration-8_haroset,1006816,2,1,10,11,0
2_7991065,eats_mutton_marzipan,7991065,2,1,15,16,0
1_1992768,noop_craves_satisfaction_yogurt,1992768,1,0,32,32,0
0_1282252,craves_satisfaction_yogurt,1282252,0,0,3,3,0
1_3433918,feast_satisfaction_arugula_wonderbread_alsace_surrey,3433918,1,6,51,57,0
0_1217321,craves_satisfaction_arugula,1217321,0,0,5,5,0
2_171277,craves_satisfaction_wonderbread,171277,2,3,33,36,0
1_2041368,feast_satisfaction_arugula_potato_bosnia_alsace,2041368,1,6,45,51,0
0_3242223,locale_arugula_alsace,3242223,0,0,2,2,0
2_790146,locale_arugula_bosnia,790146,2,2,25,27,0
1_4476418,feast_love_marzipan_haroset_alsace_surrey,4476418,1,7,47,54,0
2_6290134,craves_love_haroset,6290134,2,1,35,36,0
1_7426818,feast_love_marzipan_cherry_alsace_surrey,7426818,1,7,47,54,0
1_7729168,feast_intoxication_potato_arugula_guanabara_bosnia,7729168,1,7,54,61,0
2_1414816,eats_ham_mutton,1414816,2,1,13,14,0
1_4805169,overcome_boils_satisfaction_shrimp_mercury_saturn,4805169,1,9,41,50,0
2_6154015,fears_boils_satisfaction,6154015,2,1,21,22,0
1_7610369,overcome_abrasion_satisfaction_yogurt_mercury_saturn,7610369,1,9,36,45,0
2_4797514,fears_abrasion_satisfaction,4797514,2,1,18,19,0
2_5051695,craves_abrasion_yogurt,5051695,2,1,8,9,0
1_1584320,noop_fears_hangover_excitement,1584320,1,0,23,23,0
0_3206743,fears_hangover_excitement,3206743,0,0,1,1,0
2_3163114,planet_earth,3163114,2,1,245,246,0
1_6047420,feast_satiety_marzipan_haroset_alsace_surrey,6047420,1,7,47,54,0
2_2412853,craves_satiety_haroset,2412853,2,1,33,34,0
1_5077970,feast_intoxication_wonderbread_arugula_bosnia_alsace,5077970,1,7,31,38,0
2_1187150,locale_wonderbread_bosnia,1187150,2,6,13,19,0
2_5021833,eats_onion_ham,5021833,2,1,25,26,0
2_1830183,province_goias,1830183,2,1,1,2,0
2_1473805,food_papaya,1473805,2,1,97,98,0
1_7577871,noop_fears_prostatitis_entertainment,7577871,1,1,7,8,0
1_673471,feast_achievement_cherry_endive_bosnia_alsace,673471,1,7,60,67,0
1_4299571,feast_lubricity_potato_yogurt_bavaria_guanabara,4299571,1,7,47,54,0
2_863863,craves_lubricity_yogurt,863863,2,2,30,32,0
2_6255097,craves_sciatica_wonderbread,6255097,2,3,9,12,0
2_6280238,pleasure_satiety,6280238,2,1,166,167,0
1_534272,noop_harmony_lubricity_earth,534272,1,0,26,26,0
0_4944137,harmony_lubricity_earth,4944137,0,0,1,1,0
2_7298434,eats_shrimp_turkey,7298434,2,1,25,26,0
2_7920783,craves_entertainment_wurst,7920783,2,1,11,12,0
2_4439469,eats_ham_wonderbread,4439469,2,1,13,14,0
2_5423156,food_endive,5423156,2,1,90,91,0
2_7894655,eats_arugula_wonderbread,7894655,2,1,17,18,0
1_2007372,feast_excitement_rice_papaya_guanabara_bosnia,2007372,1,7,44,51,0
2_6276535,eats_rice_marzipan,6276535,2,1,25,26,0
1_7087923,noop_craves_satisfaction_arugula,7087923,1,1,32,33,0
1_4148623,noop_craves_lubricity_turkey,4148623,1,1,28,29,0
1_6215773,succumb_depression_achievement_endive_saturn_earth,6215773,1,6,30,36,0
0_2984277,harmony_achievement_saturn,2984277,0,0,4,4,0
1_6457823,overcome_anxiety_satiety_marzipan_mercury_saturn,6457823,1,9,43,52,0
2_7685259,fears_anxiety_satiety,7685259,2,1,24,25,0
2_4692999,attacks_alsace_surrey,4692999,2,1,44,45,0
2_7762749,eats_endive_wurst,7762749,2,1,17,18,0
2_4452600,pain_depression-7,4452600,2,1,13,14,0
1_1244925,feast_rest_wonderbread_yogurt_bosnia_alsace,1244925,1,7,33,40,0
2_1131734,craves_rest_yogurt,1131734,2,1,31,32,0
1_5468925,overcome_grief_satiety_endive_mercury_saturn,5468925,1,9,46,55,0
2_3477698,fears_grief_satiety,3477698,2,1,22,23,0
1_7945476,noop_locale_ham_bavaria,7945476,1,0,13,13,0
0_3967861,locale_ham_bavaria,3967861,0,0,0,0,0
2_6843000,pain_abrasion-4,6843000,2,1,44,45,0
1_5995026,feast_rest_onion_ham_bosnia_alsace,5995026,1,7,33,40,0
1_7893326,feast_lubricity_potato_yogurt_guanabara_bosnia,7893326,1,7,57,64,0
1_2132427,feast_achievement_cherry_endive_guanabara_bosnia,2132427,1,7,44,51,0
1_577277,feast_intoxication_wonderbread_yogurt_bosnia_alsace,577277,1,7,31,38,0
2_4388044,craves_intoxication_yogurt,4388044,2,3,27,30,0
1_4076027,overcome_boils-1_satisfaction_arugula_mercury_saturn,4076027,1,9,41,50,0
2_7829991,fears_boils-1_satisfaction,7829991,2,1,20,21,0
1_840928,noop_harmony_love_earth,840928,1,1,37,38,0
2_5370277,food_wurst,5370277,2,1,99,100,0
2_4744512,food_shrimp,4744512,2,1,148,149,0
2_918250,pain_boils,918250,2,1,49,50,0
1_5467628,feast_satisfaction_shrimp_turkey_bosnia_alsace,5467628,1,7,54,61,0
2_975900,craves_satisfaction_turkey,975900,2,2,6,8,0
1_4680578,feast_lubricity_onion_ham_bosnia_alsace,4680578,1,7,35,42,0
2_3190749,craves_lubricity_ham,3190749,2,1,31,32,0
1_7825528,overcome_sciatica_rest_wonderbread_mercury_saturn,7825528,1,9,31,40,0
2_3948803,fears_sciatica_rest,3948803,2,1,20,21,0
1_4138778,overcome_depression_achievement_endive_mercury_saturn,4138778,1,9,29,38,0
2_4046367,harmony_achievement_mercury,4046367,2,2,19,21,0
2_4074641,eats_shrimp_potato,4074641,2,1,25,26,0
2_1737877,attacks_bosnia_alsace,1737877,2,1,150,151,0
2_778475,pain_hangover,778475,2,1,41,42,0
2_1840068,food_wonderbread,1840068,2,1,120,121,0
1_2231879,noop_fears_boils_lubricity,2231879,1,0,26,26,0
0_5022204,fears_boils_lubricity,5022204,0,0,1,1,0
1_3862829,feast_achievement_cherry_rice_guanabara_bosnia,3862829,1,7,44,51,0
2_4271646,craves_achievement_rice,4271646,2,2,40,42,0
1_924830,noop_craves_lubricity_potato,924830,1,1,27,28,0
2_2456363,locale_haroset_guanabara,2456363,2,1,15,16,0
2_2200903,pleasure_love,2200903,2,1,223,224,0
1_5375631,noop_fears_abrasion-4_rest,5375631,1,1,23,24,0
1_3966481,noop_locale_cherry_bosnia,3966481,1,1,22,23,0
1_4696431,noop_fears_loneliness-3_rest,4696431,1,0,23,23,0
0_1105319,fears_loneliness-3_rest,1105319,0,0,1,1,0
2_5397415,food_cherry,5397415,2,1,196,197,0
2_3412554,food_marzipan,3412554,2,1,285,286,0
1_6280431,noop_craves_achievement_cherry,6280431,1,1,24,25,0
1_3667281,feast_love_cherry_rice_guanabara_bosnia,3667281,1,7,57,64,0
1_4191681,feast_satisfaction_shrimp_onion_guanabara_bosnia,4191681,1,7,46,53,0
2_2178943,locale_shrimp_guanabara,2178943,2,3,34,37,0
2_181007,craves_satisfaction_onion,181007,2,2,32,34,0
2_7414097,eats_wonderbread_yogurt,7414097,2,1,13,14,0
2_7203479,eats_marzipan_cherry,7203479,2,1,22,23,0
1_1203432,noop_craves_love_marzipan,1203432,1,1,36,37,0
1_4011732,feast_satiety_rice_papaya_guanabara_bosnia,4011732,1,7,57,64,0
2_5265699,eats_cherry_rice,5265699,2,1,25,26,0
2_7865332,pain_dread,7865332,2,1,41,42,0
2_1795018,eats_endive_cherry,1795018,2,1,17,18,0
2_2216718,eats_potato_shrimp,2216718,2,1,13,14,0
1_313983,feast_satiety_endive_cherry_bosnia_alsace,313983,1,7,52,59,0
1_2926233,feast_rest_wonderbread_ham_bosnia_alsace,2926233,1,7,33,40,0
1_5075933,overcome_depression_satiety_endive_mercury_saturn,5075933,1,9,46,55,0
2_2164069,fears_depression_satiety,2164069,2,1,21,22,0
2_5428931,eats_cherry_marzipan,5428931,2,1,25,26,0
1_513134,feast_rest_onion_marzipan_bosnia_alsace,513134,1,7,33,40,0
2_5472578,craves_rest_marzipan,5472578,2,2,39,41,0
1_541684,feast_satiety_endive_wurst_guanabara_bosnia,541684,1,7,55,62,0
2_6055786,craves_satiety_wurst,6055786,2,2,27,29,0
1_1897884,feast_love_marzipan_mutton_alsace_surrey,1897884,1,7,47,54,0
2_3527777,craves_love_mutton,3527777,2,1,33,34,0
1_7278434,feast_rest_mutton_marzipan_bavaria_guanabara,7278434,1,6,30,36,0
0_1403882,craves_rest_mutton,1403882,0,0,2,2,0
2_5123081,locale_mutton_bavaria,5123081,2,2,28,30,0
1_566584,feast_love_papaya_wurst_guanabara_bosnia,566584,1,7,55,62,0
2_4217608,craves_love_wurst,4217608,2,2,31,33,0
1_1345384,overcome_jealousy-2_intoxication_wonderbread_earth_uranus,1345384,1,9,29,38,0
2_7314742,fears_jealousy-2_intoxication,7314742,2,1,19,20,0
1_579734,overcome_anger_satiety_marzipan_mercury_saturn,579734,1,9,43,52,0
2_2909346,fears_anger_satiety,2909346,2,1,25,26,0
1_2807634,overcome_jealousy_excitement_rice_earth_uranus,2807634,1,9,34,43,0
2_1628909,fears_jealousy_excitement,1628909,2,1,18,19,0
2_1766033,pleasure_intoxication,1766033,2,1,142,143,0
1_1696785,noop_fears_laceration_satiety,1696785,1,1,37,38,0
2_7801210,eats_wurst_papaya,7801210,2,1,1,2,0
2_7763559,pain_jealousy-2,7763559,2,1,18,19,0
1_959535,feast_love_cherry_marzipan_bosnia_alsace,959535,1,7,72,79,0
2_323738,food_rice,323738,2,1,202,203,0
1_4434536,noop_craves_satisfaction_shrimp,4434536,1,1,32,33,0
2_4985459,pain_sciatica,4985459,2,1,18,19,0
1_2554286,succumb_boils-1_intoxication_arugula_earth_uranus,2554286,1,6,29,35,0
0_4731683,fears_boils-1_intoxication,4731683,0,0,1,1,0
1_4750336,succumb_hangover_excitement_papaya_earth_uranus,4750336,1,7,30,37,0
1_2311836,feast_lubricity_onion_marzipan_bosnia_alsace,2311836,1,7,35,42,0
2_4422260,craves_lubricity_marzipan,4422260,2,1,43,44,0
1_4290586,overcome_dread_love_papaya_earth_uranus,4290586,1,9,46,55,0
2_804392,fears_dread_love,804392,2,1,24,25,0
2_6440549,pleasure_lubricity,6440549,2,1,204,205,0
2_3810436,food_onion,3810436,2,1,190,191,0
1_7314587,noop_fears_grief_achievement,7314587,1,0,23,23,0
0_3723475,fears_grief_achievement,3723475,0,0,1,1,0
2_3474113,pain_laceration-8,3474113,2,1,13,14,0
1_2326938,noop_craves_love_cherry,2326938,1,1,37,38,0
1_5265438,feast_intoxication_potato_yogurt_bavaria_guanabara,5265438,1,7,43,50,0
1_99639,noop_craves_lubricity_onion,99639,1,1,27,28,0
2_1486223,pain_angina,1486223,2,1,25,26,0
2_7998514,pain_loneliness-3,7998514,2,1,44,45,0
2_6196362,pleasure_rest,6196362,2,1,179,180,0
2_197009,eats_wonderbread_ham,197009,2,1,13,14,0
2_6188452,food_ham,6188452,2,1,117,118,0
2_7897051,eats_turkey_shrimp,7897051,2,1,7,8,0
1_2996889,feast_satisfaction_yogurt_potato_guanabara_bosnia,2996889,1,7,37,44,0
2_74373,locale_yogurt_guanabara,74373,2,2,22,24,0
1_1522839,feast_achievement_cherry_marzipan_guanabara_bosnia,1522839,1,7,44,51,0
1_7626089,feast_love_marzipan_rice_alsace_surrey,7626089,1,7,47,54,0
1_790639,overcome_prostatitis_excitement_wurst_earth_uranus,790639,1,8,34,42,0
0_92031,craves_excitement_wurst,92031,0,0,1,1,0
2_4037416,fears_prostatitis_excitement,4037416,2,1,17,18,0
1_254640,noop_craves_excitement_rice,254640,1,1,24,25,0
1_7123940,noop_craves_achievement_wurst,7123940,1,0,24,24,0
0_7911623,craves_achievement_wurst,7911623,0,0,1,1,0
1_729890,feast_satiety_rice_cherry_guanabara_bosnia,729890,1,7,57,64,0
1_1277090,feast_achievement_cherry_rice_bosnia_alsace,1277090,1,7,60,67,0
1_4996490,feast_satisfaction_arugula_potato_alsace_surrey,4996490,1,7,51,58,0
1_922840,feast_rest_mutton_ham_bavaria_guanabara,922840,1,7,30,37,0
1_6642490,overcome_dread_excitement_papaya_saturn_earth,6642490,1,9,29,38,0
1_3603240,overcome_grief_achievement_endive_mercury_saturn,3603240,1,9,29,38,0
1_6630041,noop_fears_jealousy_love,6630041,1,1,37,38,0
1_2101641,noop_craves_satiety_endive,2101641,1,1,36,37,0
1_6490141,feast_lubricity_turkey_shrimp_goias_bavaria,6490141,1,7,32,39,0
1_1320041,feast_love_papaya_rice_bosnia_alsace,1320041,1,7,52,59,0
1_7975341,feast_rest_wonderbread_arugula_bosnia_alsace,7975341,1,7,33,40,0
2_2689598,craves_rest_arugula,2689598,2,1,33,34,0
1_52391,feast_intoxication_potato_yogurt_guanabara_bosnia,52391,1,7,54,61,0
2_1180739,pain_laceration,1180739,2,1,63,64,0
1_592492,feast_satiety_rice_marzipan_bosnia_alsace,592492,1,7,72,79,0
2_2932032,pleasure_excitement,2932032,2,1,157,158,0
1_3683143,noop_craves_excitement_wurst,3683143,1,1,24,25,0
1_3694793,noop_harmony_achievement_saturn,3694793,1,1,21,22,0
2_1370260,pain_anxiety,1370260,2,1,32,33,0
1_4786443,feast_love_cherry_rice_bosnia_alsace,4786443,1,7,72,79,0
1_4026843,feast_satisfaction_shrimp_turkey_guanabara_bosnia,4026843,1,7,46,53,0
1_834693,feast_excitement_rice_marzipan_bosnia_alsace,834693,1,7,60,67,0
2_7539959,craves_excitement_marzipan,7539959,2,2,41,43,0
1_3048343,feast_lubricity_potato_arugula_bavaria_guanabara,3048343,1,7,47,54,0
1_7026343,feast_intoxication_wonderbread_ham_bosnia_alsace,7026343,1,7,31,38,0
2_7446485,craves_intoxication_ham,7446485,2,1,30,31,0
1_1304243,overcome_sciatica_intoxication_wonderbread_earth_uranus,1304243,1,9,29,38,0
2_5852117,fears_sciatica_intoxication,5852117,2,1,18,19,0
1_4671043,overcome_laceration_achievement_cherry_saturn_earth,4671043,1,9,34,43,0
2_562209,fears_laceration_achievement,562209,2,1,18,19,0
2_3456443,pain_grief,3456443,2,1,42,43,0
2_5631791,pain_loneliness,5631791,2,1,50,51,0
1_2170044,noop_locale_papaya_bosnia,2170044,1,1,18,19,0
2_6892927,attacks_guanabara_bosnia,6892927,2,1,170,171,0
2_2180706,eats_ham_onion,2180706,2,1,13,14,0
1_6865444,succumb_boils_lubricity_shrimp_earth_uranus,6865444,1,7,33,40,0
1_6901344,succumb_grief_achievement_endive_saturn_earth,6901344,1,7,30,37,0
1_4950594,overcome_laceration_love_cherry_earth_uranus,4950594,1,9,47,56,0
2_3246453,fears_laceration_love,3246453,2,1,25,26,0
2_4018670,eats_shrimp_onion,4018670,2,1,25,26,0
1_7507245,succumb_loneliness-3_rest_ham_mercury_saturn,7507245,1,7,30,37,0
1_5254895,feast_satisfaction_yogurt_wonderbread_guanabara_bosnia,5254895,1,7,37,44,0
2_492931,locale_wurst_goias,492931,2,1,1,2,0
1_2845996,feast_satiety_endive_wurst_bosnia_alsace,2845996,1,7,52,59,0
1_478796,feast_satisfaction_arugula_wonderbread_bosnia_alsace,478796,1,7,45,52,0
1_7676246,overcome_loneliness_intoxication_potato_earth_uranus,7676246,1,9,33,42,0
2_3883948,fears_loneliness_intoxication,3883948,2,1,20,21,0
1_5381497,noop_craves_rest_mutton,5381497,1,1,26,27,0
2_7813070,pain_abrasion,7813070,2,1,13,14,0
1_2066697,noop_locale_rice_bosnia,2066697,1,1,22,23,0
1_3527197,feast_satisfaction_shrimp_potato_guanabara_bosnia,3527197,1,7,46,53,0
1_159897,feast_excitement_rice_marzipan_guanabara_bosnia,159897,1,7,44,51,0
1_279197,overcome_prostatitis_achievement_wurst_saturn_earth,279197,1,9,34,43,0
2_3545441,fears_prostatitis_achievement,3545441,2,1,17,18,0
2_506446,eats_papaya_wurst,506446,2,1,17,18,0
1_3556948,noop_locale_endive_bosnia,3556948,1,1,18,19,0
2_346337,eats_arugula_potato,346337,2,1,17,18,0
1_451898,noop_locale_arugula_alsace,451898,1,1,13,14,0
2_5509864,eats_rice_papaya,5509864,2,1,25,26,0
1_5857448,feast_satiety_rice_marzipan_guanabara_bosnia,5857448,1,7,57,64,0
1_179748,feast_satisfaction_shrimp_onion_bosnia_alsace,179748,1,7,54,61,0
1_6018798,feast_lubricity_potato_shrimp_bavaria_guanabara,6018798,1,7,47,54,0
2_2211538,eats_onion_marzipan,2211538,2,1,25,26,0
1_5442199,noop_fears_boils-1_intoxication,5442199,1,1,23,24,0
2_7159023,pain_depression,7159023,2,1,42,43,0
2_7480922,planet_uranus,7480922,2,1,133,134,0
1_7099199,feast_love_papaya_wurst_bosnia_alsace,7099199,1,7,52,59,0
3_1686416,noop_craves_satisfaction_turkey,1686416,3,92,201,293,0
3_482599,feast_satisfaction_turkey_shrimp_goias_bavaria,482599,3,107,223,330,0
3_5471088,feast_satisfaction_turkey_haroset_goias_bavaria,5471088,3,107,223,330,0
3_7486548,locale_potato_bosnia,7486548,3,26,43,69,0
3_790146,locale_arugula_bosnia,790146,3,30,11,41,0
3_7829991,fears_boils-1_satisfaction,7829991,3,18,30,48,0
3_5753084,craves_satisfaction_potato,5753084,3,23,31,54,0
3_171277,craves_satisfaction_wonderbread,171277,3,22,35,57,0
3_74373,locale_yogurt_guanabara,74373,3,28,9,37,0
3_1217321,craves_satisfaction_arugula,1217321,3,21,29,50,0
3_3724020,craves_satisfaction_shrimp,3724020,3,24,33,57,0
3_6154015,fears_boils_satisfaction,6154015,3,18,31,49,0
3_1918314,harmony_satisfaction_mercury,1918314,3,21,25,46,0
3_4797514,fears_abrasion_satisfaction,4797514,3,17,28,45,0
3_1766507,locale_shrimp_alsace,1766507,3,27,46,73,0
3_181007,craves_satisfaction_onion,181007,3,23,33,56,0
3_6982256,fears_loneliness_satisfaction,6982256,3,19,20,39,0
3_1282252,craves_satisfaction_yogurt,1282252,3,19,17,36,0
3_7565704,noop_locale_wonderbread_bosnia,7565704,3,20,39,59,0
3_2162471,feast_satisfaction_wonderbread_ham_guanabara_bosnia,2162471,3,98,220,318,0
3_4627335,feast_satisfaction_wonderbread_yogurt_guanabara_bosnia,4627335,3,98,220,318,0
3_2771213,feast_satisfaction_wonderbread_arugula_guanabara_bosnia,2771213,3,98,220,318,0
3_5643580,feast_rest_wonderbread_ham_guanabara_bosnia,5643580,3,111,284,395,0
3_6605908,feast_rest_wonderbread_yogurt_guanabara_bosnia,6605908,3,111,284,395,0
3_5224350,feast_rest_wonderbread_arugula_guanabara_bosnia,5224350,3,111,284,395,0
3_4975932,feast_intoxication_wonderbread_ham_guanabara_bosnia,4975932,3,92,201,293,0
3_3686216,feast_intoxication_wonderbread_yogurt_guanabara_bosnia,3686216,3,92,201,293,0
3_1874059,feast_intoxication_wonderbread_arugula_guanabara_bosnia,1874059,3,92,201,293,0
3_3639227,locale_wonderbread_alsace,3639227,3,13,21,34,0
3_3073175,noop_fears_jealousy-2_rest,3073175,3,95,254,349,0
3_4774347,succumb_jealousy-2_rest_wonderbread_mercury_saturn,4774347,3,108,287,395,0
3_2689598,craves_rest_arugula,2689598,3,25,41,66,0
3_6284244,craves_rest_ham,6284244,3,21,36,57,0
3_7314742,fears_jealousy-2_intoxication,7314742,3,15,23,38,0
3_7730434,harmony_rest_saturn,7730434,3,27,48,75,0
3_1131734,craves_rest_yogurt,1131734,3,23,39,62,0
3_1403882,craves_rest_mutton,1403882,3,18,33,51,0
3_5123081,locale_mutton_bavaria,5123081,3,24,16,40,0
3_164979,fears_abrasion-4_rest,164979,3,16,32,48,0
3_5472578,craves_rest_marzipan,5472578,3,27,48,75,0
3_3693926,fears_angina_rest,3693926,3,18,36,54,0
3_1105319,fears_loneliness-3_rest,1105319,3,16,32,48,0
3_1126409,locale_ham_guanabara,1126409,3,21,46,67,0
3_6551857,craves_jealousy-2_wonderbread,6551857,3,8,8,16,0
3_868003,craves_rest_onion,868003,3,24,34,58,0
3_3948803,fears_sciatica_rest,3948803,3,18,31,49,0
3_3573502,craves_rest_shrimp,3573502,3,29,38,67,0
3_13203,noop_fears_angina_lubricity,13203,3,98,221,319,0
3_3991950,succumb_angina_lubricity_onion_earth_uranus,3991950,3,111,288,399,0
3_3190749,craves_lubricity_ham,3190749,3,24,39,63,0
3_5334695,craves_lubricity_potato,5334695,3,28,44,72,0
3_2072290,craves_lubricity_haroset,2072290,3,19,36,55,0
3_3305631,craves_lubricity_shrimp,3305631,3,25,47,72,0
3_2937679,craves_angina_onion,2937679,3,10,16,26,0
3_6847927,fears_loneliness_lubricity,6847927,3,19,35,54,0
3_7367121,harmony_lubricity_uranus,7367121,3,21,50,71,0
3_6123415,craves_lubricity_arugula,6123415,3,25,41,66,0
3_863863,craves_lubricity_yogurt,863863,3,23,38,61,0
3_557511,craves_lubricity_turkey,557511,3,18,30,48,0
3_1607211,locale_turkey_goias,1607211,3,17,1,18,0
3_4422260,craves_lubricity_marzipan,4422260,3,29,49,78,0
3_5022204,fears_boils_lubricity,5022204,3,18,32,50,0
3_2182175,noop_harmony_intoxication_uranus,2182175,3,24,87,111,0
3_910036,overcome_abrasion-4_intoxication_ham_earth_uranus,910036,3,111,231,342,0
3_2911312,overcome_boils_intoxication_shrimp_earth_uranus,2911312,3,115,237,352,0
3_7805069,overcome_boils-1_intoxication_arugula_earth_uranus,7805069,3,83,186,269,0
3_1304243,overcome_sciatica_intoxication_wonderbread_earth_uranus,1304243,3,89,187,276,0
3_1345384,overcome_jealousy-2_intoxication_wonderbread_earth_uranus,1345384,3,89,187,276,0
3_2592020,overcome_loneliness-3_intoxication_ham_earth_uranus,2592020,3,111,231,342,0
3_4261129,overcome_abrasion_intoxication_yogurt_earth_uranus,4261129,3,90,193,283,0
3_7676246,overcome_loneliness_intoxication_potato_earth_uranus,7676246,3,95,213,308,0
3_3883948,fears_loneliness_intoxication,3883948,3,16,27,43,0
3_4775936,harmony_intoxication_earth,4775936,3,22,43,65,0
3_4731683,fears_boils-1_intoxication,4731683,3,15,23,38,0
3_5852117,fears_sciatica_intoxication,5852117,3,15,23,38,0
3_2072975,noop_craves_intoxication_arugula,2072975,3,64,150,214,0
3_2554286,succumb_boils-1_intoxication_arugula_earth_uranus,2554286,3,86,183,269,0
3_636882,feast_intoxication_arugula_wonderbread_bosnia_alsace,636882,3,92,195,287,0
3_3592004,feast_intoxication_arugula_wonderbread_alsace_surrey,3592004,3,92,198,290,0
3_7535551,feast_intoxication_arugula_wonderbread_guanabara_bosnia,7535551,3,149,195,344,0
3_4564663,feast_intoxication_arugula_potato_bosnia_alsace,4564663,3,92,195,287,0
3_7519785,feast_intoxication_arugula_potato_alsace_surrey,7519785,3,92,198,290,0
3_7056651,feast_intoxication_arugula_potato_guanabara_bosnia,7056651,3,149,195,344,0
3_3154392,overcome_boils-1_intoxication_arugula_saturn_earth,3154392,3,83,183,266,0
3_2799049,craves_intoxication_wonderbread,2799049,3,20,43,63,0
3_857899,craves_intoxication_potato,857899,3,25,36,61,0
3_4388044,craves_intoxication_yogurt,4388044,3,20,30,50,0
3_7446485,craves_intoxication_ham,7446485,3,22,31,53,0
3_6829812,craves_intoxication_shrimp,6829812,3,26,37,63,0
3_1499025,noop_pain_depression-7,1499025,3,1,1,2,0
3_576134,overcome_depression-7_love_haroset_earth_uranus,576134,3,162,341,503,0
3_2846564,overcome_depression-7_satiety_haroset_mercury_saturn,2846564,3,156,289,445,0
3_6384339,overcome_depression-7_lubricity_haroset_earth_uranus,6384339,3,111,281,392,0
3_145726,noop_pain_abrasion-4,145726,3,1,1,2,0
3_6726996,succumb_abrasion-4_rest_onion_mercury_saturn,6726996,3,105,283,388,0
3_5425224,succumb_abrasion-4_rest_mutton_mercury_saturn,5425224,3,105,283,388,0
3_6351126,succumb_abrasion-4_rest_wonderbread_mercury_saturn,6351126,3,105,283,388,0
3_5831263,succumb_abrasion-4_rest_ham_mercury_saturn,5831263,3,98,267,365,0
3_6459978,overcome_abrasion-4_rest_ham_mercury_saturn,6459978,3,95,267,362,0
3_1101858,overcome_abrasion-4_lubricity_ham_earth_uranus,1101858,3,135,332,467,0
3_6427428,noop_pain_boils,6427428,3,1,1,2,0
3_1496995,succumb_boils_lubricity_turkey_earth_uranus,1496995,3,117,285,402,0
3_6865444,succumb_boils_lubricity_shrimp_earth_uranus,6865444,3,107,267,374,0
3_3842841,succumb_boils_lubricity_onion_earth_uranus,3842841,3,117,284,401,0
3_890482,succumb_boils_lubricity_potato_earth_uranus,890482,3,117,284,401,0
3_2253099,succumb_boils_satisfaction_shrimp_mercury_saturn,2253099,3,108,257,365,0
3_4171450,overcome_boils_rest_shrimp_mercury_saturn,4171450,3,148,344,492,0
3_4805169,overcome_boils_satisfaction_shrimp_mercury_saturn,4805169,3,110,218,328,0
3_7796944,overcome_boils_lubricity_shrimp_earth_uranus,7796944,3,101,269,370,0
3_3146267,overcome_boils_lubricity_shrimp_saturn_earth,3146267,3,102,267,369,0
3_2326938,noop_craves_love_cherry,2326938,3,101,256,357,0
3_4019094,succumb_laceration_love_cherry_earth_uranus,4019094,3,126,348,474,0
3_1147833,succumb_jealousy_love_cherry_earth_uranus,1147833,3,133,311,444,0
3_1460940,feast_love_cherry_marzipan_bavaria_guanabara,1460940,3,146,341,487,0
3_959535,feast_love_cherry_marzipan_bosnia_alsace,959535,3,233,632,865,0
3_5600709,feast_love_cherry_marzipan_guanabara_bosnia,5600709,3,141,341,482,0
3_3267815,feast_love_cherry_endive_bavaria_guanabara,3267815,3,146,341,487,0
3_1547814,feast_love_cherry_endive_bosnia_alsace,1547814,3,233,632,865,0
3_4263853,feast_love_cherry_endive_guanabara_bosnia,4263853,3,141,341,482,0
3_2563946,feast_love_cherry_rice_bavaria_guanabara,2563946,3,146,341,487,0
3_4786443,feast_love_cherry_rice_bosnia_alsace,4786443,3,233,632,865,0
3_3667281,feast_love_cherry_rice_guanabara_bosnia,3667281,3,141,341,482,0
3_299917,overcome_laceration_love_cherry_saturn_earth,299917,3,127,339,466,0
3_4950594,overcome_laceration_love_cherry_earth_uranus,4950594,3,128,334,462,0
3_6026349,fears_hangover_love,6026349,3,21,34,55,0
3_804392,fears_dread_love,804392,3,21,34,55,0
3_6376041,craves_love_endive,6376041,3,29,44,73,0
3_2426690,craves_love_papaya,2426690,3,20,44,64,0
3_809839,fears_anger_love,809839,3,21,36,57,0
3_725535,craves_love_rice,725535,3,29,56,85,0
3_6290134,craves_love_haroset,6290134,3,25,38,63,0
3_1275730,locale_papaya_guanabara,1275730,3,30,11,41,0
3_4058429,craves_love_marzipan,4058429,3,34,55,89,0
3_3527777,craves_love_mutton,3527777,3,27,38,65,0
3_2657767,craves_love_onion,2657767,3,29,47,76,0
3_541159,locale_rice_alsace,541159,3,31,58,89,0
3_4217608,craves_love_wurst,4217608,3,22,36,58,0
3_5436552,fears_anxiety_love,5436552,3,21,34,55,0
3_3873689,noop_eats_turkey_shrimp,3873689,3,1,1,2,0
3_6490141,feast_lubricity_turkey_shrimp_goias_bavaria,6490141,3,105,280,385,0
3_2510862,noop_orbits_earth_uranus,2510862,3,1,1,2,0
3_3528352,succumb_anxiety_love_marzipan_earth_uranus,3528352,3,122,321,443,0
3_1776967,succumb_prostatitis_entertainment_wurst_earth_uranus,1776967,3,22,35,57,0
3_3478144,succumb_jealousy_excitement_rice_earth_uranus,3478144,3,91,267,358,0
3_1939434,succumb_dread_excitement_wurst_earth_uranus,1939434,3,87,231,318,0
3_5408149,succumb_dread_excitement_rice_earth_uranus,5408149,3,87,231,318,0
3_4857500,succumb_dread_excitement_papaya_earth_uranus,4857500,3,82,224,306,0
3_3540833,succumb_prostatitis_excitement_wurst_earth_uranus,3540833,3,90,236,326,0
3_1000943,succumb_sciatica_intoxication_wonderbread_earth_uranus,1000943,3,87,189,276,0
3_5609161,succumb_loneliness_lubricity_potato_earth_uranus,5609161,3,115,307,422,0
3_2830692,succumb_jealousy_love_marzipan_earth_uranus,2830692,3,133,311,444,0
3_1784700,succumb_jealousy_love_rice_earth_uranus,1784700,3,123,293,416,0
3_7501196,succumb_jealousy_love_papaya_earth_uranus,7501196,3,133,312,445,0
3_7507585,succumb_boils-1_intoxication_potato_earth_uranus,7507585,3,93,192,285,0
3_2272662,succumb_boils-1_intoxication_wonderbread_earth_uranus,2272662,3,93,191,284,0
3_877404,succumb_anger_love_marzipan_earth_uranus,877404,3,122,321,443,0
3_6704429,succumb_jealousy-2_intoxication_wonderbread_earth_uranus,6704429,3,87,189,276,0
3_4997210,succumb_dread_love_papaya_earth_uranus,4997210,3,124,328,452,0
3_813878,succumb_hangover_excitement_wurst_earth_uranus,813878,3,87,231,318,0
3_1028218,succumb_hangover_excitement_rice_earth_uranus,1028218,3,87,231,318,0
3_4750336,succumb_hangover_excitement_papaya_earth_uranus,4750336,3,82,224,306,0
3_6381351,succumb_loneliness_intoxication_potato_earth_uranus,6381351,3,93,218,311,0
3_7797629,succumb_hangover_love_papaya_earth_uranus,7797629,3,124,328,452,0
3_2042862,overcome_boils-1_lubricity_arugula_earth_uranus,2042862,3,132,309,441,0
3_4157067,overcome_anxiety_love_marzipan_earth_uranus,4157067,3,124,306,430,0
3_773917,overcome_anxiety_excitement_marzipan_earth_uranus,773917,3,109,267,376,0
3_386984,overcome_anxiety_lubricity_marzipan_earth_uranus,386984,3,138,303,441,0
3_1197398,overcome_laceration-8_love_haroset_earth_uranus,1197398,3,162,341,503,0
3_792025,overcome_laceration-8_lubricity_haroset_earth_uranus,792025,3,111,281,392,0
3_7092061,overcome_loneliness-3_lubricity_ham_earth_uranus,7092061,3,135,332,467,0
3_3900703,overcome_abrasion_lubricity_yogurt_earth_uranus,3900703,3,127,292,419,0
3_2767387,overcome_angina_love_onion_earth_uranus,2767387,3,169,355,524,0
3_4923450,overcome_angina_lubricity_onion_earth_uranus,4923450,3,113,280,393,0
3_4431939,overcome_depression_love_endive_earth_uranus,4431939,3,158,352,510,0
3_7956354,overcome_hangover_love_papaya_earth_uranus,7956354,3,126,317,443,0
3_3572660,overcome_hangover_excitement_papaya_earth_uranus,3572660,3,82,225,307,0
3_1221816,overcome_anger_love_marzipan_earth_uranus,1221816,3,124,306,430,0
3_166809,overcome_anger_excitement_marzipan_earth_uranus,166809,3,109,267,376,0
3_2509872,overcome_anger_lubricity_marzipan_earth_uranus,2509872,3,138,303,441,0
3_735774,overcome_prostatitis_love_wurst_earth_uranus,735774,3,130,314,444,0
3_790639,overcome_prostatitis_excitement_wurst_earth_uranus,790639,3,92,222,314,0
3_5230030,overcome_prostatitis_entertainment_wurst_earth_uranus,5230030,3,24,35,59,0
3_4911427,overcome_jealousy_love_rice_earth_uranus,4911427,3,110,298,408,0
3_2807634,overcome_jealousy_excitement_rice_earth_uranus,2807634,3,93,249,342,0
3_4290586,overcome_dread_love_papaya_earth_uranus,4290586,3,126,317,443,0
3_3292190,overcome_dread_excitement_papaya_earth_uranus,3292190,3,82,225,307,0
3_5532813,overcome_laceration_excitement_cherry_earth_uranus,5532813,3,113,293,406,0
3_160254,overcome_loneliness_lubricity_potato_earth_uranus,160254,3,117,302,419,0
3_5089849,overcome_grief_love_endive_earth_uranus,5089849,3,158,352,510,0
3_5636604,noop_eats_mutton_ham,5636604,3,1,1,2,0
3_6601673,feast_satiety_mutton_ham_bavaria_guanabara,6601673,3,156,299,455,0
3_7604645,feast_satiety_mutton_ham_goias_bavaria,7604645,3,226,299,525,0
3_2901246,feast_love_mutton_ham_bavaria_guanabara,2901246,3,162,352,514,0
3_1463910,feast_love_mutton_ham_goias_bavaria,1463910,3,232,352,584,0
3_922840,feast_rest_mutton_ham_bavaria_guanabara,922840,3,104,279,383,0
3_5861162,noop_orbits_saturn_earth,5861162,3,1,1,2,0
3_4634731,succumb_laceration_achievement_cherry_saturn_earth,4634731,3,89,273,362,0
3_206823,succumb_dread_excitement_papaya_saturn_earth,206823,3,82,224,306,0
3_2157931,succumb_grief_achievement_cherry_saturn_earth,2157931,3,84,229,313,0
3_102786,succumb_grief_achievement_wurst_saturn_earth,102786,3,84,229,313,0
3_6901344,succumb_grief_achievement_endive_saturn_earth,6901344,3,79,222,301,0
3_1472360,succumb_depression_achievement_cherry_saturn_earth,1472360,3,84,229,313,0
3_4694419,succumb_depression_achievement_wurst_saturn_earth,4694419,3,84,229,313,0
3_6215773,succumb_depression_achievement_endive_saturn_earth,6215773,3,79,222,301,0
3_242885,succumb_prostatitis_achievement_wurst_saturn_earth,242885,3,88,238,326,0
3_99659,succumb_hangover_excitement_papaya_saturn_earth,99659,3,82,224,306,0
3_4654543,overcome_sciatica_intoxication_wonderbread_saturn_earth,4654543,3,87,189,276,0
3_4695684,overcome_jealousy-2_intoxication_wonderbread_saturn_earth,4695684,3,87,189,276,0
3_7507367,overcome_anxiety_love_marzipan_saturn_earth,7507367,3,122,313,435,0
3_4906264,overcome_anxiety_achievement_marzipan_saturn_earth,4906264,3,107,268,375,0
3_272773,overcome_angina_lubricity_onion_saturn_earth,272773,3,112,288,400,0
3_6252085,overcome_depression_achievement_endive_saturn_earth,6252085,3,79,223,302,0
3_3305677,overcome_hangover_love_papaya_saturn_earth,3305677,3,124,321,445,0
3_6922960,overcome_hangover_excitement_papaya_saturn_earth,6922960,3,81,224,305,0
3_4572116,overcome_anger_love_marzipan_saturn_earth,4572116,3,122,313,435,0
3_1505179,overcome_anger_achievement_marzipan_saturn_earth,1505179,3,107,268,375,0
3_279197,overcome_prostatitis_achievement_wurst_saturn_earth,279197,3,90,222,312,0
3_4140939,overcome_prostatitis_excitement_wurst_saturn_earth,4140939,3,90,236,326,0
3_260750,overcome_jealousy_love_rice_saturn_earth,260750,3,115,293,408,0
3_1017291,overcome_jealousy_achievement_rice_saturn_earth,1017291,3,111,292,403,0
3_6157934,overcome_jealousy_excitement_rice_saturn_earth,6157934,3,91,267,358,0
3_7640886,overcome_dread_love_papaya_saturn_earth,7640886,3,124,321,445,0
3_6642490,overcome_dread_excitement_papaya_saturn_earth,6642490,3,81,224,305,0
3_4671043,overcome_laceration_achievement_cherry_saturn_earth,4671043,3,91,255,346,0
3_3025569,overcome_loneliness_intoxication_potato_saturn_earth,3025569,3,94,218,312,0
3_3510554,overcome_loneliness_lubricity_potato_saturn_earth,3510554,3,116,307,423,0
3_6230834,overcome_grief_achievement_endive_saturn_earth,6230834,3,79,223,302,0
3_3904904,noop_locale_yogurt_bosnia,3904904,3,16,27,43,0
3_5254895,feast_satisfaction_yogurt_wonderbread_guanabara_bosnia,5254895,3,102,192,294,0
3_2996889,feast_satisfaction_yogurt_potato_guanabara_bosnia,2996889,3,102,192,294,0
3_505873,feast_lubricity_yogurt_wonderbread_guanabara_bosnia,505873,3,131,296,427,0
3_5305331,feast_lubricity_yogurt_potato_guanabara_bosnia,5305331,3,131,296,427,0
3_7233468,feast_rest_yogurt_wonderbread_guanabara_bosnia,7233468,3,127,297,424,0
3_3965200,feast_rest_yogurt_potato_guanabara_bosnia,3965200,3,127,297,424,0
3_4313776,feast_intoxication_yogurt_wonderbread_guanabara_bosnia,4313776,3,94,195,289,0
3_5465373,feast_intoxication_yogurt_potato_guanabara_bosnia,5465373,3,94,195,289,0
3_4913604,noop_province_surrey,4913604,3,1,1,2,0
3_7551117,noop_craves_rest_shrimp,7551117,3,127,280,407,0
3_4666379,feast_rest_shrimp_onion_bosnia_alsace,4666379,3,217,608,825,0
3_5976931,feast_rest_shrimp_onion_guanabara_bosnia,5976931,3,161,353,514,0
3_1762048,feast_rest_shrimp_onion_bavaria_guanabara,1762048,3,219,353,572,0
3_1904476,feast_rest_shrimp_turkey_bosnia_alsace,1904476,3,217,608,825,0
3_4995154,feast_rest_shrimp_turkey_guanabara_bosnia,4995154,3,161,353,514,0
3_6458400,feast_rest_shrimp_turkey_bavaria_guanabara,6458400,3,219,353,572,0
3_6656688,feast_rest_shrimp_potato_bosnia_alsace,6656688,3,217,608,825,0
3_4495508,feast_rest_shrimp_potato_guanabara_bosnia,4495508,3,161,353,514,0
3_6564656,feast_rest_shrimp_potato_bavaria_guanabara,6564656,3,219,353,572,0
3_7131947,locale_onion_alsace,7131947,3,19,40,59,0
3_1149340,craves_rest_wonderbread,1149340,3,23,41,64,0
3_2914055,harmony_rest_mercury,2914055,3,27,43,70,0
3_5863500,fears_jealousy-2_rest,5863500,3,18,26,44,0
3_5543869,noop_craves_excitement_cherry,5543869,3,89,215,304,0
3_3479644,feast_excitement_cherry_marzipan_bavaria_guanabara,3479644,3,131,294,425,0
3_3099929,feast_excitement_cherry_marzipan_bosnia_alsace,3099929,3,220,588,808,0
3_1108045,feast_excitement_cherry_marzipan_guanabara_bosnia,1108045,3,126,294,420,0
3_3000235,feast_excitement_cherry_endive_bavaria_guanabara,3000235,3,131,294,425,0
3_2960861,feast_excitement_cherry_endive_bosnia_alsace,2960861,3,220,588,808,0
3_137304,feast_excitement_cherry_endive_guanabara_bosnia,137304,3,126,294,420,0
3_4704340,feast_excitement_cherry_rice_bavaria_guanabara,4704340,3,131,294,425,0
3_2566589,feast_excitement_cherry_rice_bosnia_alsace,2566589,3,220,588,808,0
3_5363348,feast_excitement_cherry_rice_guanabara_bosnia,5363348,3,126,294,420,0
3_3206743,fears_hangover_excitement,3206743,3,15,21,36,0
3_2407942,craves_excitement_papaya,2407942,3,15,41,56,0
3_2490887,craves_excitement_rice,2490887,3,24,42,66,0
3_2366283,harmony_excitement_earth,2366283,3,25,45,70,0
3_92031,craves_excitement_wurst,92031,3,10,33,43,0
3_2441720,harmony_excitement_saturn,2441720,3,17,31,48,0
3_7477118,locale_papaya_alsace,7477118,3,15,27,42,0
3_4037416,fears_prostatitis_excitement,4037416,3,17,27,44,0
3_942615,craves_satiety_papaya,942615,3,29,40,69,0
3_4020164,fears_dread_excitement,4020164,3,15,20,35,0
3_1628909,fears_jealousy_excitement,1628909,3,16,29,45,0
3_7539959,craves_excitement_marzipan,7539959,3,29,46,75,0
3_7254354,noop_craves_satiety_mutton,7254354,3,146,264,410,0
3_2776295,feast_satiety_mutton_marzipan_bavaria_guanabara,2776295,3,156,299,455,0
3_3502772,feast_satiety_mutton_marzipan_goias_bavaria,3502772,3,226,299,525,0
3_3477698,fears_grief_satiety,3477698,3,20,34,54,0
3_2909346,fears_anger_satiety,2909346,3,20,35,55,0
3_116045,harmony_satiety_mercury,116045,3,28,44,72,0
3_4495945,craves_satiety_onion,4495945,3,29,42,71,0
3_3595641,craves_satiety_marzipan,3595641,3,34,45,79,0
3_6055786,craves_satiety_wurst,6055786,3,22,32,54,0
3_3950433,locale_endive_guanabara,3950433,3,30,11,41,0
3_1272578,locale_cherry_alsace,1272578,3,31,60,91,0
3_4866225,craves_satiety_cherry,4866225,3,29,42,71,0
3_2164069,fears_depression_satiety,2164069,3,20,33,53,0
3_2484468,fears_laceration_satiety,2484468,3,21,29,50,0
3_4891966,craves_satiety_endive,4891966,3,20,37,57,0
3_2459414,locale_marzipan_surrey,2459414,3,37,66,103,0
3_3605459,fears_jealousy_satiety,3605459,3,21,33,54,0
3_7685259,fears_anxiety_satiety,7685259,3,20,33,53,0
3_2412853,craves_satiety_haroset,2412853,3,25,28,53,0
3_2670452,craves_satiety_rice,2670452,3,31,31,62,0
3_1413190,noop_fears_anxiety_love,1413190,3,104,214,318,0
3_2928243,harmony_love_uranus,2928243,3,28,50,78,0
3_4484680,fears_jealousy_love,4484680,3,22,30,52,0
3_7323719,craves_anxiety_marzipan,7323719,3,11,18,29,0
3_3246453,fears_laceration_love,3246453,3,22,36,58,0
3_6350300,craves_love_cherry,6350300,3,31,11,42,0
3_6462913,noop_eats_marzipan_onion,6462913,3,1,1,2,0
3_7899276,feast_excitement_marzipan_onion_alsace_surrey,7899276,3,184,566,750,0
3_4944154,feast_excitement_marzipan_onion_bosnia_alsace,4944154,3,148,322,470,0
3_6023505,feast_lubricity_marzipan_onion_alsace_surrey,6023505,3,207,592,799,0
3_3068383,feast_lubricity_marzipan_onion_bosnia_alsace,3068383,3,177,357,534,0
3_6398757,feast_achievement_marzipan_onion_alsace_surrey,6398757,3,182,567,749,0
3_3443635,feast_achievement_marzipan_onion_bosnia_alsace,3443635,3,146,323,469,0
3_4224803,feast_rest_marzipan_onion_alsace_surrey,4224803,3,185,573,758,0
3_1269681,feast_rest_marzipan_onion_bosnia_alsace,1269681,3,149,358,507,0
3_6203209,feast_love_marzipan_onion_alsace_surrey,6203209,3,180,563,743,0
3_3248087,feast_love_marzipan_onion_bosnia_alsace,3248087,3,162,368,530,0
3_1902659,feast_satiety_marzipan_onion_alsace_surrey,1902659,3,174,517,691,0
3_6948514,feast_satiety_marzipan_onion_bosnia_alsace,6948514,3,156,314,470,0
3_5887254,noop_eats_marzipan_haroset,5887254,3,1,1,2,0
3_349869,feast_excitement_marzipan_haroset_alsace_surrey,349869,3,184,566,750,0
3_5395724,feast_excitement_marzipan_haroset_bosnia_alsace,5395724,3,148,322,470,0
3_4833218,feast_lubricity_marzipan_haroset_alsace_surrey,4833218,3,207,592,799,0
3_1878096,feast_lubricity_marzipan_haroset_bosnia_alsace,1878096,3,177,357,534,0
3_2344992,feast_achievement_marzipan_haroset_alsace_surrey,2344992,3,182,567,749,0
3_7390847,feast_achievement_marzipan_haroset_bosnia_alsace,7390847,3,146,323,469,0
3_3493087,feast_rest_marzipan_haroset_alsace_surrey,3493087,3,185,573,758,0
3_537965,feast_rest_marzipan_haroset_bosnia_alsace,537965,3,149,358,507,0
3_4476418,feast_love_marzipan_haroset_alsace_surrey,4476418,3,180,563,743,0
3_1521296,feast_love_marzipan_haroset_bosnia_alsace,1521296,3,162,368,530,0
3_6047420,feast_satiety_marzipan_haroset_alsace_surrey,6047420,3,174,517,691,0
3_3092298,feast_satiety_marzipan_haroset_bosnia_alsace,3092298,3,156,314,470,0
3_496858,noop_pain_boils-1,496858,3,1,1,2,0
3_2781132,succumb_boils-1_satisfaction_arugula_mercury_saturn,2781132,3,107,241,348,0
3_6615081,overcome_boils-1_rest_arugula_mercury_saturn,6615081,3,128,315,443,0
3_4076027,overcome_boils-1_satisfaction_arugula_mercury_saturn,4076027,3,109,204,313,0
3_1903589,noop_food_ham,1903589,3,1,1,2,0
3_7507245,succumb_loneliness-3_rest_ham_mercury_saturn,7507245,3,98,267,365,0
3_1727488,feast_rest_onion_ham_guanabara_bosnia,1727488,3,124,311,435,0
3_5995026,feast_rest_onion_ham_bosnia_alsace,5995026,3,143,418,561,0
3_5241834,feast_satisfaction_onion_ham_guanabara_bosnia,5241834,3,124,272,396,0
3_1522582,feast_satisfaction_onion_ham_bosnia_alsace,1522582,3,154,376,530,0
3_2437810,feast_love_onion_ham_guanabara_bosnia,2437810,3,178,390,568,0
3_1059112,feast_love_onion_ham_bosnia_alsace,1059112,3,206,501,707,0
3_1140983,feast_satisfaction_wonderbread_ham_bosnia_alsace,1140983,3,121,275,396,0
3_3665438,feast_intoxication_ham_onion_bavaria_guanabara,3665438,3,173,439,612,0
3_686136,feast_intoxication_ham_onion_goias_bavaria,686136,3,115,217,332,0
3_6455828,feast_intoxication_ham_mutton_bavaria_guanabara,6455828,3,173,439,612,0
3_4947099,feast_intoxication_ham_mutton_goias_bavaria,4947099,3,115,217,332,0
3_7065083,feast_intoxication_ham_wonderbread_bavaria_guanabara,7065083,3,173,439,612,0
3_6107414,feast_intoxication_ham_wonderbread_goias_bavaria,6107414,3,115,217,332,0
3_4577717,feast_lubricity_onion_ham_guanabara_bosnia,4577717,3,127,322,449,0
3_4680578,feast_lubricity_onion_ham_bosnia_alsace,4680578,3,135,386,521,0
3_2926233,feast_rest_wonderbread_ham_bosnia_alsace,2926233,3,117,304,421,0
3_3561603,feast_rest_ham_onion_bavaria_guanabara,3561603,3,106,291,397,0
3_3516386,feast_rest_ham_onion_goias_bavaria,3516386,3,101,282,383,0
3_3876999,feast_rest_ham_mutton_bavaria_guanabara,3876999,3,106,291,397,0
3_1402192,feast_rest_ham_mutton_goias_bavaria,1402192,3,101,282,383,0
3_1961477,feast_rest_ham_wonderbread_bavaria_guanabara,1961477,3,106,291,397,0
3_2007304,feast_rest_ham_wonderbread_goias_bavaria,2007304,3,101,282,383,0
3_504647,feast_satiety_onion_ham_guanabara_bosnia,504647,3,172,337,509,0
3_614292,feast_satiety_onion_ham_bosnia_alsace,614292,3,200,448,648,0
3_5131320,feast_lubricity_ham_onion_bavaria_guanabara,5131320,3,200,544,744,0
3_2201938,feast_lubricity_ham_onion_goias_bavaria,2201938,3,139,319,458,0
3_5675701,feast_lubricity_ham_mutton_bavaria_guanabara,5675701,3,200,544,744,0
3_944538,feast_lubricity_ham_mutton_goias_bavaria,944538,3,139,319,458,0
3_3734418,feast_lubricity_ham_wonderbread_bavaria_guanabara,3734418,3,200,544,744,0
3_6419327,feast_lubricity_ham_wonderbread_goias_bavaria,6419327,3,139,319,458,0
3_7026343,feast_intoxication_wonderbread_ham_bosnia_alsace,7026343,3,104,231,335,0
3_5941935,overcome_loneliness-3_rest_ham_mercury_saturn,5941935,3,95,267,362,0
3_1992768,noop_craves_satisfaction_yogurt,1992768,3,86,164,250,0
3_2954263,succumb_loneliness_satisfaction_yogurt_mercury_saturn,2954263,3,114,202,316,0
3_6315474,succumb_abrasion_satisfaction_yogurt_mercury_saturn,6315474,3,102,222,324,0
3_7610369,overcome_abrasion_satisfaction_yogurt_mercury_saturn,7610369,3,104,186,290,0
3_2178943,locale_shrimp_guanabara,2178943,3,36,21,57,0
3_975900,craves_satisfaction_turkey,975900,3,19,7,26,0
3_4815813,noop_craves_satiety_rice,4815813,3,96,211,307,0
3_7099223,succumb_jealousy_satiety_rice_mercury_saturn,7099223,3,121,303,424,0
3_2829527,succumb_laceration_satiety_rice_mercury_saturn,2829527,3,128,265,393,0
3_2732655,feast_satiety_rice_papaya_bavaria_guanabara,2732655,3,140,286,426,0
3_4373908,feast_satiety_rice_papaya_bosnia_alsace,4373908,3,232,618,850,0
3_4011732,feast_satiety_rice_papaya_guanabara_bosnia,4011732,3,135,286,421,0
3_3178308,feast_satiety_rice_marzipan_bavaria_guanabara,3178308,3,140,286,426,0
3_592492,feast_satiety_rice_marzipan_bosnia_alsace,592492,3,232,618,850,0
3_5857448,feast_satiety_rice_marzipan_guanabara_bosnia,5857448,3,135,286,421,0
3_2683688,feast_satiety_rice_cherry_bavaria_guanabara,2683688,3,140,286,426,0
3_2111311,feast_satiety_rice_cherry_bosnia_alsace,2111311,3,232,618,850,0
3_729890,feast_satiety_rice_cherry_guanabara_bosnia,729890,3,135,286,421,0
3_5533913,overcome_jealousy_satiety_rice_mercury_saturn,5533913,3,123,285,408,0
3_2043702,craves_satiety_mutton,2043702,3,27,31,58,0
3_176606,noop_craves_satiety_haroset,176606,3,144,260,404,0
3_4456544,feast_satiety_haroset_marzipan_bavaria_guanabara,4456544,3,155,300,455,0
3_93129,feast_satiety_haroset_turkey_bavaria_guanabara,93129,3,155,300,455,0
3_5255227,overcome_laceration-8_satiety_haroset_mercury_saturn,5255227,3,156,289,445,0
3_6094164,noop_fears_sciatica_rest,6094164,3,95,254,349,0
3_5273458,succumb_sciatica_rest_wonderbread_mercury_saturn,5273458,3,108,287,395,0
3_6255097,craves_sciatica_wonderbread,6255097,3,8,9,17,0
3_456128,noop_fears_laceration_love,456128,3,110,273,383,0
3_3324635,craves_laceration_cherry,3324635,3,12,17,29,0
3_562209,fears_laceration_achievement,562209,3,16,28,44,0
3_1016330,noop_pleasure_love,1016330,3,1,1,2,0
3_5830254,feast_love_onion_marzipan_guanabara_bosnia,5830254,3,178,390,568,0
3_2491540,feast_love_onion_marzipan_bosnia_alsace,2491540,3,206,501,707,0
3_87961,feast_love_onion_shrimp_guanabara_bosnia,87961,3,178,390,568,0
3_7860087,feast_love_onion_shrimp_bosnia_alsace,7860087,3,206,501,707,0
3_5346619,feast_love_mutton_marzipan_bavaria_guanabara,5346619,3,162,352,514,0
3_308746,feast_love_mutton_marzipan_goias_bavaria,308746,3,232,352,584,0
3_1897884,feast_love_marzipan_mutton_alsace_surrey,1897884,3,180,563,743,0
3_6943739,feast_love_marzipan_mutton_bosnia_alsace,6943739,3,162,368,530,0
3_7626089,feast_love_marzipan_rice_alsace_surrey,7626089,3,180,563,743,0
3_4670967,feast_love_marzipan_rice_bosnia_alsace,4670967,3,162,368,530,0
3_7426818,feast_love_marzipan_cherry_alsace_surrey,7426818,3,180,563,743,0
3_4471696,feast_love_marzipan_cherry_bosnia_alsace,4471696,3,162,368,530,0
3_6379374,feast_love_haroset_marzipan_bavaria_guanabara,6379374,3,161,353,514,0
3_7479070,feast_love_haroset_turkey_bavaria_guanabara,7479070,3,161,353,514,0
3_7539606,feast_love_rice_papaya_bavaria_guanabara,7539606,3,128,331,459,0
3_537240,feast_love_rice_papaya_bosnia_alsace,537240,3,163,460,623,0
3_311305,feast_love_rice_papaya_guanabara_bosnia,311305,3,127,331,458,0
3_1050646,feast_love_rice_marzipan_bavaria_guanabara,1050646,3,128,331,459,0
3_7422623,feast_love_rice_marzipan_bosnia_alsace,7422623,3,163,460,623,0
3_4286446,feast_love_rice_marzipan_guanabara_bosnia,4286446,3,127,331,458,0
3_7490639,feast_love_rice_cherry_bavaria_guanabara,7490639,3,128,331,459,0
3_6275620,feast_love_rice_cherry_bosnia_alsace,6275620,3,163,460,623,0
3_5030440,feast_love_rice_cherry_guanabara_bosnia,5030440,3,127,331,458,0
3_1320041,feast_love_papaya_rice_bosnia_alsace,1320041,3,164,471,635,0
3_2074717,feast_love_papaya_rice_guanabara_bosnia,2074717,3,120,308,428,0
3_7099199,feast_love_papaya_wurst_bosnia_alsace,7099199,3,164,471,635,0
3_566584,feast_love_papaya_wurst_guanabara_bosnia,566584,3,120,308,428,0
3_4914153,feast_love_endive_cherry_bavaria_guanabara,4914153,3,234,337,571,0
3_7144114,feast_love_endive_cherry_bosnia_alsace,7144114,3,180,501,681,0
3_1207410,feast_love_endive_cherry_guanabara_bosnia,1207410,3,158,337,495,0
3_937812,feast_love_endive_wurst_bavaria_guanabara,937812,3,234,337,571,0
3_4779159,feast_love_endive_wurst_bosnia_alsace,4779159,3,180,501,681,0
3_5348635,feast_love_endive_wurst_guanabara_bosnia,5348635,3,158,337,495,0
3_5915405,noop_craves_rest_onion,5915405,3,88,235,323,0
3_6471092,succumb_loneliness-3_rest_onion_mercury_saturn,6471092,3,105,283,388,0
3_3681945,succumb_angina_rest_onion_mercury_saturn,3681945,3,110,296,406,0
3_2127805,feast_rest_onion_marzipan_guanabara_bosnia,2127805,3,124,311,435,0
3_513134,feast_rest_onion_marzipan_bosnia_alsace,513134,3,143,418,561,0
3_5678553,feast_rest_onion_shrimp_guanabara_bosnia,5678553,3,124,311,435,0
3_7149765,feast_rest_onion_shrimp_bosnia_alsace,7149765,3,143,418,561,0
3_4026357,overcome_angina_rest_onion_mercury_saturn,4026357,3,112,273,385,0
3_5648606,noop_locale_rice_guanabara,5648606,3,44,76,120,0
3_1679023,feast_excitement_rice_papaya_bavaria_guanabara,1679023,3,110,260,370,0
3_783066,feast_excitement_rice_marzipan_bavaria_guanabara,783066,3,110,260,370,0
3_1630056,feast_excitement_rice_cherry_bavaria_guanabara,1630056,3,110,260,370,0
3_1593055,feast_achievement_rice_papaya_bavaria_guanabara,1593055,3,129,295,424,0
3_7473003,feast_achievement_rice_marzipan_bavaria_guanabara,7473003,3,129,295,424,0
3_1544088,feast_achievement_rice_cherry_bavaria_guanabara,1544088,3,129,295,424,0
3_6090059,locale_rice_bosnia,6090059,3,26,19,45,0
3_5424666,noop_eats_yogurt_wonderbread,5424666,3,1,1,2,0
3_1342175,feast_lubricity_yogurt_wonderbread_bavaria_guanabara,1342175,3,176,296,472,0
3_3396440,feast_rest_yogurt_wonderbread_bavaria_guanabara,3396440,3,188,297,485,0
3_46149,feast_intoxication_yogurt_wonderbread_bavaria_guanabara,46149,3,150,195,345,0
3_2227981,noop_food_marzipan,2227981,3,1,1,2,0
3_7635499,succumb_anxiety_satiety_marzipan_mercury_saturn,7635499,3,117,275,392,0
3_4128319,succumb_laceration_satiety_marzipan_mercury_saturn,4128319,3,128,265,393,0
3_1250244,succumb_anger_satiety_marzipan_mercury_saturn,1250244,3,117,275,392,0
3_5654207,feast_achievement_cherry_marzipan_bavaria_guanabara,5654207,3,108,261,369,0
3_3013961,feast_achievement_cherry_marzipan_bosnia_alsace,3013961,3,182,477,659,0
3_1522839,feast_achievement_cherry_marzipan_guanabara_bosnia,1522839,3,103,261,364,0
3_2270476,feast_satisfaction_onion_marzipan_guanabara_bosnia,2270476,3,124,272,396,0
3_568668,feast_satisfaction_onion_marzipan_bosnia_alsace,568668,3,154,376,530,0
3_4038278,feast_excitement_marzipan_mutton_alsace_surrey,4038278,3,184,566,750,0
3_1083156,feast_excitement_marzipan_mutton_bosnia_alsace,1083156,3,148,322,470,0
3_1038159,feast_excitement_marzipan_rice_alsace_surrey,1038159,3,184,566,750,0
3_6084014,feast_excitement_marzipan_rice_bosnia_alsace,6084014,3,148,322,470,0
3_1566235,feast_excitement_marzipan_cherry_alsace_surrey,1566235,3,184,566,750,0
3_6612090,feast_excitement_marzipan_cherry_bosnia_alsace,6612090,3,148,322,470,0
3_3899522,feast_lubricity_marzipan_mutton_alsace_surrey,3899522,3,207,592,799,0
3_944400,feast_lubricity_marzipan_mutton_bosnia_alsace,944400,3,177,357,534,0
3_3374868,feast_lubricity_marzipan_rice_alsace_surrey,3374868,3,207,592,799,0
3_419746,feast_lubricity_marzipan_rice_bosnia_alsace,419746,3,177,357,534,0
3_1427479,feast_lubricity_marzipan_cherry_alsace_surrey,1427479,3,207,592,799,0
3_6473334,feast_lubricity_marzipan_cherry_bosnia_alsace,6473334,3,177,357,534,0
3_3952310,feast_achievement_marzipan_mutton_alsace_surrey,3952310,3,182,567,749,0
3_997188,feast_achievement_marzipan_mutton_bosnia_alsace,997188,3,146,323,469,0
3_6751746,feast_achievement_marzipan_rice_alsace_surrey,6751746,3,182,567,749,0
3_3796624,feast_achievement_marzipan_rice_bosnia_alsace,3796624,3,146,323,469,0
3_1480267,feast_achievement_marzipan_cherry_alsace_surrey,1480267,3,182,567,749,0
3_6526122,feast_achievement_marzipan_cherry_bosnia_alsace,6526122,3,146,323,469,0
3_6891593,feast_satiety_cherry_marzipan_bavaria_guanabara,6891593,3,122,279,401,0
3_4153561,feast_satiety_cherry_marzipan_bosnia_alsace,4153561,3,157,414,571,0
3_6215745,feast_satiety_cherry_marzipan_guanabara_bosnia,6215745,3,121,279,400,0
3_7488476,feast_rest_marzipan_mutton_alsace_surrey,7488476,3,185,573,758,0
3_4533354,feast_rest_marzipan_mutton_bosnia_alsace,4533354,3,149,358,507,0
3_1805151,feast_rest_marzipan_rice_alsace_surrey,1805151,3,185,573,758,0
3_6851006,feast_rest_marzipan_rice_bosnia_alsace,6851006,3,149,358,507,0
3_5016433,feast_rest_marzipan_cherry_alsace_surrey,5016433,3,185,573,758,0
3_2061311,feast_rest_marzipan_cherry_bosnia_alsace,2061311,3,149,358,507,0
3_7278434,feast_rest_mutton_marzipan_bavaria_guanabara,7278434,3,104,279,383,0
3_1159330,feast_lubricity_onion_marzipan_guanabara_bosnia,1159330,3,127,322,449,0
3_2311836,feast_lubricity_onion_marzipan_bosnia_alsace,2311836,3,135,386,521,0
3_834693,feast_excitement_rice_marzipan_bosnia_alsace,834693,3,189,514,703,0
3_159897,feast_excitement_rice_marzipan_guanabara_bosnia,159897,3,105,260,365,0
3_2680647,feast_lubricity_haroset_marzipan_bavaria_guanabara,2680647,3,111,297,408,0
3_5091910,feast_satiety_marzipan_mutton_alsace_surrey,5091910,3,174,517,691,0
3_2136788,feast_satiety_marzipan_mutton_bosnia_alsace,2136788,3,156,314,470,0
3_795958,feast_satiety_marzipan_rice_alsace_surrey,795958,3,174,517,691,0
3_5841813,feast_satiety_marzipan_rice_bosnia_alsace,5841813,3,156,314,470,0
3_2619867,feast_satiety_marzipan_cherry_alsace_surrey,2619867,3,174,517,691,0
3_7665722,feast_satiety_marzipan_cherry_bosnia_alsace,7665722,3,156,314,470,0
3_7957916,feast_satiety_onion_marzipan_guanabara_bosnia,7957916,3,172,337,509,0
3_6191967,feast_satiety_onion_marzipan_bosnia_alsace,6191967,3,200,448,648,0
3_6548280,feast_achievement_rice_marzipan_bosnia_alsace,6548280,3,223,621,844,0
3_2155020,feast_achievement_rice_marzipan_guanabara_bosnia,2155020,3,124,295,419,0
3_1189353,overcome_anxiety_rest_marzipan_mercury_saturn,1189353,3,110,306,416,0
3_6457823,overcome_anxiety_satiety_marzipan_mercury_saturn,6457823,3,119,256,375,0
3_4069828,overcome_anger_rest_marzipan_mercury_saturn,4069828,3,110,306,416,0
3_579734,overcome_anger_satiety_marzipan_mercury_saturn,579734,3,119,256,375,0
3_2231879,noop_fears_boils_lubricity,2231879,3,72,147,219,0
3_1682327,craves_boils_shrimp,1682327,3,9,16,25,0
3_2249450,fears_angina_lubricity,2249450,3,18,6,24,0
3_6280431,noop_craves_achievement_cherry,6280431,3,62,180,242,0
3_1689195,feast_achievement_cherry_endive_bavaria_guanabara,1689195,3,108,261,369,0
3_673471,feast_achievement_cherry_endive_bosnia_alsace,673471,3,182,477,659,0
3_2132427,feast_achievement_cherry_endive_guanabara_bosnia,2132427,3,103,261,364,0
3_4618372,feast_achievement_cherry_rice_bavaria_guanabara,4618372,3,108,261,369,0
3_1277090,feast_achievement_cherry_rice_bosnia_alsace,1277090,3,182,477,659,0
3_3862829,feast_achievement_cherry_rice_guanabara_bosnia,3862829,3,103,261,364,0
3_1622416,overcome_laceration_achievement_cherry_mercury_saturn,1622416,3,89,273,362,0
3_4271646,craves_achievement_rice,4271646,3,27,44,71,0
3_863045,locale_endive_alsace,863045,3,15,29,44,0
3_7928595,craves_achievement_endive,7928595,3,15,38,53,0
3_3545441,fears_prostatitis_achievement,3545441,3,17,26,43,0
3_7911623,craves_achievement_wurst,7911623,3,10,30,40,0
3_4046367,harmony_achievement_mercury,4046367,3,15,21,36,0
3_3812864,craves_achievement_marzipan,3812864,3,29,47,76,0
3_7565557,noop_craves_depression-7_haroset,7565557,3,4,16,20,0
3_7106972,noop_eats_arugula_wonderbread,7106972,3,1,1,2,0
3_5307194,feast_lubricity_arugula_wonderbread_bosnia_alsace,5307194,3,138,303,441,0
3_261339,feast_lubricity_arugula_wonderbread_alsace_surrey,261339,3,181,438,619,0
3_830600,feast_lubricity_arugula_wonderbread_guanabara_bosnia,830600,3,185,303,488,0
3_478796,feast_satisfaction_arugula_wonderbread_bosnia_alsace,478796,3,109,198,307,0
3_3433918,feast_satisfaction_arugula_wonderbread_alsace_surrey,3433918,3,158,339,497,0
3_3534253,feast_rest_arugula_wonderbread_bosnia_alsace,3534253,3,134,304,438,0
3_6489375,feast_rest_arugula_wonderbread_alsace_surrey,6489375,3,179,436,615,0
3_2884865,feast_rest_arugula_wonderbread_guanabara_bosnia,2884865,3,197,304,501,0
3_7971067,noop_locale_mutton_guanabara,7971067,3,12,31,43,0
3_3651421,noop_food_papaya,3651421,3,1,1,2,0
3_5156709,feast_satiety_papaya_rice_bosnia_alsace,5156709,3,174,448,622,0
3_6111415,feast_satiety_papaya_rice_bavaria_guanabara,6111415,3,236,284,520,0
3_5775144,feast_satiety_papaya_rice_guanabara_bosnia,5775144,3,152,284,436,0
3_5166036,feast_satiety_papaya_wurst_bosnia_alsace,5166036,3,174,448,622,0
3_2453239,feast_satiety_papaya_wurst_bavaria_guanabara,2453239,3,236,284,520,0
3_3760610,feast_satiety_papaya_wurst_guanabara_bosnia,3760610,3,152,284,436,0
3_6318363,feast_excitement_rice_papaya_bosnia_alsace,6318363,3,189,514,703,0
3_2007372,feast_excitement_rice_papaya_guanabara_bosnia,2007372,3,105,260,365,0
3_7101164,feast_excitement_papaya_rice_bosnia_alsace,7101164,3,85,237,322,0
3_5057783,feast_excitement_papaya_rice_bavaria_guanabara,5057783,3,172,234,406,0
3_3770784,feast_excitement_papaya_rice_guanabara_bosnia,3770784,3,83,234,317,0
3_6885942,feast_excitement_papaya_wurst_bosnia_alsace,6885942,3,85,237,322,0
3_4756665,feast_excitement_papaya_wurst_bavaria_guanabara,4756665,3,172,234,406,0
3_2706978,feast_excitement_papaya_wurst_guanabara_bosnia,2706978,3,83,234,317,0
3_5028864,feast_achievement_rice_papaya_bosnia_alsace,5028864,3,223,621,844,0
3_506853,feast_achievement_rice_papaya_guanabara_bosnia,506853,3,124,295,419,0
3_5234163,overcome_hangover_excitement_papaya_mercury_saturn,5234163,3,84,224,308,0
3_386897,overcome_hangover_satiety_papaya_mercury_saturn,386897,3,154,302,456,0
3_2596412,overcome_dread_excitement_papaya_mercury_saturn,2596412,3,84,224,308,0
3_6073996,overcome_dread_satiety_papaya_mercury_saturn,6073996,3,154,302,456,0
3_7577871,noop_fears_prostatitis_entertainment,7577871,3,15,27,42,0
3_3477531,harmony_entertainment_uranus,3477531,3,4,7,11,0
3_4565062,craves_prostatitis_wurst,4565062,3,14,14,28,0
3_59058,noop_harmony_rest_mercury,59058,3,61,166,227,0
3_3921616,succumb_loneliness-3_rest_mutton_mercury_saturn,3921616,3,105,283,388,0
3_3977670,succumb_loneliness-3_rest_wonderbread_mercury_saturn,3977670,3,105,283,388,0
3_1525959,noop_eats_marzipan_mutton,1525959,3,1,1,2,0
3_2967144,noop_eats_ham_onion,2967144,3,1,1,2,0
3_7600772,noop_food_endive,7600772,3,1,1,2,0
3_5693854,succumb_laceration_satiety_endive_mercury_saturn,5693854,3,128,265,393,0
3_2523863,succumb_depression_satiety_endive_mercury_saturn,2523863,3,117,285,402,0
3_4780916,succumb_grief_achievement_endive_mercury_saturn,4780916,3,79,222,301,0
3_685715,succumb_depression_achievement_endive_mercury_saturn,685715,3,79,222,301,0
3_4537425,succumb_grief_satiety_endive_mercury_saturn,4537425,3,117,285,402,0
3_313983,feast_satiety_endive_cherry_bosnia_alsace,313983,3,158,430,588,0
3_2778412,feast_satiety_endive_cherry_guanabara_bosnia,2778412,3,114,256,370,0
3_2845996,feast_satiety_endive_wurst_bosnia_alsace,2845996,3,158,430,588,0
3_541684,feast_satiety_endive_wurst_guanabara_bosnia,541684,3,114,256,370,0
3_5395477,feast_satiety_cherry_endive_bavaria_guanabara,5395477,3,122,279,401,0
3_2718660,feast_satiety_cherry_endive_bosnia_alsace,2718660,3,157,414,571,0
3_5834855,feast_satiety_cherry_endive_guanabara_bosnia,5834855,3,121,279,400,0
3_3335533,feast_achievement_endive_cherry_bavaria_guanabara,3335533,3,164,236,400,0
3_6269771,feast_achievement_endive_cherry_bosnia_alsace,6269771,3,83,239,322,0
3_7076961,feast_achievement_endive_cherry_guanabara_bosnia,7076961,3,81,236,317,0
3_6807363,feast_achievement_endive_wurst_bavaria_guanabara,6807363,3,164,236,400,0
3_2494215,feast_achievement_endive_wurst_bosnia_alsace,2494215,3,83,239,322,0
3_7403061,feast_achievement_endive_wurst_guanabara_bosnia,7403061,3,81,236,317,0
3_4138778,overcome_depression_achievement_endive_mercury_saturn,4138778,3,78,222,300,0
3_5075933,overcome_depression_satiety_endive_mercury_saturn,5075933,3,119,272,391,0
3_3603240,overcome_grief_achievement_endive_mercury_saturn,3603240,3,78,222,300,0
3_5468925,overcome_grief_satiety_endive_mercury_saturn,5468925,3,119,272,391,0
3_7774906,noop_fears_loneliness_satisfaction,7774906,3,79,127,206,0
3_4806077,succumb_loneliness_satisfaction_shrimp_mercury_saturn,4806077,3,114,202,316,0
3_6975880,succumb_loneliness_satisfaction_arugula_mercury_saturn,6975880,3,114,202,316,0
3_5511802,succumb_loneliness_satisfaction_potato_mercury_saturn,5511802,3,107,192,299,0
3_3037449,locale_potato_bavaria,3037449,3,21,15,36,0
3_1112071,craves_loneliness_potato,1112071,3,11,13,24,0
3_131867,harmony_satisfaction_saturn,131867,3,19,35,54,0
3_6559561,noop_craves_satisfaction_onion,6559561,3,91,196,287,0
3_3893303,feast_satisfaction_onion_shrimp_guanabara_bosnia,3893303,3,124,272,396,0
3_2663134,feast_satisfaction_onion_shrimp_bosnia_alsace,2663134,3,154,376,530,0
3_1477938,overcome_angina_satisfaction_onion_mercury_saturn,1477938,3,110,237,347,0
3_7344507,noop_craves_jealousy-2_wonderbread,7344507,3,9,21,30,0
3_4810659,overcome_jealousy-2_rest_wonderbread_mercury_saturn,4810659,3,110,274,384,0
3_1155004,overcome_jealousy-2_satisfaction_wonderbread_mercury_saturn,1155004,3,94,214,308,0
3_5024368,noop_craves_grief_endive,5024368,3,12,47,59,0
3_3723475,fears_grief_achievement,3723475,3,14,25,39,0
3_6912487,noop_locale_shrimp_alsace,6912487,3,120,358,478,0
3_7323359,feast_intoxication_shrimp_onion_bosnia_alsace,7323359,3,195,515,710,0
3_2008311,feast_intoxication_shrimp_turkey_bosnia_alsace,2008311,3,195,515,710,0
3_6760523,feast_intoxication_shrimp_potato_bosnia_alsace,6760523,3,195,515,710,0
3_179748,feast_satisfaction_shrimp_onion_bosnia_alsace,179748,3,181,455,636,0
3_5467628,feast_satisfaction_shrimp_turkey_bosnia_alsace,5467628,3,181,455,636,0
3_2218863,feast_satisfaction_shrimp_potato_bosnia_alsace,2218863,3,181,455,636,0
3_7516608,feast_lubricity_shrimp_onion_bosnia_alsace,7516608,3,130,370,500,0
3_3474193,feast_lubricity_shrimp_turkey_bosnia_alsace,3474193,3,130,370,500,0
3_225428,feast_lubricity_shrimp_potato_bosnia_alsace,225428,3,130,370,500,0
3_2335886,craves_lubricity_onion,2335886,3,24,47,71,0
3_7315407,locale_shrimp_bosnia,7315407,3,26,16,42,0
3_4460410,noop_locale_shrimp_bosnia,4460410,3,36,76,112,0
3_2076064,feast_intoxication_shrimp_onion_guanabara_bosnia,2076064,3,128,250,378,0
3_6495327,feast_intoxication_shrimp_turkey_guanabara_bosnia,6495327,3,128,250,378,0
3_5995681,feast_intoxication_shrimp_potato_guanabara_bosnia,5995681,3,128,250,378,0
3_4191681,feast_satisfaction_shrimp_onion_guanabara_bosnia,4191681,3,115,232,347,0
3_4026843,feast_satisfaction_shrimp_turkey_guanabara_bosnia,4026843,3,115,232,347,0
3_3527197,feast_satisfaction_shrimp_potato_guanabara_bosnia,3527197,3,115,232,347,0
3_2387977,feast_lubricity_shrimp_onion_guanabara_bosnia,2387977,3,118,312,430,0
3_6335285,feast_lubricity_shrimp_turkey_guanabara_bosnia,6335285,3,118,312,430,0
3_5835639,feast_lubricity_shrimp_potato_guanabara_bosnia,5835639,3,118,312,430,0
3_1264033,noop_craves_love_wurst,1264033,3,107,269,376,0
3_4864290,harmony_love_earth,4864290,3,34,73,107,0
3_249498,noop_craves_excitement_marzipan,249498,3,88,213,301,0
3_6331552,craves_excitement_cherry,6331552,3,27,30,57,0
3_4894934,noop_fears_anxiety_satiety,4894934,3,100,213,313,0
3_4531615,harmony_satiety_saturn,4531615,3,28,46,74,0
3_6486,noop_fears_jealousy_excitement,6486,3,75,190,265,0
3_3282766,craves_jealousy_rice,3282766,3,12,16,28,0
3_3516611,harmony_excitement_uranus,3516611,3,21,38,59,0
3_1369212,noop_fears_jealousy_satiety,1369212,3,105,252,357,0
3_7253622,noop_fears_laceration_achievement,7253622,3,73,199,272,0
3_3962347,harmony_achievement_earth,3962347,3,21,48,69,0
3_1976428,fears_depression_achievement,1976428,3,14,25,39,0
3_4518774,noop_locale_rice_alsace,4518774,3,153,442,595,0
3_4055766,feast_excitement_rice_cherry_bosnia_alsace,4055766,3,189,514,703,0
3_2766267,feast_achievement_rice_cherry_bosnia_alsace,2766267,3,223,621,844,0
3_437954,locale_rice_guanabara,437954,3,27,15,42,0
3_6272389,noop_locale_ham_guanabara,6272389,3,95,283,378,0
3_3967861,locale_ham_bavaria,3967861,3,19,20,39,0
3_5342989,noop_eats_wonderbread_ham,5342989,3,1,1,2,0
3_3800886,noop_pain_sciatica,3800886,3,1,1,2,0
3_7825528,overcome_sciatica_rest_wonderbread_mercury_saturn,7825528,3,110,274,384,0
3_1267677,overcome_sciatica_satisfaction_wonderbread_mercury_saturn,1267677,3,94,214,308,0
3_1066285,noop_pain_jealousy-2,1066285,3,1,1,2,0
3_3833315,noop_food_arugula,3833315,3,1,1,2,0
3_3784536,feast_lubricity_arugula_potato_bosnia_alsace,3784536,3,138,303,441,0
3_6739658,feast_lubricity_arugula_potato_alsace_surrey,6739658,3,181,438,619,0
3_6090784,feast_lubricity_arugula_potato_guanabara_bosnia,6090784,3,185,303,488,0
3_2041368,feast_satisfaction_arugula_potato_bosnia_alsace,2041368,3,109,198,307,0
3_4996490,feast_satisfaction_arugula_potato_alsace_surrey,4996490,3,158,339,497,0
3_4919884,feast_satisfaction_wonderbread_arugula_bosnia_alsace,4919884,3,121,275,396,0
3_7467524,feast_satisfaction_potato_arugula_bavaria_guanabara,7467524,3,86,196,282,0
3_7874447,feast_satisfaction_potato_arugula_guanabara_bosnia,7874447,3,128,273,401,0
3_6881144,feast_satisfaction_potato_arugula_goias_bavaria,6881144,3,87,196,283,0
3_7975341,feast_rest_wonderbread_arugula_bosnia_alsace,7975341,3,117,304,421,0
3_3048343,feast_lubricity_potato_arugula_bavaria_guanabara,3048343,3,122,290,412,0
3_6763301,feast_lubricity_potato_arugula_guanabara_bosnia,6763301,3,188,468,656,0
3_623335,feast_lubricity_potato_arugula_goias_bavaria,623335,3,127,290,417,0
3_1985834,feast_rest_arugula_potato_bosnia_alsace,1985834,3,134,304,438,0
3_4940956,feast_rest_arugula_potato_alsace_surrey,4940956,3,179,436,615,0
3_7059259,feast_rest_arugula_potato_guanabara_bosnia,7059259,3,197,304,501,0
3_2280008,feast_intoxication_potato_arugula_bavaria_guanabara,2280008,3,100,201,301,0
3_7729168,feast_intoxication_potato_arugula_guanabara_bosnia,7729168,3,170,387,557,0
3_1403462,feast_intoxication_potato_arugula_goias_bavaria,1403462,3,105,201,306,0
3_5077970,feast_intoxication_wonderbread_arugula_bosnia_alsace,5077970,3,104,231,335,0
3_2066697,noop_locale_rice_bosnia,2066697,3,39,76,115,0
3_6726507,feast_excitement_rice_cherry_guanabara_bosnia,6726507,3,105,260,365,0
3_5225988,feast_achievement_rice_cherry_guanabara_bosnia,5225988,3,124,295,419,0
3_2799837,noop_craves_lubricity_marzipan,2799837,3,117,249,366,0
3_4944137,harmony_lubricity_earth,4944137,3,27,53,80,0
3_4847635,noop_eats_wurst_papaya,4847635,3,1,1,2,0
3_6772543,noop_pain_anxiety,6772543,3,1,1,2,0
3_3752572,noop_locale_turkey_goias,3752572,3,88,33,121,0
3_1024883,locale_turkey_bavaria,1024883,3,6,16,22,0
3_1894188,noop_harmony_excitement_uranus,1894188,3,30,93,123,0
3_7945476,noop_locale_ham_bavaria,7945476,3,20,39,59,0
3_4148623,noop_craves_lubricity_turkey,4148623,3,95,256,351,0
3_7214256,feast_lubricity_turkey_haroset_goias_bavaria,7214256,3,105,280,385,0
3_7540328,noop_craves_intoxication_shrimp,7540328,3,94,176,270,0
3_3262221,feast_intoxication_shrimp_onion_bavaria_guanabara,3262221,3,170,250,420,0
3_6455792,feast_intoxication_shrimp_turkey_bavaria_guanabara,6455792,3,170,250,420,0
3_6562048,feast_intoxication_shrimp_potato_bavaria_guanabara,6562048,3,170,250,420,0
3_6161127,locale_arugula_surrey,6161127,3,18,27,45,0
3_4203350,craves_intoxication_arugula,4203350,3,19,6,25,0
3_3777379,noop_craves_prostatitis_wurst,3777379,3,15,27,42,0
3_4749558,overcome_prostatitis_achievement_wurst_mercury_saturn,4749558,3,88,238,326,0
3_7759180,overcome_prostatitis_satiety_wurst_mercury_saturn,7759180,3,124,262,386,0
3_3616283,harmony_entertainment_earth,3616283,3,6,11,17,0
3_2810155,fears_prostatitis_entertainment,2810155,3,6,5,11,0
3_5011789,noop_pleasure_rest,5011789,3,1,1,2,0
3_6822417,feast_rest_yogurt_potato_bavaria_guanabara,6822417,3,188,297,485,0
3_1244925,feast_rest_wonderbread_yogurt_bosnia_alsace,1244925,3,117,304,421,0
3_4942809,overcome_abrasion_rest_yogurt_mercury_saturn,4942809,3,123,296,419,0
3_6922128,noop_food_shrimp,6922128,3,1,1,2,0
3_3102179,feast_lubricity_shrimp_onion_bavaria_guanabara,3102179,3,169,312,481,0
3_5489925,feast_lubricity_shrimp_turkey_bavaria_guanabara,5489925,3,169,312,481,0
3_5596181,feast_lubricity_shrimp_potato_bavaria_guanabara,5596181,3,169,312,481,0
3_7129944,feast_satisfaction_potato_shrimp_bavaria_guanabara,7129944,3,86,196,282,0
3_7248052,feast_satisfaction_potato_shrimp_guanabara_bosnia,7248052,3,128,273,401,0
3_6663456,feast_satisfaction_potato_shrimp_goias_bavaria,6663456,3,87,196,283,0
3_2089599,feast_lubricity_onion_shrimp_guanabara_bosnia,2089599,3,127,322,449,0
3_1999017,feast_lubricity_onion_shrimp_bosnia_alsace,1999017,3,135,386,521,0
3_3281987,feast_satiety_onion_shrimp_guanabara_bosnia,3281987,3,172,337,509,0
3_5926924,feast_satiety_onion_shrimp_bosnia_alsace,5926924,3,200,448,648,0
3_6018798,feast_lubricity_potato_shrimp_bavaria_guanabara,6018798,3,122,290,412,0
3_1555517,feast_lubricity_potato_shrimp_guanabara_bosnia,1555517,3,188,468,656,0
3_4670021,feast_lubricity_potato_shrimp_goias_bavaria,4670021,3,127,290,417,0
3_6984665,feast_intoxication_potato_shrimp_bavaria_guanabara,6984665,3,100,201,301,0
3_1715559,feast_intoxication_potato_shrimp_guanabara_bosnia,1715559,3,170,387,557,0
3_3204139,feast_intoxication_potato_shrimp_goias_bavaria,3204139,3,105,201,306,0
3_4454975,noop_craves_lubricity_yogurt,4454975,3,112,265,377,0
3_5853942,feast_lubricity_yogurt_potato_bavaria_guanabara,5853942,3,176,296,472,0
3_1668680,noop_locale_haroset_guanabara,1668680,3,7,38,45,0
3_3868099,feast_lubricity_haroset_turkey_bavaria_guanabara,3868099,3,111,297,408,0
3_520538,noop_pain_laceration-8,520538,3,1,1,2,0
3_1682489,noop_craves_achievement_marzipan,1682489,3,86,212,298,0
3_2984277,harmony_achievement_saturn,2984277,3,25,44,69,0
3_7902854,craves_achievement_cherry,7902854,3,24,31,55,0
3_2667139,noop_fears_abrasion_satisfaction,2667139,3,93,197,290,0
3_5051695,craves_abrasion_yogurt,5051695,3,6,10,16,0
3_223167,noop_locale_marzipan_surrey,223167,3,98,390,488,0
3_7541487,locale_marzipan_alsace,7541487,3,61,37,98,0
3_3216798,noop_eats_rice_papaya,3216798,3,1,1,2,0
3_564420,noop_planet_earth,564420,3,1,1,2,0
3_5044939,noop_pain_loneliness-3,5044939,3,1,1,2,0
3_608750,noop_harmony_satisfaction_mercury,608750,3,57,99,156,0
3_1783917,noop_fears_dread_excitement,1783917,3,51,92,143,0
3_2996931,craves_dread_papaya,2996931,3,11,13,24,0
3_6153267,noop_craves_satiety_papaya,6153267,3,131,246,377,0
3_143900,noop_locale_cherry_guanabara,143900,3,44,76,120,0
3_5757972,feast_satiety_cherry_rice_bavaria_guanabara,5757972,3,122,279,401,0
3_6821478,locale_cherry_bosnia,6821478,3,26,20,46,0
3_5335732,noop_craves_lubricity_arugula,5335732,3,112,265,377,0
3_5366332,noop_fears_boils_satisfaction,5366332,3,95,224,319,0
3_5136068,noop_eats_mutton_marzipan,5136068,3,1,1,2,0
3_2295368,noop_harmony_satiety_saturn,2295368,3,29,87,116,0
3_6578941,overcome_angina_satiety_onion_mercury_saturn,6578941,3,163,303,466,0
3_5890937,overcome_laceration_satiety_cherry_mercury_saturn,5890937,3,105,249,354,0
3_7575031,noop_food_cherry,7575031,3,1,1,2,0
3_3338867,succumb_laceration_satiety_cherry_mercury_saturn,3338867,3,118,249,367,0
3_622134,feast_satiety_cherry_rice_bosnia_alsace,622134,3,157,414,571,0
3_7367708,feast_satiety_cherry_rice_guanabara_bosnia,7367708,3,121,279,400,0
3_2727852,noop_fears_prostatitis_excitement,2727852,3,83,223,306,0
3_427769,noop_craves_jealousy_rice,427769,3,16,67,83,0
3_6877418,noop_craves_laceration-8_haroset,6877418,3,4,16,20,0
3_2718519,noop_eats_ham_mutton,2718519,3,1,1,2,0
3_2101641,noop_craves_satiety_endive,2101641,3,93,219,312,0
3_7705169,noop_craves_love_onion,7705169,3,151,309,460,0
3_3721742,noop_fears_sciatica_intoxication,3721742,3,73,128,201,0
3_4312550,harmony_intoxication_uranus,4312550,3,19,19,38,0
3_1915992,noop_harmony_achievement_mercury,1915992,3,63,184,247,0
3_6002469,noop_harmony_satisfaction_saturn,6002469,3,20,56,76,0
3_1387483,overcome_loneliness_satisfaction_potato_mercury_saturn,1387483,3,78,192,270,0
3_6153519,noop_craves_anger_marzipan,6153519,3,12,38,50,0
3_5772633,noop_eats_endive_cherry,5772633,3,1,1,2,0
3_6194333,noop_eats_potato_shrimp,6194333,3,1,1,2,0
3_4622121,noop_locale_papaya_alsace,4622121,3,68,218,286,0
3_5025041,locale_papaya_bosnia,5025041,3,14,11,25,0
3_7547979,noop_food_wonderbread,7547979,3,1,1,2,0
3_5764793,feast_satisfaction_wonderbread_yogurt_bosnia_alsace,5764793,3,121,275,396,0
3_577277,feast_intoxication_wonderbread_yogurt_bosnia_alsace,577277,3,104,231,335,0
3_1696785,noop_fears_laceration_satiety,1696785,3,79,165,244,0
3_4553765,locale_cherry_guanabara,4553765,3,27,19,46,0
3_1376386,noop_fears_depression_satiety,1376386,3,106,264,370,0
3_6318237,craves_depression_endive,6318237,3,9,11,20,0
3_2913854,noop_craves_anxiety_marzipan,2913854,3,12,38,50,0
3_1584472,noop_eats_ham_wonderbread,1584472,3,1,1,2,0
3_4696431,noop_fears_loneliness-3_rest,4696431,3,68,187,255,0
3_4737077,craves_loneliness-3_ham,4737077,3,5,14,19,0
3_6825231,noop_locale_onion_bosnia,6825231,3,32,75,107,0
3_819297,noop_harmony_excitement_saturn,819297,3,65,183,248,0
3_1065095,noop_eats_shrimp_onion,1065095,3,1,1,2,0
3_6628497,noop_pain_abrasion,6628497,3,1,1,2,0
3_4434536,noop_craves_satisfaction_shrimp,4434536,3,86,161,247,0
3_324388,noop_craves_loneliness_potato,324388,3,15,56,71,0
3_6579438,noop_harmony_lubricity_uranus,6579438,3,25,109,134,0
3_7087923,noop_craves_satisfaction_arugula,7087923,3,86,163,249,0
3_6296349,noop_planet_uranus,6296349,3,1,1,2,0
3_3665485,noop_locale_yogurt_guanabara,3665485,3,82,27,109,0
3_6819809,feast_intoxication_yogurt_potato_bavaria_guanabara,6819809,3,150,195,345,0
3_6759901,locale_yogurt_bosnia,6759901,3,9,9,18,0
3_1640807,noop_province_bavaria,1640807,3,1,1,2,0
3_3663839,noop_pain_angina,3663839,3,1,1,2,0
3_461749,noop_pain_depression,461749,3,1,1,2,0
3_7123940,noop_craves_achievement_wurst,7123940,3,62,178,240,0
3_451898,noop_locale_arugula_alsace,451898,3,25,36,61,0
3_1938062,noop_province_guanabara,1938062,3,1,1,2,0
3_2075900,noop_craves_satiety_cherry,2075900,3,83,202,285,0
3_433650,noop_eats_haroset_marzipan,433650,3,1,1,2,0
3_7594879,noop_pain_hangover,7594879,3,1,1,2,0
3_7314587,noop_fears_grief_achievement,7314587,3,49,93,142,0
3_2879007,craves_grief_endive,2879007,3,9,11,20,0
3_740351,noop_fears_angina_rest,740351,3,97,250,347,0
3_3231060,noop_eats_papaya_rice,3231060,3,1,1,2,0
3_7076654,noop_pain_anger,7076654,3,1,1,2,0
3_950215,noop_food_potato,950215,3,1,1,2,0
3_5410717,feast_satisfaction_potato_yogurt_bavaria_guanabara,5410717,3,86,196,282,0
3_5584884,feast_satisfaction_potato_yogurt_guanabara_bosnia,5584884,3,128,273,401,0
3_4843501,feast_satisfaction_potato_yogurt_goias_bavaria,4843501,3,87,196,283,0
3_4299571,feast_lubricity_potato_yogurt_bavaria_guanabara,4299571,3,122,290,412,0
3_7893326,feast_lubricity_potato_yogurt_guanabara_bosnia,7893326,3,188,468,656,0
3_2850066,feast_lubricity_potato_yogurt_goias_bavaria,2850066,3,127,290,417,0
3_5265438,feast_intoxication_potato_yogurt_bavaria_guanabara,5265438,3,100,201,301,0
3_52391,feast_intoxication_potato_yogurt_guanabara_bosnia,52391,3,170,387,557,0
3_1384184,feast_intoxication_potato_yogurt_goias_bavaria,1384184,3,105,201,306,0
3_4938993,noop_craves_satisfaction_wonderbread,4938993,3,76,177,253,0
3_7505392,noop_craves_love_mutton,7505392,3,152,315,467,0
3_7558443,noop_fears_loneliness_lubricity,7558443,3,99,255,354,0
3_6948529,noop_attacks_bosnia_alsace,6948529,3,1,1,2,0
3_3827688,noop_craves_boils_shrimp,3827688,3,13,56,69,0
3_6105244,noop_attacks_guanabara_bosnia,6105244,3,1,1,2,0
3_327212,noop_craves_loneliness-3_ham,327212,3,9,50,59,0
3_2016804,noop_locale_wonderbread_alsace,2016804,3,43,96,139,0
3_1187150,locale_wonderbread_bosnia,1187150,3,19,9,28,0
3_3752565,noop_eats_potato_yogurt,3752565,3,1,1,2,0
3_3370802,noop_locale_arugula_surrey,3370802,3,82,186,268,0
3_3242223,locale_arugula_alsace,3242223,3,18,10,28,0
3_2878478,noop_food_wurst,2878478,3,1,1,2,0
3_3694793,noop_harmony_achievement_saturn,3694793,3,45,152,197,0
3_2617581,noop_craves_rest_marzipan,2617581,3,89,253,342,0
3_6418558,noop_locale_cherry_alsace,6418558,3,148,405,553,0
3_2928166,noop_eats_marzipan_rice,2928166,3,1,1,2,0
3_666864,noop_fears_depression_achievement,666864,3,49,93,142,0
3_3966481,noop_locale_cherry_bosnia,3966481,3,39,76,115,0
3_5083040,noop_craves_angina_onion,5083040,3,11,30,41,0
3_4348482,noop_eats_marzipan_cherry,4348482,3,1,1,2,0
3_3737404,noop_orbits_mercury_saturn,3737404,3,1,1,2,0
3_5375631,noop_fears_abrasion-4_rest,5375631,3,68,187,255,0
3_4462730,craves_abrasion-4_ham,4462730,3,5,14,19,0
3_1203432,noop_craves_love_marzipan,1203432,3,97,254,351,0
3_4866842,noop_locale_papaya_guanabara,4866842,3,121,36,157,0
3_1672405,noop_craves_abrasion-4_ham,1672405,3,9,50,59,0
3_6630041,noop_fears_jealousy_love,6630041,3,79,135,214,0
3_2332756,noop_locale_mutton_bavaria,2332756,3,82,31,113,0
3_4379955,locale_mutton_guanabara,4379955,3,7,15,22,0
3_4470546,noop_locale_wurst_goias,4470546,3,1,1,2,0
3_2573934,noop_eats_cherry_marzipan,2573934,3,1,1,2,0
3_2167967,noop_harmony_entertainment_uranus,2167967,3,5,13,18,0
3_5142292,noop_craves_dread_papaya,5142292,3,14,46,60,0
3_6896743,noop_craves_lubricity_shrimp,6896743,3,82,233,315,0
3_5221458,noop_planet_saturn,5221458,3,1,1,2,0
3_3418815,noop_pain_prostatitis,3418815,3,1,1,2,0
3_3683143,noop_craves_excitement_wurst,3683143,3,64,178,242,0
3_1540266,noop_eats_potato_arugula,1540266,3,1,1,2,0
3_2749009,noop_pain_jealousy,2749009,3,1,1,2,0
3_5373533,noop_pain_dread,5373533,3,1,1,2,0
3_5747312,noop_pleasure_achievement,5747312,3,1,1,2,0
3_5077393,noop_pleasure_excitement,5077393,3,1,1,2,0
3_5381497,noop_craves_rest_mutton,5381497,3,91,245,336,0
3_7541545,noop_locale_endive_guanabara,7541545,3,113,36,149,0
3_6411945,locale_endive_bosnia,6411945,3,14,11,25,0
3_6235535,noop_locale_turkey_bavaria,6235535,3,11,25,36,0
3_630322,noop_craves_entertainment_wurst,630322,3,1,1,2,0
3_5808271,noop_eats_onion_ham,5808271,3,1,1,2,0
3_2616621,noop_province_goias,2616621,3,1,1,2,0
3_6976685,noop_pleasure_intoxication,6976685,3,1,1,2,0
3_1578600,noop_harmony_excitement_earth,1578600,3,47,151,198,0
3_1485908,noop_harmony_entertainment_earth,1485908,3,15,31,46,0
3_5442199,noop_fears_boils-1_intoxication,5442199,3,55,85,140,0
3_5173398,craves_boils-1_arugula,5173398,3,9,13,22,0
3_434518,noop_craves_love_haroset,434518,3,150,311,461,0
3_5109349,noop_craves_rest_yogurt,5109349,3,108,266,374,0
3_3275072,noop_eats_shrimp_turkey,3275072,3,1,1,2,0
3_6463600,noop_craves_satisfaction_potato,6463600,3,57,155,212,0
3_796009,noop_eats_wurst_endive,796009,3,1,1,2,0
3_1874818,noop_harmony_rest_saturn,1874818,3,28,82,110,0
3_7783167,noop_food_haroset,7783167,3,1,1,2,0
3_3036620,noop_craves_intoxication_ham,3036620,3,93,172,265,0
3_2253173,noop_eats_rice_marzipan,2253173,3,1,1,2,0
3_6433446,noop_craves_love_rice,6433446,3,88,240,328,0
3_2536952,noop_craves_laceration_cherry,2536952,3,16,70,86,0
3_7496750,noop_eats_yogurt_potato,7496750,3,1,1,2,0
3_3200789,noop_craves_satiety_wurst,3200789,3,101,221,322,0
3_7007816,noop_pleasure_entertainment,7007816,3,1,1,2,0
3_1318637,noop_food_onion,1318637,3,1,1,2,0
3_5486452,noop_harmony_intoxication_earth,5486452,3,42,107,149,0
3_99639,noop_craves_lubricity_onion,99639,3,91,239,330,0
3_5305240,noop_locale_marzipan_alsace,5305240,3,62,108,170,0
3_2491698,noop_eats_arugula_potato,2491698,3,1,1,2,0
3_5530554,noop_craves_depression_endive,5530554,3,12,47,59,0
3_534272,noop_harmony_lubricity_earth,534272,3,56,160,216,0
3_254640,noop_craves_excitement_rice,254640,3,64,179,243,0
3_4356899,noop_eats_onion_marzipan,4356899,3,1,1,2,0
3_3987172,noop_pleasure_satiety,3987172,3,1,1,2,0
3_7533636,noop_food_rice,7533636,3,1,1,2,0
3_6517750,noop_fears_anger_love,6517750,3,104,214,318,0
3_942867,craves_anger_marzipan,942867,3,11,18,29,0
3_2484442,noop_pain_laceration,2484442,3,1,1,2,0
3_1284607,noop_craves_lubricity_haroset,1284607,3,98,255,353,0
3_840928,noop_harmony_love_earth,840928,3,57,180,237,0
3_4740452,noop_craves_rest_wonderbread,4740452,3,85,242,327,0
3_6404305,noop_craves_love_papaya,6404305,3,97,264,361,0
3_2352679,noop_craves_love_endive,2352679,3,137,296,433,0
3_539530,noop_fears_boils-1_satisfaction,539530,3,96,214,310,0
3_4338091,noop_fears_prostatitis_achievement,4338091,3,81,227,308,0
3_4852816,noop_eats_onion_shrimp,4852816,3,1,1,2,0
3_51279,noop_eats_shrimp_potato,51279,3,1,1,2,0
3_2606268,noop_attacks_bavaria_guanabara,2606268,3,1,1,2,0
3_3477552,noop_eats_turkey_haroset,3477552,3,1,1,2,0
3_1654616,noop_attacks_goias_bavaria,1654616,3,1,1,2,0
3_6935494,noop_pain_loneliness,6935494,3,1,1,2,0
3_2074016,noop_pleasure_satisfaction,2074016,3,1,1,2,0
3_2170044,noop_locale_papaya_bosnia,2170044,3,19,36,55,0
3_7186753,noop_craves_satiety_marzipan,7186753,3,93,210,303,0
3_106415,noop_fears_jealousy-2_intoxication,106415,3,73,128,201,0
3_6512303,noop_fears_dread_love,6512303,3,112,284,396,0
3_899045,noop_craves_hangover_papaya,899045,3,14,46,60,0
3_6207907,noop_eats_cherry_endive,6207907,3,1,1,2,0
3_1620259,noop_craves_excitement_papaya,1620259,3,54,186,240,0
3_4174008,noop_food_turkey,4174008,3,1,1,2,0
3_4752508,noop_food_mutton,4752508,3,1,1,2,0
3_5770055,noop_locale_shrimp_guanabara,5770055,3,98,76,174,0
3_5073604,noop_harmony_love_uranus,5073604,3,35,145,180,0
3_964644,noop_pain_grief,964644,3,1,1,2,0
3_1584320,noop_fears_hangover_excitement,1584320,3,51,92,143,0
3_3135292,craves_hangover_papaya,3135292,3,11,13,24,0
3_5098560,noop_craves_intoxication_yogurt,5098560,3,75,162,237,0
3_7587947,noop_craves_rest_ham,7587947,3,77,239,316,0
3_4480360,noop_food_yogurt,4480360,3,1,1,2,0
3_4682406,noop_locale_potato_guanabara,4682406,3,30,40,70,0
3_1640948,noop_craves_satiety_onion,1640948,3,145,260,405,0
3_6306172,noop_craves_achievement_endive,6306172,3,54,191,245,0
3_6009025,noop_locale_endive_alsace,6009025,3,68,223,291,0
3_2815448,noop_craves_abrasion_yogurt,2815448,3,7,17,24,0
3_3707157,noop_harmony_satiety_mercury,3707157,3,51,127,178,0
3_3556948,noop_locale_endive_bosnia,3556948,3,19,36,55,0
3_924830,noop_craves_lubricity_potato,924830,3,91,245,336,0
3_7862758,noop_craves_achievement_rice,7862758,3,87,214,301,0
3_6000798,noop_locale_arugula_bosnia,6000798,3,93,36,129,0
3_5054707,noop_fears_anger_satiety,5054707,3,100,213,313,0
3_4398007,noop_eats_haroset_turkey,4398007,3,1,1,2,0
3_5553848,noop_eats_papaya_wurst,5553848,3,1,1,2,0
3_2339924,noop_harmony_achievement_earth,2339924,3,28,92,120,0
3_1276331,noop_locale_onion_alsace,1276331,3,65,211,276,0
3_4679870,locale_onion_bosnia,4679870,3,31,25,56,0
3_7140408,noop_eats_rice_cherry,7140408,3,1,1,2,0
3_4124722,noop_craves_sciatica_wonderbread,4124722,3,9,21,30,0
3_3004232,noop_eats_wonderbread_yogurt,3004232,3,1,1,2,0
3_1994700,noop_province_alsace,1994700,3,1,1,2,0
3_7543600,noop_province_bosnia,7543600,3,1,1,2,0
3_4834959,noop_craves_rest_arugula,4834959,3,108,266,374,0
3_4676598,noop_fears_loneliness_intoxication,4676598,3,77,165,242,0
3_5623059,noop_fears_grief_satiety,5623059,3,106,264,370,0
3_4631551,noop_locale_potato_bosnia,4631551,3,119,265,384,0
3_1091294,locale_potato_guanabara,1091294,3,20,15,35,0
3_2937151,noop_craves_boils-1_arugula,2937151,3,12,38,50,0
3_694359,noop_planet_mercury,694359,3,1,1,2,0
3_335752,noop_craves_lubricity_ham,335752,3,117,275,392,0
3_247124,noop_locale_potato_bavaria,247124,3,35,40,75,0
3_170733,noop_fears_hangover_love,170733,3,112,284,396,0
3_1902674,noop_attacks_alsace_surrey,1902674,3,1,1,2,0
3_1990466,noop_eats_wonderbread_arugula,1990466,3,1,1,2,0
3_2972633,noop_eats_cherry_rice,2972633,3,1,1,2,0
3_4809174,noop_eats_endive_wurst,4809174,3,1,1,2,0
3_2417187,noop_pleasure_lubricity,2417187,3,1,1,2,0
3_1568415,noop_craves_intoxication_potato,1568415,3,69,156,225,0
3_7566765,noop_craves_intoxication_wonderbread,7566765,3,65,149,214,0
3_6239897,province_bosnia,6239897,3,1,0,1,0
3_690997,province_alsace,690997,3,1,0,1,0
2_6517750,noop_fears_anger_love,6517750,2,0,104,104,0
1_809839,fears_anger_love,809839,1,0,1,1,0
3_3519135,eats_yogurt_potato,3519135,3,1,12,13,0
3_3223975,eats_haroset_marzipan,3223975,3,1,14,15,0
2_143900,noop_locale_cherry_guanabara,143900,2,0,44,44,0
1_4553765,locale_cherry_guanabara,4553765,1,0,12,12,0
2_3991950,succumb_angina_lubricity_onion_earth_uranus,3991950,2,6,108,114,0
1_2249450,fears_angina_lubricity,2249450,1,0,1,1,0
2_6458400,feast_rest_shrimp_turkey_bavaria_guanabara,6458400,2,5,216,221,0
1_2178943,locale_shrimp_guanabara,2178943,1,0,9,9,0
1_3573502,craves_rest_shrimp,3573502,1,0,10,10,0
3_7231215,locale_shrimp_bavaria,7231215,3,9,36,45,0
3_825382,craves_rest_turkey,825382,3,3,44,47,0
2_944400,feast_lubricity_marzipan_mutton_bosnia_alsace,944400,2,5,174,179,0
1_7541487,locale_marzipan_alsace,7541487,1,0,30,30,0
1_4422260,craves_lubricity_marzipan,4422260,1,0,12,12,0
3_5089410,locale_marzipan_bosnia,5089410,3,30,36,66,0
3_1136011,craves_lubricity_mutton,1136011,3,4,37,41,0
2_830600,feast_lubricity_arugula_wonderbread_guanabara_bosnia,830600,2,5,182,187,0
1_790146,locale_arugula_bosnia,790146,1,0,6,6,0
1_6123415,craves_lubricity_arugula,6123415,1,0,7,7,0
3_1014328,locale_arugula_guanabara,1014328,3,6,27,33,0
3_4947268,craves_lubricity_wonderbread,4947268,3,7,41,48,0
2_3965200,feast_rest_yogurt_potato_guanabara_bosnia,3965200,2,6,124,130,0
1_1131734,craves_rest_yogurt,1131734,1,0,5,5,0
3_5602566,craves_rest_potato,5602566,3,8,43,51,0
2_5224350,feast_rest_wonderbread_arugula_guanabara_bosnia,5224350,2,6,108,114,0
1_1187150,locale_wonderbread_bosnia,1187150,1,0,9,9,0
3_1546140,locale_wonderbread_guanabara,1546140,3,9,14,23,0
2_4171450,overcome_boils_rest_shrimp_mercury_saturn,4171450,2,9,143,152,0
3_5493103,fears_boils_rest,5493103,3,1,44,45,0
2_260750,overcome_jealousy_love_rice_saturn_earth,260750,2,9,110,119,0
3_1853352,harmony_love_saturn,1853352,3,6,36,42,0
2_740351,noop_fears_angina_rest,740351,2,0,97,97,0
1_3693926,fears_angina_rest,3693926,1,0,1,1,0
2_6381351,succumb_loneliness_intoxication_potato_earth_uranus,6381351,2,6,90,96,0
1_3883948,fears_loneliness_intoxication,3883948,1,0,1,1,0
2_7535551,feast_intoxication_arugula_wonderbread_guanabara_bosnia,7535551,2,7,146,153,0
2_7056651,feast_intoxication_arugula_potato_guanabara_bosnia,7056651,2,7,146,153,0
2_1805151,feast_rest_marzipan_rice_alsace_surrey,1805151,2,6,182,188,0
1_5472578,craves_rest_marzipan,5472578,1,0,12,12,0
3_843559,craves_rest_rice,843559,3,2,48,50,0
2_4843501,feast_satisfaction_potato_yogurt_goias_bavaria,4843501,2,6,84,90,0
1_3037449,locale_potato_bavaria,3037449,1,0,9,9,0
3_3491505,locale_potato_goias,3491505,3,9,4,13,0
2_5675701,feast_lubricity_ham_mutton_bavaria_guanabara,5675701,2,6,197,203,0
1_3190749,craves_lubricity_ham,3190749,1,0,8,8,0
2_335752,noop_craves_lubricity_ham,335752,2,1,117,118,0
3_1332191,eats_turkey_haroset,1332191,3,1,6,7,0
2_2727852,noop_fears_prostatitis_excitement,2727852,2,0,83,83,0
1_4037416,fears_prostatitis_excitement,4037416,1,0,1,1,0
2_3528352,succumb_anxiety_love_marzipan_earth_uranus,3528352,2,6,119,125,0
1_5436552,fears_anxiety_love,5436552,1,0,1,1,0
2_6512303,noop_fears_dread_love,6512303,2,0,112,112,0
1_804392,fears_dread_love,804392,1,0,1,1,0
2_13203,noop_fears_angina_lubricity,13203,2,1,98,99,0
2_5678553,feast_rest_onion_shrimp_guanabara_bosnia,5678553,2,6,121,127,0
1_4679870,locale_onion_bosnia,4679870,1,0,15,15,0
3_3992670,locale_onion_guanabara,3992670,3,15,25,40,0
2_3893303,feast_satisfaction_onion_shrimp_guanabara_bosnia,3893303,2,6,121,127,0
1_181007,craves_satisfaction_onion,181007,1,0,7,7,0
2_4224803,feast_rest_marzipan_onion_alsace_surrey,4224803,2,7,182,189,0
2_4914153,feast_love_endive_cherry_bavaria_guanabara,4914153,2,5,231,236,0
1_3950433,locale_endive_guanabara,3950433,1,0,4,4,0
1_6376041,craves_love_endive,6376041,1,0,8,8,0
3_7973276,locale_endive_bavaria,7973276,3,4,41,45,0
2_506853,feast_achievement_rice_papaya_guanabara_bosnia,506853,2,6,121,127,0
1_4271646,craves_achievement_rice,4271646,1,0,10,10,0
3_3979244,craves_achievement_papaya,3979244,3,3,38,41,0
2_7473003,feast_achievement_rice_marzipan_bavaria_guanabara,7473003,2,6,126,132,0
1_437954,locale_rice_guanabara,437954,1,0,12,12,0
3_5580230,locale_rice_bavaria,5580230,3,12,24,36,0
2_3534253,feast_rest_arugula_wonderbread_bosnia_alsace,3534253,2,6,131,137,0
1_2689598,craves_rest_arugula,2689598,1,0,7,7,0
2_1189353,overcome_anxiety_rest_marzipan_mercury_saturn,1189353,2,9,105,114,0
3_1431034,fears_anxiety_rest,1431034,3,1,36,37,0
2_3900703,overcome_abrasion_lubricity_yogurt_earth_uranus,3900703,2,8,122,130,0
1_863863,craves_lubricity_yogurt,863863,1,0,5,5,0
3_1790580,fears_abrasion_lubricity,1790580,3,1,36,37,0
3_6527729,orbits_mercury_saturn,6527729,3,1,252,253,0
3_1567476,pain_anger,1567476,3,1,30,31,0
3_676602,eats_marzipan_haroset,676602,3,1,0,1,0
2_7254354,noop_craves_satiety_mutton,7254354,2,0,146,146,0
1_2043702,craves_satiety_mutton,2043702,1,0,4,4,0
3_3609901,province_surrey,3609901,3,1,0,1,0
3_4332901,eats_mutton_ham,4332901,3,1,0,1,0
2_7565704,noop_locale_wonderbread_bosnia,7565704,2,1,20,21,0
2_5693854,succumb_laceration_satiety_endive_mercury_saturn,5693854,2,7,125,132,0
3_3350376,craves_laceration_endive,3350376,3,1,39,40,0
2_877404,succumb_anger_love_marzipan_earth_uranus,877404,2,7,119,126,0
2_4995154,feast_rest_shrimp_turkey_guanabara_bosnia,4995154,2,7,158,165,0
2_137304,feast_excitement_cherry_endive_guanabara_bosnia,137304,2,6,123,129,0
1_6331552,craves_excitement_cherry,6331552,1,0,10,10,0
3_6357293,craves_excitement_endive,6357293,3,3,39,42,0
2_4944154,feast_excitement_marzipan_onion_bosnia_alsace,4944154,2,6,145,151,0
1_7539959,craves_excitement_marzipan,7539959,1,0,12,12,0
3_6533167,craves_excitement_onion,6533167,3,2,49,51,0
2_5830254,feast_love_onion_marzipan_guanabara_bosnia,5830254,2,6,175,181,0
1_2657767,craves_love_onion,2657767,1,0,7,7,0
2_4533354,feast_rest_marzipan_mutton_bosnia_alsace,4533354,2,7,146,153,0
2_2007304,feast_rest_ham_wonderbread_goias_bavaria,2007304,2,7,98,105,0
3_157616,locale_ham_goias,157616,3,9,2,11,0
2_1155004,overcome_jealousy-2_satisfaction_wonderbread_mercury_saturn,1155004,2,8,89,97,0
1_171277,craves_satisfaction_wonderbread,171277,1,0,8,8,0
3_2412073,fears_jealousy-2_satisfaction,2412073,3,1,25,26,0
2_3510554,overcome_loneliness_lubricity_potato_saturn_earth,3510554,2,9,111,120,0
3_6292230,harmony_lubricity_saturn,6292230,3,3,37,40,0
2_5770055,noop_locale_shrimp_guanabara,5770055,2,1,98,99,0
2_2732655,feast_satiety_rice_papaya_bavaria_guanabara,2732655,2,7,137,144,0
2_2127805,feast_rest_onion_marzipan_guanabara_bosnia,2127805,2,7,121,128,0
2_6023505,feast_lubricity_marzipan_onion_alsace_surrey,6023505,2,7,204,211,0
2_5834855,feast_satiety_cherry_endive_guanabara_bosnia,5834855,2,7,118,125,0
2_311305,feast_love_rice_papaya_guanabara_bosnia,311305,2,7,124,131,0
2_1593055,feast_achievement_rice_papaya_bavaria_guanabara,1593055,2,7,126,133,0
2_2332756,noop_locale_mutton_bavaria,2332756,2,0,82,82,0
1_5123081,locale_mutton_bavaria,5123081,1,0,4,4,0
2_5648606,noop_locale_rice_guanabara,5648606,2,1,44,45,0
2_176606,noop_craves_satiety_haroset,176606,2,0,144,144,0
1_2412853,craves_satiety_haroset,2412853,1,0,4,4,0
2_6564656,feast_rest_shrimp_potato_bavaria_guanabara,6564656,2,7,216,223,0
2_1083156,feast_excitement_marzipan_mutton_bosnia_alsace,1083156,2,7,145,152,0
3_3509029,craves_excitement_mutton,3509029,3,2,42,44,0
2_6851006,feast_rest_marzipan_rice_bosnia_alsace,6851006,2,7,146,153,0
2_6663456,feast_satisfaction_potato_shrimp_goias_bavaria,6663456,2,7,84,91,0
2_7539606,feast_love_rice_papaya_bavaria_guanabara,7539606,2,7,125,132,0
2_1630056,feast_excitement_rice_cherry_bavaria_guanabara,1630056,2,7,107,114,0
2_4940956,feast_rest_arugula_potato_alsace_surrey,4940956,2,7,176,183,0
3_2252646,eats_haroset_turkey,2252646,3,1,14,15,0
2_5054707,noop_fears_anger_satiety,5054707,2,0,100,100,0
1_2909346,fears_anger_satiety,2909346,1,0,1,1,0
3_2230292,eats_cherry_endive,2230292,3,1,24,25,0
2_1284607,noop_craves_lubricity_haroset,1284607,2,0,98,98,0
1_2072290,craves_lubricity_haroset,2072290,1,0,4,4,0
3_3933873,province_bavaria,3933873,3,1,0,1,0
3_1694955,craves_depression-7_haroset,1694955,3,4,12,16,0
2_5654207,feast_achievement_cherry_marzipan_bavaria_guanabara,5654207,2,7,105,112,0
3_800046,locale_cherry_bavaria,800046,3,12,24,36,0
2_6398757,feast_achievement_marzipan_onion_alsace_surrey,6398757,2,6,179,185,0
1_3812864,craves_achievement_marzipan,3812864,1,0,12,12,0
3_6351782,craves_achievement_onion,6351782,3,2,48,50,0
3_1432497,eats_rice_cherry,1432497,3,1,24,25,0
2_7862758,noop_craves_achievement_rice,7862758,2,1,87,88,0
3_2574892,food_mutton,2574892,3,1,85,86,0
3_1996392,food_turkey,1996392,3,1,59,60,0
3_6406031,planet_saturn,6406031,3,1,263,264,0
3_3095552,pain_boils-1,3095552,3,1,20,21,0
2_5273458,succumb_sciatica_rest_wonderbread_mercury_saturn,5273458,2,6,105,111,0
1_3948803,fears_sciatica_rest,3948803,1,0,1,1,0
2_4495508,feast_rest_shrimp_potato_guanabara_bosnia,4495508,2,7,158,165,0
2_3178308,feast_satiety_rice_marzipan_bavaria_guanabara,3178308,2,7,137,144,0
2_6739658,feast_lubricity_arugula_potato_alsace_surrey,6739658,2,7,178,185,0
2_7367708,feast_satiety_cherry_rice_guanabara_bosnia,7367708,2,7,118,125,0
2_6605908,feast_rest_wonderbread_yogurt_guanabara_bosnia,6605908,2,7,108,115,0
2_1101858,overcome_abrasion-4_lubricity_ham_earth_uranus,1101858,2,9,130,139,0
3_4539735,fears_abrasion-4_lubricity,4539735,3,1,38,39,0
2_4749558,overcome_prostatitis_achievement_wurst_mercury_saturn,4749558,2,9,83,92,0
3_7908898,planet_mercury,7908898,3,1,151,152,0
2_5623059,noop_fears_grief_satiety,5623059,2,0,106,106,0
1_3477698,fears_grief_satiety,3477698,1,0,1,1,0
2_4834959,noop_craves_rest_arugula,4834959,2,1,108,109,0
3_3749584,eats_wurst_endive,3749584,3,1,0,1,0
3_3933582,pain_jealousy,3933582,3,1,59,60,0
3_4380956,eats_marzipan_mutton,4380956,3,1,21,22,0
2_99659,succumb_hangover_excitement_papaya_saturn_earth,99659,2,6,79,85,0
1_2441720,harmony_excitement_saturn,2441720,1,0,4,4,0
2_1038159,feast_excitement_marzipan_rice_alsace_surrey,1038159,2,7,181,188,0
2_7323359,feast_intoxication_shrimp_onion_bosnia_alsace,7323359,2,6,192,198,0
1_6829812,craves_intoxication_shrimp,6829812,1,0,10,10,0
3_193139,craves_intoxication_onion,193139,3,5,34,39,0
2_5156709,feast_satiety_papaya_rice_bosnia_alsace,5156709,2,6,171,177,0
1_942615,craves_satiety_papaya,942615,1,0,8,8,0
2_4779159,feast_love_endive_wurst_bosnia_alsace,4779159,2,7,177,184,0
2_6819809,feast_intoxication_yogurt_potato_bavaria_guanabara,6819809,2,5,147,152,0
1_74373,locale_yogurt_guanabara,74373,1,0,6,6,0
1_4388044,craves_intoxication_yogurt,4388044,1,0,5,5,0
3_1038288,locale_yogurt_bavaria,1038288,3,6,24,30,0
2_7059259,feast_rest_arugula_potato_guanabara_bosnia,7059259,2,7,194,201,0
2_1874059,feast_intoxication_wonderbread_arugula_guanabara_bosnia,1874059,2,7,89,96,0
2_4942809,overcome_abrasion_rest_yogurt_mercury_saturn,4942809,2,9,118,127,0
3_3664603,fears_abrasion_rest,3664603,3,1,37,38,0
2_166809,overcome_anger_excitement_marzipan_earth_uranus,166809,2,9,104,113,0
3_5571930,fears_anger_excitement,5571930,3,1,33,34,0
3_2302744,food_yogurt,2302744,3,1,75,76,0
2_5098560,noop_craves_intoxication_yogurt,5098560,2,1,75,76,0
3_5524126,eats_papaya_rice,5524126,3,1,16,17,0
2_1472360,succumb_depression_achievement_cherry_saturn_earth,1472360,2,7,81,88,0
3_6292496,craves_depression_cherry,6292496,3,1,33,34,0
2_4997210,succumb_dread_love_papaya_earth_uranus,4997210,2,7,121,128,0
2_3952310,feast_achievement_marzipan_mutton_alsace_surrey,3952310,2,7,179,186,0
3_5080331,craves_achievement_mutton,5080331,3,2,41,43,0
2_3760610,feast_satiety_papaya_wurst_guanabara_bosnia,3760610,2,7,149,156,0
2_2437810,feast_love_onion_ham_guanabara_bosnia,2437810,2,7,175,182,0
3_2533325,craves_love_ham,2533325,3,4,45,49,0
2_1463910,feast_love_mutton_ham_goias_bavaria,1463910,2,6,229,235,0
1_3527777,craves_love_mutton,3527777,1,0,4,4,0
3_397409,locale_mutton_goias,397409,3,4,30,34,0
2_1207410,feast_love_endive_cherry_guanabara_bosnia,1207410,2,7,155,162,0
2_6559561,noop_craves_satisfaction_onion,6559561,2,1,91,92,0
2_5609161,succumb_loneliness_lubricity_potato_earth_uranus,5609161,2,6,112,118,0
1_6847927,fears_loneliness_lubricity,6847927,1,0,1,1,0
2_2960861,feast_excitement_cherry_endive_bosnia_alsace,2960861,2,7,217,224,0
2_2008311,feast_intoxication_shrimp_turkey_bosnia_alsace,2008311,2,7,192,199,0
3_4081692,craves_intoxication_turkey,4081692,3,3,29,32,0
2_87961,feast_love_onion_shrimp_guanabara_bosnia,87961,2,7,175,182,0
3_5697397,craves_love_shrimp,5697397,3,2,54,56,0
2_2061311,feast_rest_marzipan_cherry_bosnia_alsace,2061311,2,7,146,153,0
3_4226405,craves_rest_cherry,4226405,3,2,43,45,0
2_7076961,feast_achievement_endive_cherry_guanabara_bosnia,7076961,2,7,78,85,0
2_7403061,feast_achievement_endive_wurst_guanabara_bosnia,7403061,2,7,78,85,0
2_7092061,overcome_loneliness-3_lubricity_ham_earth_uranus,7092061,2,9,130,139,0
3_5317415,fears_loneliness-3_lubricity,5317415,3,1,38,39,0
3_601332,pleasure_achievement,601332,3,1,156,157,0
3_5961424,province_guanabara,5961424,3,1,0,1,0
2_1369212,noop_fears_jealousy_satiety,1369212,2,0,105,105,0
1_3605459,fears_jealousy_satiety,3605459,1,0,1,1,0
3_3715801,orbits_saturn_earth,3715801,3,1,34,35,0
3_365501,orbits_earth_uranus,365501,3,1,73,74,0
2_2272662,succumb_boils-1_intoxication_wonderbread_earth_uranus,2272662,2,7,90,97,0
3_108360,craves_boils-1_wonderbread,108360,3,1,28,29,0
2_1059112,feast_love_onion_ham_bosnia_alsace,1059112,2,7,203,210,0
2_937812,feast_love_endive_wurst_bavaria_guanabara,937812,2,7,231,238,0
2_1403462,feast_intoxication_potato_arugula_goias_bavaria,1403462,2,7,102,109,0
2_2911312,overcome_boils_intoxication_shrimp_earth_uranus,2911312,2,9,110,119,0
3_3055707,fears_boils_intoxication,3055707,3,1,31,32,0
2_2042862,overcome_boils-1_lubricity_arugula_earth_uranus,2042862,2,9,127,136,0
3_7258771,fears_boils-1_lubricity,7258771,3,1,38,39,0
2_2596412,overcome_dread_excitement_papaya_mercury_saturn,2596412,2,9,79,88,0
3_1168384,harmony_excitement_mercury,1168384,3,2,23,25,0
3_4317552,eats_marzipan_onion,4317552,3,1,0,1,0
2_2954263,succumb_loneliness_satisfaction_yogurt_mercury_saturn,2954263,2,7,111,118,0
3_4642216,craves_loneliness_yogurt,4642216,3,1,31,32,0
2_2523863,succumb_depression_satiety_endive_mercury_saturn,2523863,2,6,114,120,0
1_2164069,fears_depression_satiety,2164069,1,0,1,1,0
2_4564663,feast_intoxication_arugula_potato_bosnia_alsace,4564663,2,7,89,96,0
2_2771213,feast_satisfaction_wonderbread_arugula_guanabara_bosnia,2771213,2,7,95,102,0
2_5841813,feast_satiety_marzipan_rice_bosnia_alsace,5841813,2,7,153,160,0
2_6807363,feast_achievement_endive_wurst_bavaria_guanabara,6807363,2,7,161,168,0
2_5234163,overcome_hangover_excitement_papaya_mercury_saturn,5234163,2,9,79,88,0
2_5532813,overcome_laceration_excitement_cherry_earth_uranus,5532813,2,9,108,117,0
3_6026007,fears_laceration_excitement,6026007,3,1,31,32,0
2_6094164,noop_fears_sciatica_rest,6094164,2,1,95,96,0
2_6084014,feast_excitement_marzipan_rice_bosnia_alsace,6084014,2,7,145,152,0
2_2076064,feast_intoxication_shrimp_onion_guanabara_bosnia,2076064,2,7,125,132,0
2_6107414,feast_intoxication_ham_wonderbread_goias_bavaria,6107414,2,6,112,118,0
1_7446485,craves_intoxication_ham,7446485,1,0,8,8,0
2_7144114,feast_love_endive_cherry_bosnia_alsace,7144114,2,7,177,184,0
2_6948514,feast_satiety_marzipan_onion_bosnia_alsace,6948514,2,7,153,160,0
2_5028864,feast_achievement_rice_papaya_bosnia_alsace,5028864,2,7,220,227,0
2_2846564,overcome_depression-7_satiety_haroset_mercury_saturn,2846564,2,9,151,160,0
3_166176,fears_depression-7_satiety,166176,3,1,38,39,0
2_4906264,overcome_anxiety_achievement_marzipan_saturn_earth,4906264,2,9,102,111,0
3_2122856,fears_anxiety_achievement,2122856,3,1,32,33,0
2_106415,noop_fears_jealousy-2_intoxication,106415,2,0,73,73,0
1_7314742,fears_jealousy-2_intoxication,7314742,1,0,1,1,0
3_5711881,pain_prostatitis,5711881,3,1,16,17,0
3_7775927,eats_potato_yogurt,7775927,3,1,12,13,0
3_6773576,food_potato,6773576,3,1,110,111,0
3_6432009,food_arugula,6432009,3,1,54,55,0
2_685715,succumb_depression_achievement_endive_mercury_saturn,685715,2,6,76,82,0
1_4046367,harmony_achievement_mercury,4046367,1,0,2,2,0
2_3267815,feast_love_cherry_endive_bavaria_guanabara,3267815,2,7,143,150,0
2_6111415,feast_satiety_papaya_rice_bavaria_guanabara,6111415,2,6,233,239,0
1_1275730,locale_papaya_guanabara,1275730,1,0,4,4,0
3_4968840,locale_papaya_bavaria,4968840,3,4,45,49,0
2_537965,feast_rest_marzipan_haroset_bosnia_alsace,537965,2,7,146,153,0
3_6639450,craves_rest_haroset,6639450,3,2,0,2,0
2_4756665,feast_excitement_papaya_wurst_bavaria_guanabara,4756665,2,7,169,176,0
2_2884865,feast_rest_arugula_wonderbread_guanabara_bosnia,2884865,2,7,194,201,0
3_2778149,eats_wonderbread_arugula,2778149,3,1,12,13,0
3_4864341,pleasure_satisfaction,4864341,3,1,127,128,0
3_4444941,attacks_goias_bavaria,4444941,3,1,148,149,0
3_7806391,eats_onion_shrimp,7806391,3,1,24,25,0
3_1243086,pleasure_entertainment,1243086,3,1,10,11,0
3_7395882,eats_potato_arugula,7395882,3,1,12,13,0
3_6951528,eats_marzipan_rice,6951528,3,1,21,22,0
3_1833554,eats_yogurt_wonderbread,1833554,3,1,6,7,0
2_1686416,noop_craves_satisfaction_turkey,1686416,2,0,92,92,0
1_975900,craves_satisfaction_turkey,975900,1,0,2,2,0
2_3921616,succumb_loneliness-3_rest_mutton_mercury_saturn,3921616,2,7,102,109,0
3_87106,craves_loneliness-3_mutton,87106,3,1,40,41,0
2_4780916,succumb_grief_achievement_endive_mercury_saturn,4780916,2,7,76,83,0
2_783066,feast_excitement_rice_marzipan_bavaria_guanabara,783066,2,7,107,114,0
2_7957916,feast_satiety_onion_marzipan_guanabara_bosnia,7957916,2,6,169,175,0
1_4495945,craves_satiety_onion,4495945,1,0,7,7,0
2_2850066,feast_lubricity_potato_yogurt_goias_bavaria,2850066,2,7,124,131,0
2_3686216,feast_intoxication_wonderbread_yogurt_guanabara_bosnia,3686216,2,7,89,96,0
2_4572116,overcome_anger_love_marzipan_saturn_earth,4572116,2,9,117,126,0
2_1622416,overcome_laceration_achievement_cherry_mercury_saturn,1622416,2,9,84,93,0
3_2380884,food_haroset,2380884,3,1,86,87,0
2_6153267,noop_craves_satiety_papaya,6153267,2,1,131,132,0
2_7551117,noop_craves_rest_shrimp,7551117,2,1,127,128,0
2_1480267,feast_achievement_marzipan_cherry_alsace_surrey,1480267,2,7,179,186,0
2_4670967,feast_love_marzipan_rice_bosnia_alsace,4670967,2,7,159,166,0
2_6822417,feast_rest_yogurt_potato_bavaria_guanabara,6822417,2,7,185,192,0
2_5410717,feast_satisfaction_potato_yogurt_bavaria_guanabara,5410717,2,7,83,90,0
2_4577717,feast_lubricity_onion_ham_guanabara_bosnia,4577717,2,7,124,131,0
2_6191967,feast_satiety_onion_marzipan_bosnia_alsace,6191967,2,7,197,204,0
2_2766267,feast_achievement_rice_cherry_bosnia_alsace,2766267,2,7,220,227,0
2_3146267,overcome_boils_lubricity_shrimp_saturn_earth,3146267,2,9,97,106,0
2_7507367,overcome_anxiety_love_marzipan_saturn_earth,7507367,2,9,117,126,0
2_773917,overcome_anxiety_excitement_marzipan_earth_uranus,773917,2,9,104,113,0
3_1312777,fears_anxiety_excitement,1312777,3,1,33,34,0
2_299917,overcome_laceration_love_cherry_saturn_earth,299917,2,9,122,131,0
3_4228691,attacks_bavaria_guanabara,4228691,3,1,180,181,0
2_434518,noop_craves_love_haroset,434518,2,0,150,150,0
1_6290134,craves_love_haroset,6290134,1,0,4,4,0
3_1006816,craves_laceration-8_haroset,1006816,3,4,12,16,0
3_7991065,eats_mutton_marzipan,7991065,3,1,14,15,0
2_1028218,succumb_hangover_excitement_rice_earth_uranus,1028218,2,7,84,91,0
3_4824435,craves_hangover_rice,4824435,3,1,34,35,0
2_568668,feast_satisfaction_onion_marzipan_bosnia_alsace,568668,2,7,151,158,0
3_4615585,craves_satisfaction_marzipan,4615585,3,2,46,48,0
2_4833218,feast_lubricity_marzipan_haroset_alsace_surrey,4833218,2,7,204,211,0
2_3374868,feast_lubricity_marzipan_rice_alsace_surrey,3374868,2,7,204,211,0
3_1005562,craves_lubricity_rice,1005562,3,2,57,59,0
2_7233468,feast_rest_yogurt_wonderbread_guanabara_bosnia,7233468,2,7,124,131,0
2_3734418,feast_lubricity_ham_wonderbread_bavaria_guanabara,3734418,2,7,197,204,0
2_7705169,noop_craves_love_onion,7705169,2,1,151,152,0
3_1414816,eats_ham_mutton,1414816,3,1,12,13,0
2_5543869,noop_craves_excitement_cherry,5543869,2,1,89,90,0
2_4128319,succumb_laceration_satiety_marzipan_mercury_saturn,4128319,2,7,125,132,0
3_2289980,craves_laceration_marzipan,2289980,3,1,45,46,0
2_4694419,succumb_depression_achievement_wurst_saturn_earth,4694419,2,7,81,88,0
3_4592428,craves_depression_wurst,4592428,3,1,33,34,0
2_349869,feast_excitement_marzipan_haroset_alsace_surrey,349869,2,7,181,188,0
3_1490646,craves_excitement_haroset,1490646,3,2,42,44,0
2_5346619,feast_love_mutton_marzipan_bavaria_guanabara,5346619,2,7,159,166,0
2_3025569,overcome_loneliness_intoxication_potato_saturn_earth,3025569,2,9,89,98,0
3_3237659,harmony_intoxication_saturn,3237659,3,4,28,32,0
2_3036620,noop_craves_intoxication_ham,3036620,2,1,93,94,0
3_3163114,planet_earth,3163114,3,1,244,245,0
2_3977670,succumb_loneliness-3_rest_wonderbread_mercury_saturn,3977670,2,7,102,109,0
3_6166792,craves_loneliness-3_wonderbread,6166792,3,1,39,40,0
2_7479070,feast_love_haroset_turkey_bavaria_guanabara,7479070,2,7,157,164,0
3_7733722,locale_haroset_bavaria,7733722,3,6,12,18,0
3_2949277,craves_love_turkey,2949277,3,1,42,43,0
3_2456363,locale_haroset_guanabara,2456363,3,6,14,20,0
2_2155020,feast_achievement_rice_marzipan_guanabara_bosnia,2155020,2,7,121,128,0
2_5131320,feast_lubricity_ham_onion_bavaria_guanabara,5131320,2,7,197,204,0
2_2592020,overcome_loneliness-3_intoxication_ham_earth_uranus,2592020,2,9,106,115,0
3_978904,fears_loneliness-3_intoxication,978904,3,1,29,30,0
3_1830183,province_goias,1830183,3,1,0,1,0
3_5021833,eats_onion_ham,5021833,3,1,24,25,0
3_1473805,food_papaya,1473805,3,1,49,50,0
2_3262221,feast_intoxication_shrimp_onion_bavaria_guanabara,3262221,2,7,167,174,0
2_2162471,feast_satisfaction_wonderbread_ham_guanabara_bosnia,2162471,2,7,95,102,0
3_5388128,craves_satisfaction_ham,5388128,3,4,29,33,0
2_4670021,feast_lubricity_potato_shrimp_goias_bavaria,4670021,2,7,124,131,0
3_6280238,pleasure_satiety,6280238,3,1,165,166,0
3_7298434,eats_shrimp_turkey,7298434,3,1,24,25,0
3_7920783,craves_entertainment_wurst,7920783,3,1,10,11,0
3_4439469,eats_ham_wonderbread,4439469,3,1,12,13,0
2_3752572,noop_locale_turkey_goias,3752572,2,0,88,88,0
1_1607211,locale_turkey_goias,1607211,1,0,0,0,0
2_7253622,noop_fears_laceration_achievement,7253622,2,0,73,73,0
1_562209,fears_laceration_achievement,562209,1,0,1,1,0
3_5423156,food_endive,5423156,3,1,45,46,0
3_7894655,eats_arugula_wonderbread,7894655,3,1,4,5,0
2_3502772,feast_satiety_mutton_marzipan_goias_bavaria,3502772,2,7,223,230,0
2_4618372,feast_achievement_cherry_rice_bavaria_guanabara,4618372,2,7,105,112,0
2_3899522,feast_lubricity_marzipan_mutton_alsace_surrey,3899522,2,7,204,211,0
2_6526122,feast_achievement_marzipan_cherry_bosnia_alsace,6526122,2,7,143,150,0
2_5757972,feast_satiety_cherry_rice_bavaria_guanabara,5757972,2,7,119,126,0
2_7665722,feast_satiety_marzipan_cherry_bosnia_alsace,7665722,2,7,153,160,0
2_2509872,overcome_anger_lubricity_marzipan_earth_uranus,2509872,2,9,133,142,0
3_6638384,fears_anger_lubricity,6638384,3,1,38,39,0
3_6276535,eats_rice_marzipan,6276535,3,1,24,25,0
2_7099223,succumb_jealousy_satiety_rice_mercury_saturn,7099223,2,7,118,125,0
2_206823,succumb_dread_excitement_papaya_saturn_earth,206823,2,7,79,86,0
2_6601673,feast_satiety_mutton_ham_bavaria_guanabara,6601673,2,7,153,160,0
3_384409,craves_satiety_ham,384409,3,4,44,48,0
2_6760523,feast_intoxication_shrimp_potato_bosnia_alsace,6760523,2,7,192,199,0
2_505873,feast_lubricity_yogurt_wonderbread_guanabara_bosnia,505873,2,7,128,135,0
2_1679023,feast_excitement_rice_papaya_bavaria_guanabara,1679023,2,7,107,114,0
2_5465373,feast_intoxication_yogurt_potato_guanabara_bosnia,5465373,2,7,91,98,0
2_272773,overcome_angina_lubricity_onion_saturn_earth,272773,2,9,107,116,0
3_7762749,eats_endive_wurst,7762749,3,1,16,17,0
3_4692999,attacks_alsace_surrey,4692999,3,1,43,44,0
2_247124,noop_locale_potato_bavaria,247124,2,1,35,36,0
2_6315474,succumb_abrasion_satisfaction_yogurt_mercury_saturn,6315474,2,6,99,105,0
1_4797514,fears_abrasion_satisfaction,4797514,1,0,1,1,0
2_5425224,succumb_abrasion-4_rest_mutton_mercury_saturn,5425224,2,7,102,109,0
3_7255760,craves_abrasion-4_mutton,7255760,3,1,41,42,0
2_5395724,feast_excitement_marzipan_haroset_bosnia_alsace,5395724,2,7,145,152,0
2_3796624,feast_achievement_marzipan_rice_bosnia_alsace,3796624,2,7,143,150,0
2_6379374,feast_love_haroset_marzipan_bavaria_guanabara,6379374,2,7,158,165,0
2_7467524,feast_satisfaction_potato_arugula_bavaria_guanabara,7467524,2,7,83,90,0
2_5926924,feast_satiety_onion_shrimp_bosnia_alsace,5926924,2,7,197,204,0
3_4213322,craves_satiety_shrimp,4213322,3,2,53,55,0
2_735774,overcome_prostatitis_love_wurst_earth_uranus,735774,2,8,125,133,0
1_4217608,craves_love_wurst,4217608,1,0,1,1,0
3_2054340,fears_prostatitis_love,2054340,3,1,36,37,0
2_4454975,noop_craves_lubricity_yogurt,4454975,2,1,112,113,0
3_4452600,pain_depression-7,4452600,3,1,1,2,0
2_3073175,noop_fears_jealousy-2_rest,3073175,2,0,95,95,0
1_5863500,fears_jealousy-2_rest,5863500,1,0,1,1,0
2_4537425,succumb_grief_satiety_endive_mercury_saturn,4537425,2,7,114,121,0
2_1342175,feast_lubricity_yogurt_wonderbread_bavaria_guanabara,1342175,2,7,173,180,0
2_5489925,feast_lubricity_shrimp_turkey_bavaria_guanabara,5489925,2,7,166,173,0
2_6489375,feast_rest_arugula_wonderbread_alsace_surrey,6489375,2,7,176,183,0
2_792025,overcome_laceration-8_lubricity_haroset_earth_uranus,792025,2,9,106,115,0
3_7831322,fears_laceration-8_lubricity,7831322,3,1,34,35,0
3_6843000,pain_abrasion-4,6843000,3,1,0,1,0
2_6351126,succumb_abrasion-4_rest_wonderbread_mercury_saturn,6351126,2,7,102,109,0
3_6651610,craves_abrasion-4_wonderbread,6651610,3,1,39,40,0
2_1904476,feast_rest_shrimp_turkey_bosnia_alsace,1904476,2,7,214,221,0
2_2270476,feast_satisfaction_onion_marzipan_guanabara_bosnia,2270476,2,7,121,128,0
2_7899276,feast_excitement_marzipan_onion_alsace_surrey,7899276,2,7,181,188,0
2_7488476,feast_rest_marzipan_mutton_alsace_surrey,7488476,2,7,182,189,0
2_4313776,feast_intoxication_yogurt_wonderbread_guanabara_bosnia,4313776,2,7,91,98,0
2_4806077,succumb_loneliness_satisfaction_shrimp_mercury_saturn,4806077,2,7,111,118,0
3_7083984,craves_loneliness_shrimp,7083984,3,1,36,37,0
2_2829527,succumb_laceration_satiety_rice_mercury_saturn,2829527,2,7,125,132,0
3_5669574,craves_laceration_rice,5669574,3,1,43,44,0
2_6495327,feast_intoxication_shrimp_turkey_guanabara_bosnia,6495327,2,7,125,132,0
2_5395477,feast_satiety_cherry_endive_bavaria_guanabara,5395477,2,7,119,126,0
2_2387977,feast_lubricity_shrimp_onion_guanabara_bosnia,2387977,2,7,115,122,0
2_6419327,feast_lubricity_ham_wonderbread_goias_bavaria,6419327,2,7,136,143,0
2_1267677,overcome_sciatica_satisfaction_wonderbread_mercury_saturn,1267677,2,9,89,98,0
3_949448,fears_sciatica_satisfaction,949448,3,1,25,26,0
2_5255227,overcome_laceration-8_satiety_haroset_mercury_saturn,5255227,2,9,151,160,0
3_7479014,fears_laceration-8_satiety,7479014,3,1,38,39,0
2_3305677,overcome_hangover_love_papaya_saturn_earth,3305677,2,9,119,128,0
3_5370277,food_wurst,5370277,3,1,97,98,0
3_4744512,food_shrimp,4744512,3,1,93,94,0
2_7540328,noop_craves_intoxication_shrimp,7540328,2,1,94,95,0
2_456128,noop_fears_laceration_love,456128,2,0,110,110,0
1_3246453,fears_laceration_love,3246453,1,0,1,1,0
3_918250,pain_boils,918250,3,1,0,1,0
2_813878,succumb_hangover_excitement_wurst_earth_uranus,813878,2,7,84,91,0
3_5408021,craves_hangover_wurst,5408021,3,1,32,33,0
2_4038278,feast_excitement_marzipan_mutton_alsace_surrey,4038278,2,7,181,188,0
2_6455828,feast_intoxication_ham_mutton_bavaria_guanabara,6455828,2,7,170,177,0
3_4660192,craves_intoxication_mutton,4660192,3,2,31,33,0
2_2706978,feast_excitement_papaya_wurst_guanabara_bosnia,2706978,2,7,80,87,0
2_4069828,overcome_anger_rest_marzipan_mercury_saturn,4069828,2,9,105,114,0
3_4805298,fears_anger_rest,4805298,3,1,36,37,0
3_4074641,eats_shrimp_potato,4074641,3,1,24,25,0
2_2352679,noop_craves_love_endive,2352679,2,1,137,138,0
3_1737877,attacks_bosnia_alsace,1737877,3,1,149,150,0
3_778475,pain_hangover,778475,3,1,39,40,0
3_1840068,food_wonderbread,1840068,3,1,115,116,0
2_6704429,succumb_jealousy-2_intoxication_wonderbread_earth_uranus,6704429,2,7,84,91,0
2_7797629,succumb_hangover_love_papaya_earth_uranus,7797629,2,6,121,127,0
1_6026349,fears_hangover_love,6026349,1,0,1,1,0
2_4666379,feast_rest_shrimp_onion_bosnia_alsace,4666379,2,7,214,221,0
2_3099929,feast_excitement_cherry_marzipan_bosnia_alsace,3099929,2,7,217,224,0
2_93129,feast_satiety_haroset_turkey_bavaria_guanabara,93129,2,7,152,159,0
3_1465202,craves_satiety_turkey,1465202,3,1,36,37,0
2_1427479,feast_lubricity_marzipan_cherry_alsace_surrey,1427479,2,7,204,211,0
3_3958534,craves_lubricity_cherry,3958534,3,2,58,60,0
2_3102179,feast_lubricity_shrimp_onion_bavaria_guanabara,3102179,2,7,166,173,0
2_4261129,overcome_abrasion_intoxication_yogurt_earth_uranus,4261129,2,9,85,94,0
3_1699206,fears_abrasion_intoxication,1699206,3,1,25,26,0
2_1505179,overcome_anger_achievement_marzipan_saturn_earth,1505179,2,9,102,111,0
3_4333152,fears_anger_achievement,4333152,3,1,12,13,0
2_539530,noop_fears_boils-1_satisfaction,539530,2,0,96,96,0
1_7829991,fears_boils-1_satisfaction,7829991,1,0,1,1,0
3_2200903,pleasure_love,2200903,3,1,160,161,0
2_6975880,succumb_loneliness_satisfaction_arugula_mercury_saturn,6975880,2,7,111,118,0
3_5263566,craves_loneliness_arugula,5263566,3,1,34,35,0
2_1159330,feast_lubricity_onion_marzipan_guanabara_bosnia,1159330,2,7,124,131,0
2_5643580,feast_rest_wonderbread_ham_guanabara_bosnia,5643580,2,7,108,115,0
2_6548280,feast_achievement_rice_marzipan_bosnia_alsace,6548280,2,7,220,227,0
2_7759180,overcome_prostatitis_satiety_wurst_mercury_saturn,7759180,2,8,119,127,0
1_6055786,craves_satiety_wurst,6055786,1,0,1,1,0
3_3430109,fears_prostatitis_satiety,3430109,3,1,32,33,0
2_2617581,noop_craves_rest_marzipan,2617581,2,1,89,90,0
2_6825231,noop_locale_onion_bosnia,6825231,2,1,32,33,0
3_5397415,food_cherry,5397415,3,1,177,178,0
3_3412554,food_marzipan,3412554,3,1,142,143,0
2_4634731,succumb_laceration_achievement_cherry_saturn_earth,4634731,2,7,86,93,0
2_2157931,succumb_grief_achievement_cherry_saturn_earth,2157931,2,7,81,88,0
3_2853266,craves_grief_cherry,2853266,3,1,33,34,0
2_5976931,feast_rest_shrimp_onion_guanabara_bosnia,5976931,2,7,158,165,0
2_5995681,feast_intoxication_shrimp_potato_guanabara_bosnia,5995681,2,7,125,132,0
2_5305331,feast_lubricity_yogurt_potato_guanabara_bosnia,5305331,2,7,128,135,0
2_1269681,feast_rest_marzipan_onion_bosnia_alsace,1269681,2,7,146,153,0
2_5596181,feast_lubricity_shrimp_potato_bavaria_guanabara,5596181,2,7,166,173,0
2_6615081,overcome_boils-1_rest_arugula_mercury_saturn,6615081,2,9,123,132,0
3_6009981,fears_boils-1_rest,6009981,3,1,41,42,0
3_7414097,eats_wonderbread_yogurt,7414097,3,1,12,13,0
3_7203479,eats_marzipan_cherry,7203479,3,1,21,22,0
2_5366332,noop_fears_boils_satisfaction,5366332,2,0,95,95,0
1_6154015,fears_boils_satisfaction,6154015,1,0,1,1,0
2_5335732,noop_craves_lubricity_arugula,5335732,2,1,112,113,0
2_890482,succumb_boils_lubricity_potato_earth_uranus,890482,2,7,114,121,0
3_3711391,craves_boils_potato,3711391,3,1,39,40,0
2_2781132,succumb_boils-1_satisfaction_arugula_mercury_saturn,2781132,2,7,104,111,0
2_636882,feast_intoxication_arugula_wonderbread_bosnia_alsace,636882,2,7,89,96,0
2_1522582,feast_satisfaction_onion_ham_bosnia_alsace,1522582,2,7,151,158,0
2_4975932,feast_intoxication_wonderbread_ham_guanabara_bosnia,4975932,2,7,89,96,0
3_5265699,eats_cherry_rice,5265699,3,1,24,25,0
2_170733,noop_fears_hangover_love,170733,2,1,112,113,0
3_7865332,pain_dread,7865332,3,1,40,41,0
3_2216718,eats_potato_shrimp,2216718,3,1,12,13,0
3_1795018,eats_endive_cherry,1795018,3,1,16,17,0
2_1264033,noop_craves_love_wurst,1264033,2,1,107,108,0
2_3540833,succumb_prostatitis_excitement_wurst_earth_uranus,3540833,2,7,87,94,0
2_1147833,succumb_jealousy_love_cherry_earth_uranus,1147833,2,7,130,137,0
3_575897,craves_jealousy_cherry,575897,3,1,42,43,0
2_3068383,feast_lubricity_marzipan_onion_bosnia_alsace,3068383,2,7,174,181,0
2_1140983,feast_satisfaction_wonderbread_ham_bosnia_alsace,1140983,2,7,118,125,0
2_5016433,feast_rest_marzipan_cherry_alsace_surrey,5016433,2,7,182,189,0
2_7065083,feast_intoxication_ham_wonderbread_bavaria_guanabara,7065083,2,7,170,177,0
2_5057783,feast_excitement_papaya_rice_bavaria_guanabara,5057783,2,7,169,176,0
2_3335533,feast_achievement_endive_cherry_bavaria_guanabara,3335533,2,7,161,168,0
3_5428931,eats_cherry_marzipan,5428931,3,1,24,25,0
2_4894934,noop_fears_anxiety_satiety,4894934,2,0,100,100,0
1_7685259,fears_anxiety_satiety,7685259,1,0,1,1,0
2_1939434,succumb_dread_excitement_wurst_earth_uranus,1939434,2,7,84,91,0
3_6688887,craves_dread_wurst,6688887,3,1,33,34,0
2_5241834,feast_satisfaction_onion_ham_guanabara_bosnia,5241834,2,7,121,128,0
2_2663134,feast_satisfaction_onion_shrimp_bosnia_alsace,2663134,2,7,151,158,0
2_6473334,feast_lubricity_marzipan_cherry_bosnia_alsace,6473334,2,7,174,181,0
2_6090784,feast_lubricity_arugula_potato_guanabara_bosnia,6090784,2,7,182,189,0
2_4919884,feast_satisfaction_wonderbread_arugula_bosnia_alsace,4919884,2,7,118,125,0
2_3770784,feast_excitement_papaya_rice_guanabara_bosnia,3770784,2,7,80,87,0
2_1985834,feast_rest_arugula_potato_bosnia_alsace,1985834,2,7,131,138,0
2_1384184,feast_intoxication_potato_yogurt_goias_bavaria,1384184,2,7,102,109,0
2_576134,overcome_depression-7_love_haroset_earth_uranus,576134,2,9,157,166,0
3_1131397,fears_depression-7_love,1131397,3,1,40,41,0
2_4695684,overcome_jealousy-2_intoxication_wonderbread_saturn_earth,4695684,2,9,82,91,0
2_386984,overcome_anxiety_lubricity_marzipan_earth_uranus,386984,2,9,133,142,0
3_2652512,fears_anxiety_lubricity,2652512,3,1,38,39,0
2_6157934,overcome_jealousy_excitement_rice_saturn_earth,6157934,2,9,86,95,0
3_1766033,pleasure_intoxication,1766033,3,1,140,141,0
2_3665485,noop_locale_yogurt_guanabara,3665485,2,1,82,83,0
3_7801210,eats_wurst_papaya,7801210,3,1,0,1,0
3_7763559,pain_jealousy-2,7763559,3,1,16,17,0
2_7507585,succumb_boils-1_intoxication_potato_earth_uranus,7507585,2,7,90,97,0
3_6862421,craves_boils-1_potato,6862421,3,1,31,32,0
2_242885,succumb_prostatitis_achievement_wurst_saturn_earth,242885,2,6,85,91,0
1_3545441,fears_prostatitis_achievement,3545441,1,0,1,1,0
2_3000235,feast_excitement_cherry_endive_bavaria_guanabara,3000235,2,7,128,135,0
2_1566235,feast_excitement_marzipan_cherry_alsace_surrey,1566235,2,7,181,188,0
2_3443635,feast_achievement_marzipan_onion_bosnia_alsace,3443635,2,7,143,150,0
2_4627335,feast_satisfaction_wonderbread_yogurt_guanabara_bosnia,4627335,2,7,95,102,0
2_6335285,feast_lubricity_shrimp_turkey_guanabara_bosnia,6335285,2,7,115,122,0
2_5348635,feast_love_endive_wurst_guanabara_bosnia,5348635,2,7,155,162,0
2_623335,feast_lubricity_potato_arugula_goias_bavaria,623335,2,7,124,131,0
3_323738,food_rice,323738,3,1,201,202,0
2_1376386,noop_fears_depression_satiety,1376386,2,1,106,107,0
3_4985459,pain_sciatica,4985459,3,1,14,15,0
2_6486,noop_fears_jealousy_excitement,6486,2,0,75,75,0
1_1628909,fears_jealousy_excitement,1628909,1,0,1,1,0
2_102786,succumb_grief_achievement_wurst_saturn_earth,102786,2,7,81,88,0
3_5516608,craves_grief_wurst,5516608,3,1,29,30,0
2_5166036,feast_satiety_papaya_wurst_bosnia_alsace,5166036,2,7,171,178,0
2_3784536,feast_lubricity_arugula_potato_bosnia_alsace,3784536,2,7,135,142,0
2_686136,feast_intoxication_ham_onion_goias_bavaria,686136,2,7,112,119,0
2_3516386,feast_rest_ham_onion_goias_bavaria,3516386,2,7,98,105,0
2_910036,overcome_abrasion-4_intoxication_ham_earth_uranus,910036,2,9,106,115,0
3_847602,fears_abrasion-4_intoxication,847602,3,1,26,27,0
2_7640886,overcome_dread_love_papaya_saturn_earth,7640886,2,9,119,128,0
3_6440549,pleasure_lubricity,6440549,3,1,203,204,0
3_3810436,food_onion,3810436,3,1,189,190,0
2_2799837,noop_craves_lubricity_marzipan,2799837,2,1,117,118,0
2_7860087,feast_love_onion_shrimp_bosnia_alsace,7860087,2,7,203,210,0
2_3493087,feast_rest_marzipan_haroset_alsace_surrey,3493087,2,7,182,189,0
2_3248087,feast_love_marzipan_onion_bosnia_alsace,3248087,2,7,159,166,0
2_3281987,feast_satiety_onion_shrimp_guanabara_bosnia,3281987,2,7,169,176,0
2_2767387,overcome_angina_love_onion_earth_uranus,2767387,2,9,164,173,0
3_7699444,fears_angina_love,7699444,3,1,42,43,0
3_3474113,pain_laceration-8,3474113,3,1,11,12,0
2_5471088,feast_satisfaction_turkey_haroset_goias_bavaria,5471088,2,7,104,111,0
3_5167173,craves_satisfaction_haroset,5167173,3,1,33,34,0
2_6656688,feast_rest_shrimp_potato_bosnia_alsace,6656688,2,7,214,221,0
2_2683688,feast_satiety_rice_cherry_bavaria_guanabara,2683688,2,7,137,144,0
2_1727488,feast_rest_onion_ham_guanabara_bosnia,1727488,2,7,121,128,0
2_997188,feast_achievement_marzipan_mutton_bosnia_alsace,997188,2,7,143,150,0
2_3665438,feast_intoxication_ham_onion_bavaria_guanabara,3665438,2,7,170,177,0
2_2136788,feast_satiety_marzipan_mutton_bosnia_alsace,2136788,2,7,153,160,0
2_1544088,feast_achievement_rice_cherry_bavaria_guanabara,1544088,2,7,126,133,0
2_5225988,feast_achievement_rice_cherry_guanabara_bosnia,5225988,2,7,121,128,0
2_2201938,feast_lubricity_ham_onion_goias_bavaria,2201938,2,7,136,143,0
2_944538,feast_lubricity_ham_mutton_goias_bavaria,944538,2,7,136,143,0
2_1477938,overcome_angina_satisfaction_onion_mercury_saturn,1477938,2,9,105,114,0
3_1831103,fears_angina_satisfaction,1831103,3,1,25,26,0
2_3200789,noop_craves_satiety_wurst,3200789,2,1,101,102,0
3_1486223,pain_angina,1486223,3,1,23,24,0
3_7998514,pain_loneliness-3,7998514,3,1,42,43,0
2_2667139,noop_fears_abrasion_satisfaction,2667139,2,1,93,94,0
2_1682489,noop_craves_achievement_marzipan,1682489,2,1,86,87,0
3_6196362,pleasure_rest,6196362,3,1,166,167,0
3_197009,eats_wonderbread_ham,197009,3,1,12,13,0
3_6188452,food_ham,6188452,3,1,42,43,0
3_7897051,eats_turkey_shrimp,7897051,3,1,1,2,0
2_2566589,feast_excitement_cherry_rice_bosnia_alsace,2566589,2,7,217,224,0
2_2453239,feast_satiety_papaya_wurst_bavaria_guanabara,2453239,2,7,233,240,0
2_261339,feast_lubricity_arugula_wonderbread_alsace_surrey,261339,2,7,178,185,0
2_6943739,feast_love_marzipan_mutton_bosnia_alsace,6943739,2,7,159,166,0
2_5835639,feast_lubricity_shrimp_potato_guanabara_bosnia,5835639,2,7,115,122,0
2_7490639,feast_love_rice_cherry_bavaria_guanabara,7490639,2,7,125,132,0
2_3204139,feast_intoxication_potato_shrimp_goias_bavaria,3204139,2,7,102,109,0
2_6384339,overcome_depression-7_lubricity_haroset_earth_uranus,6384339,2,9,106,115,0
3_4201477,fears_depression-7_lubricity,4201477,3,1,34,35,0
2_4431939,overcome_depression_love_endive_earth_uranus,4431939,2,9,153,162,0
3_7179962,fears_depression_love,7179962,3,1,42,43,0
2_4140939,overcome_prostatitis_excitement_wurst_saturn_earth,4140939,2,9,85,94,0
2_5305240,noop_locale_marzipan_alsace,5305240,2,1,62,63,0
2_1413190,noop_fears_anxiety_love,1413190,2,1,104,105,0
2_1460940,feast_love_cherry_marzipan_bavaria_guanabara,1460940,2,7,143,150,0
2_4704340,feast_excitement_cherry_rice_bavaria_guanabara,4704340,2,7,128,135,0
2_6612090,feast_excitement_marzipan_cherry_bosnia_alsace,6612090,2,7,145,152,0
2_2491540,feast_love_onion_marzipan_bosnia_alsace,2491540,2,7,203,210,0
2_3396440,feast_rest_yogurt_wonderbread_bavaria_guanabara,3396440,2,7,185,192,0
2_5030440,feast_love_rice_cherry_guanabara_bosnia,5030440,2,7,124,131,0
2_4338091,noop_fears_prostatitis_achievement,4338091,2,1,81,82,0
2_3842841,succumb_boils_lubricity_onion_earth_uranus,3842841,2,7,114,121,0
3_6580064,craves_boils_onion,6580064,3,1,42,43,0
2_6578941,overcome_angina_satiety_onion_mercury_saturn,6578941,2,9,158,167,0
3_7641058,fears_angina_satiety,7641058,3,1,40,41,0
2_1017291,overcome_jealousy_achievement_rice_saturn_earth,1017291,2,9,106,115,0
3_3042878,fears_jealousy_achievement,3042878,3,1,33,34,0
3_1180739,pain_laceration,1180739,3,1,62,63,0
2_4866842,noop_locale_papaya_guanabara,4866842,2,1,121,122,0
2_7505392,noop_craves_love_mutton,7505392,2,1,152,153,0
2_1915992,noop_harmony_achievement_mercury,1915992,2,1,63,64,0
2_3721742,noop_fears_sciatica_intoxication,3721742,2,0,73,73,0
1_5852117,fears_sciatica_intoxication,5852117,1,0,1,1,0
2_6471092,succumb_loneliness-3_rest_onion_mercury_saturn,6471092,2,7,102,109,0
3_2113012,craves_loneliness-3_onion,2113012,3,1,42,43,0
2_2830692,succumb_jealousy_love_marzipan_earth_uranus,2830692,2,7,130,137,0
3_2993567,craves_jealousy_marzipan,2993567,3,1,44,45,0
2_6455792,feast_intoxication_shrimp_turkey_bavaria_guanabara,6455792,2,7,167,174,0
2_5853942,feast_lubricity_yogurt_potato_bavaria_guanabara,5853942,2,7,173,180,0
2_2344992,feast_achievement_marzipan_haroset_alsace_surrey,2344992,2,7,179,186,0
3_3695108,craves_achievement_haroset,3695108,3,2,39,41,0
2_1402192,feast_rest_ham_mutton_goias_bavaria,1402192,2,7,98,105,0
2_614292,feast_satiety_onion_ham_bosnia_alsace,614292,2,7,197,204,0
2_3154392,overcome_boils-1_intoxication_arugula_saturn_earth,3154392,2,9,78,87,0
3_2932032,pleasure_excitement,2932032,3,1,156,157,0
2_7558443,noop_fears_loneliness_lubricity,7558443,2,1,99,100,0
2_4938993,noop_craves_satisfaction_wonderbread,4938993,2,1,76,77,0
3_1370260,pain_anxiety,1370260,3,1,31,32,0
2_1000943,succumb_sciatica_intoxication_wonderbread_earth_uranus,1000943,2,7,84,91,0
2_6891593,feast_satiety_cherry_marzipan_bavaria_guanabara,6891593,2,7,119,126,0
2_5764793,feast_satisfaction_wonderbread_yogurt_bosnia_alsace,5764793,2,7,118,125,0
2_4654543,overcome_sciatica_intoxication_wonderbread_saturn_earth,4654543,2,9,82,91,0
3_3456443,pain_grief,3456443,3,1,41,42,0
3_5631791,pain_loneliness,5631791,3,1,49,50,0
3_6892927,attacks_guanabara_bosnia,6892927,3,1,169,170,0
3_2180706,eats_ham_onion,2180706,3,1,12,13,0
2_4019094,succumb_laceration_love_cherry_earth_uranus,4019094,2,7,123,130,0
2_3478144,succumb_jealousy_excitement_rice_earth_uranus,3478144,2,7,88,95,0
2_1250244,succumb_anger_satiety_marzipan_mercury_saturn,1250244,2,7,114,121,0
2_3479644,feast_excitement_cherry_marzipan_bavaria_guanabara,3479644,2,7,128,135,0
2_4456544,feast_satiety_haroset_marzipan_bavaria_guanabara,4456544,2,7,152,159,0
2_5775144,feast_satiety_papaya_rice_guanabara_bosnia,5775144,2,7,149,156,0
2_5307194,feast_lubricity_arugula_wonderbread_bosnia_alsace,5307194,2,7,135,142,0
2_7129944,feast_satisfaction_potato_shrimp_bavaria_guanabara,7129944,2,7,83,90,0
2_6881144,feast_satisfaction_potato_arugula_goias_bavaria,6881144,2,7,84,91,0
2_7541545,noop_locale_endive_guanabara,7541545,2,1,113,114,0
3_4018670,eats_shrimp_onion,4018670,3,1,24,25,0
2_1496995,succumb_boils_lubricity_turkey_earth_uranus,1496995,2,7,114,121,0
3_6935184,craves_boils_turkey,6935184,3,1,39,40,0
2_3681945,succumb_angina_rest_onion_mercury_saturn,3681945,2,7,107,114,0
2_1108045,feast_excitement_cherry_marzipan_guanabara_bosnia,1108045,2,7,123,130,0
2_7604645,feast_satiety_mutton_ham_goias_bavaria,7604645,2,7,223,230,0
2_2776295,feast_satiety_mutton_marzipan_bavaria_guanabara,2776295,2,7,153,160,0
2_1689195,feast_achievement_cherry_endive_bavaria_guanabara,1689195,2,7,105,112,0
2_6215745,feast_satiety_cherry_marzipan_guanabara_bosnia,6215745,2,7,118,125,0
3_492931,locale_wurst_goias,492931,3,1,0,1,0
2_6726996,succumb_abrasion-4_rest_onion_mercury_saturn,6726996,2,7,102,109,0
3_703339,craves_abrasion-4_onion,703339,3,1,44,45,0
2_7501196,succumb_jealousy_love_papaya_earth_uranus,7501196,2,7,130,137,0
3_4653264,craves_jealousy_papaya,4653264,3,1,40,41,0
2_2563946,feast_love_cherry_rice_bavaria_guanabara,2563946,2,7,143,150,0
2_1878096,feast_lubricity_marzipan_haroset_bosnia_alsace,1878096,2,7,174,181,0
2_419746,feast_lubricity_marzipan_rice_bosnia_alsace,419746,2,7,174,181,0
2_6751746,feast_achievement_marzipan_rice_alsace_surrey,6751746,2,7,179,186,0
2_2901246,feast_love_mutton_ham_bavaria_guanabara,2901246,2,7,159,166,0
2_308746,feast_love_mutton_marzipan_goias_bavaria,308746,2,7,229,236,0
2_1521296,feast_love_marzipan_haroset_bosnia_alsace,1521296,2,7,159,166,0
2_4471696,feast_love_marzipan_cherry_bosnia_alsace,4471696,2,7,159,166,0
2_1050646,feast_love_rice_marzipan_bavaria_guanabara,1050646,2,7,125,132,0
2_4286446,feast_love_rice_marzipan_guanabara_bosnia,4286446,2,7,124,131,0
2_6073996,overcome_dread_satiety_papaya_mercury_saturn,6073996,2,9,149,158,0
3_4573088,fears_dread_satiety,4573088,3,1,42,43,0
3_7813070,pain_abrasion,7813070,3,1,12,13,0
2_819297,noop_harmony_excitement_saturn,819297,2,1,65,66,0
2_4774347,succumb_jealousy-2_rest_wonderbread_mercury_saturn,4774347,2,7,105,112,0
2_7390847,feast_achievement_marzipan_haroset_bosnia_alsace,7390847,2,7,143,150,0
2_2680647,feast_lubricity_haroset_marzipan_bavaria_guanabara,2680647,2,7,108,115,0
2_504647,feast_satiety_onion_ham_guanabara_bosnia,504647,2,7,169,176,0
2_386897,overcome_hangover_satiety_papaya_mercury_saturn,386897,2,9,149,158,0
3_7052500,fears_hangover_satiety,7052500,3,1,3,4,0
2_4676598,noop_fears_loneliness_intoxication,4676598,2,1,77,78,0
3_506446,eats_papaya_wurst,506446,3,1,16,17,0
2_6000798,noop_locale_arugula_bosnia,6000798,2,1,93,94,0
2_1640948,noop_craves_satiety_onion,1640948,2,1,145,146,0
3_346337,eats_arugula_potato,346337,3,1,16,17,0
3_5509864,eats_rice_papaya,5509864,3,1,24,25,0
2_249498,noop_craves_excitement_marzipan,249498,2,1,88,89,0
2_1762048,feast_rest_shrimp_onion_bavaria_guanabara,1762048,2,7,216,223,0
2_5363348,feast_excitement_cherry_rice_guanabara_bosnia,5363348,2,7,123,130,0
2_6562048,feast_intoxication_shrimp_potato_bavaria_guanabara,6562048,2,7,167,174,0
2_3092298,feast_satiety_marzipan_haroset_bosnia_alsace,3092298,2,7,153,160,0
2_1197398,overcome_laceration-8_love_haroset_earth_uranus,1197398,2,9,157,166,0
3_7530995,fears_laceration-8_love,7530995,3,1,40,41,0
3_2211538,eats_onion_marzipan,2211538,3,1,24,25,0
2_5109349,noop_craves_rest_yogurt,5109349,2,1,108,109,0
3_7159023,pain_depression,7159023,3,1,41,42,0
3_7480922,planet_uranus,7480922,3,1,132,133,0
2_7635499,succumb_anxiety_satiety_marzipan_mercury_saturn,7635499,2,7,114,121,0
2_5408149,succumb_dread_excitement_rice_earth_uranus,5408149,2,7,84,91,0
3_6767175,craves_dread_rice,6767175,3,1,33,34,0
2_2253099,succumb_boils_satisfaction_shrimp_mercury_saturn,2253099,2,7,105,112,0
2_482599,feast_satisfaction_turkey_shrimp_goias_bavaria,482599,2,7,104,111,0
2_4947099,feast_intoxication_ham_mutton_goias_bavaria,4947099,2,7,112,119,0
2_2089599,feast_lubricity_onion_shrimp_guanabara_bosnia,2089599,2,7,124,131,0
2_3868099,feast_lubricity_haroset_turkey_bavaria_guanabara,3868099,2,7,108,115,0
2_46149,feast_intoxication_yogurt_wonderbread_bavaria_guanabara,46149,2,7,147,154,0
2_5089849,overcome_grief_love_endive_earth_uranus,5089849,2,9,153,162,0
3_5019078,fears_grief_love,5019078,3,1,43,44,0
4_783834,noop_craves_rest_haroset,783834,4,378,0,378,0
4_4863440,feast_rest_haroset_marzipan_bavaria_guanabara,4863440,4,412,0,412,0
4_4350944,feast_rest_haroset_marzipan_goias_bavaria,4350944,4,404,0,404,0
4_3767412,feast_rest_haroset_turkey_bavaria_guanabara,3767412,4,412,0,412,0
4_2767994,feast_rest_haroset_turkey_goias_bavaria,2767994,4,404,0,404,0
4_2592702,overcome_depression-7_rest_haroset_mercury_saturn,2592702,4,401,0,401,0
4_778253,overcome_laceration-8_rest_haroset_mercury_saturn,778253,4,401,0,401,0
4_2689598,craves_rest_arugula,2689598,4,40,50,90,0
4_4805298,fears_anger_rest,4805298,4,37,60,97,0
4_1490646,craves_excitement_haroset,1490646,4,43,38,81,0
4_6284244,craves_rest_ham,6284244,4,37,42,79,0
4_6166792,craves_loneliness-3_wonderbread,6166792,4,40,57,97,0
4_1149340,craves_rest_wonderbread,1149340,4,41,49,90,0
4_703339,craves_abrasion-4_onion,703339,4,45,60,105,0
4_1131734,craves_rest_yogurt,1131734,4,38,46,84,0
4_1431034,fears_anxiety_rest,1431034,4,37,60,97,0
4_3958534,craves_lubricity_cherry,3958534,4,61,45,106,0
4_1403882,craves_rest_mutton,1403882,4,34,43,77,0
4_6351782,craves_achievement_onion,6351782,4,47,38,85,0
4_825382,craves_rest_turkey,825382,4,49,48,97,0
4_6009981,fears_boils-1_rest,6009981,4,44,58,102,0
4_5080331,craves_achievement_mutton,5080331,4,42,38,80,0
4_164979,fears_abrasion-4_rest,164979,4,36,53,89,0
4_3509029,craves_excitement_mutton,3509029,4,43,36,79,0
4_5472578,craves_rest_marzipan,5472578,4,54,45,99,0
4_3693926,fears_angina_rest,3693926,4,37,51,88,0
4_1105319,fears_loneliness-3_rest,1105319,4,36,53,89,0
4_6533167,craves_excitement_onion,6533167,4,48,32,80,0
4_5602566,craves_rest_potato,5602566,4,51,43,94,0
4_2459414,locale_marzipan_surrey,2459414,4,67,104,171,0
4_1005562,craves_lubricity_rice,1005562,4,61,45,106,0
4_2113012,craves_loneliness-3_onion,2113012,4,45,54,99,0
4_6651610,craves_abrasion-4_wonderbread,6651610,4,40,53,93,0
4_7255760,craves_abrasion-4_mutton,7255760,4,42,57,99,0
4_1126409,locale_ham_guanabara,1126409,4,48,52,100,0
4_843559,craves_rest_rice,843559,4,58,53,111,0
4_3695108,craves_achievement_haroset,3695108,4,42,34,76,0
4_87106,craves_loneliness-3_mutton,87106,4,42,57,99,0
4_2914055,harmony_rest_mercury,2914055,4,82,23,105,0
4_4226405,craves_rest_cherry,4226405,4,58,44,102,0
4_3948803,fears_sciatica_rest,3948803,4,35,46,81,0
4_868003,craves_rest_onion,868003,4,42,38,80,0
4_3664603,fears_abrasion_rest,3664603,4,40,57,97,0
4_5493103,fears_boils_rest,5493103,4,50,52,102,0
4_3573502,craves_rest_shrimp,3573502,4,46,39,85,0
4_5863500,fears_jealousy-2_rest,5863500,4,35,39,74,0
4_4816253,noop_fears_hangover_satiety,4816253,4,332,0,332,0
4_4016940,succumb_hangover_satiety_papaya_mercury_saturn,4016940,4,347,0,347,0
4_6026349,fears_hangover_love,6026349,4,42,37,79,0
4_3477698,fears_grief_satiety,3477698,4,37,45,82,0
4_2909346,fears_anger_satiety,2909346,4,36,43,79,0
4_4495945,craves_satiety_onion,4495945,4,43,33,76,0
4_3206743,fears_hangover_excitement,3206743,4,26,29,55,0
4_6357293,craves_excitement_endive,6357293,4,40,39,79,0
4_3135292,craves_hangover_papaya,3135292,4,19,17,36,0
4_3595641,craves_satiety_marzipan,3595641,4,52,41,93,0
4_4573088,fears_dread_satiety,4573088,4,45,45,90,0
4_6055786,craves_satiety_wurst,6055786,4,31,28,59,0
4_4824435,craves_hangover_rice,4824435,4,38,17,55,0
4_5571930,fears_anger_excitement,5571930,4,35,41,76,0
4_2289980,craves_laceration_marzipan,2289980,4,49,21,70,0
4_1272578,locale_cherry_alsace,1272578,4,60,76,136,0
4_1312777,fears_anxiety_excitement,1312777,4,35,41,76,0
4_166176,fears_depression-7_satiety,166176,4,40,43,83,0
4_7973276,locale_endive_bavaria,7973276,4,51,4,55,0
4_3350376,craves_laceration_endive,3350376,4,43,17,60,0
4_4866225,craves_satiety_cherry,4866225,4,43,31,74,0
4_5669574,craves_laceration_rice,5669574,4,48,20,68,0
4_4213322,craves_satiety_shrimp,4213322,4,55,41,96,0
4_5408021,craves_hangover_wurst,5408021,4,36,13,49,0
4_2164069,fears_depression_satiety,2164069,4,37,42,79,0
4_2484468,fears_laceration_satiety,2484468,4,35,33,68,0
4_4891966,craves_satiety_endive,4891966,4,35,30,65,0
4_4531615,harmony_satiety_saturn,4531615,4,86,26,112,0
4_7479014,fears_laceration-8_satiety,7479014,4,40,43,83,0
4_7685259,fears_anxiety_satiety,7685259,4,36,37,73,0
4_3605459,fears_jealousy_satiety,3605459,4,40,41,81,0
4_541159,locale_rice_alsace,541159,4,60,64,124,0
4_3430109,fears_prostatitis_satiety,3430109,4,36,40,76,0
4_384409,craves_satiety_ham,384409,4,47,35,82,0
4_7641058,fears_angina_satiety,7641058,4,42,46,88,0
4_6026007,fears_laceration_excitement,6026007,4,42,38,80,0
4_2412853,craves_satiety_haroset,2412853,4,32,29,61,0
4_2043702,craves_satiety_mutton,2043702,4,35,28,63,0
4_2670452,craves_satiety_rice,2670452,4,45,27,72,0
4_1465202,craves_satiety_turkey,1465202,4,46,32,78,0
4_2326938,noop_craves_love_cherry,2326938,4,255,0,255,0
4_5858173,succumb_anxiety_love_cherry_saturn_earth,5858173,4,323,0,323,0
4_2507873,succumb_anxiety_love_cherry_earth_uranus,2507873,4,323,0,323,0
4_7369394,succumb_laceration_love_cherry_saturn_earth,7369394,4,350,0,350,0
4_4019094,succumb_laceration_love_cherry_earth_uranus,4019094,4,350,0,350,0
4_4498133,succumb_jealousy_love_cherry_saturn_earth,4498133,4,320,0,320,0
4_1147833,succumb_jealousy_love_cherry_earth_uranus,1147833,4,313,0,313,0
4_732995,succumb_anger_love_cherry_saturn_earth,732995,4,323,0,323,0
4_5383672,succumb_anger_love_cherry_earth_uranus,5383672,4,323,0,323,0
4_1460940,feast_love_cherry_marzipan_bavaria_guanabara,1460940,4,344,0,344,0
4_5600709,feast_love_cherry_marzipan_guanabara_bosnia,5600709,4,344,0,344,0
4_959535,feast_love_cherry_marzipan_bosnia_alsace,959535,4,635,0,635,0
4_3666599,feast_love_cherry_marzipan_goias_bavaria,3666599,4,367,0,367,0
4_3267815,feast_love_cherry_endive_bavaria_guanabara,3267815,4,344,0,344,0
4_4263853,feast_love_cherry_endive_guanabara_bosnia,4263853,4,344,0,344,0
4_1547814,feast_love_cherry_endive_bosnia_alsace,1547814,4,635,0,635,0
4_4254878,feast_love_cherry_endive_goias_bavaria,4254878,4,367,0,367,0
4_2563946,feast_love_cherry_rice_bavaria_guanabara,2563946,4,344,0,344,0
4_3667281,feast_love_cherry_rice_guanabara_bosnia,3667281,4,344,0,344,0
4_4786443,feast_love_cherry_rice_bosnia_alsace,4786443,4,635,0,635,0
4_7493507,feast_love_cherry_rice_goias_bavaria,7493507,4,367,0,367,0
4_5711594,overcome_depression_love_cherry_mercury_saturn,5711594,4,489,0,489,0
4_3038826,overcome_depression_love_cherry_saturn_earth,3038826,4,484,0,484,0
4_7689503,overcome_depression_love_cherry_earth_uranus,7689503,4,481,0,481,0
4_1306558,overcome_jealousy_love_cherry_earth_uranus,1306558,4,341,0,341,0
4_2489388,overcome_laceration_love_cherry_mercury_saturn,2489388,4,350,0,350,0
4_299917,overcome_laceration_love_cherry_saturn_earth,299917,4,343,0,343,0
4_4950594,overcome_laceration_love_cherry_earth_uranus,4950594,4,338,0,338,0
4_5236301,overcome_grief_love_cherry_mercury_saturn,5236301,4,489,0,489,0
4_3696736,overcome_grief_love_cherry_saturn_earth,3696736,4,484,0,484,0
4_346436,overcome_grief_love_cherry_earth_uranus,346436,4,481,0,481,0
4_1131397,fears_depression-7_love,1131397,4,42,41,83,0
4_5697397,craves_love_shrimp,5697397,4,56,46,102,0
4_7530995,fears_laceration-8_love,7530995,4,42,41,83,0
4_7699444,fears_angina_love,7699444,4,44,42,86,0
4_804392,fears_dread_love,804392,4,42,37,79,0
4_6376041,craves_love_endive,6376041,4,38,35,73,0
4_2426690,craves_love_papaya,2426690,4,35,34,69,0
4_2054340,fears_prostatitis_love,2054340,4,38,39,77,0
4_5019078,fears_grief_love,5019078,4,50,37,87,0
4_2949277,craves_love_turkey,2949277,4,47,34,81,0
4_2533325,craves_love_ham,2533325,4,48,40,88,0
4_2993567,craves_jealousy_marzipan,2993567,4,48,18,66,0
4_4653264,craves_jealousy_papaya,4653264,4,45,16,61,0
4_7179962,fears_depression_love,7179962,4,50,37,87,0
4_4217608,craves_love_wurst,4217608,4,32,29,61,0
4_2657767,craves_love_onion,2657767,4,44,28,72,0
4_3527777,craves_love_mutton,3527777,4,36,32,68,0
4_4058429,craves_love_marzipan,4058429,4,52,36,88,0
4_6290134,craves_love_haroset,6290134,4,33,34,67,0
4_725535,craves_love_rice,725535,4,43,40,83,0
4_6427428,noop_pain_boils,6427428,4,0,0,0,0
4_3827038,succumb_boils_rest_shrimp_mercury_saturn,3827038,4,393,0,393,0
4_5680213,succumb_boils_lubricity_marzipan_earth_uranus,5680213,4,286,0,286,0
4_1496995,succumb_boils_lubricity_turkey_earth_uranus,1496995,4,287,0,287,0
4_4951852,succumb_boils_lubricity_yogurt_earth_uranus,4951852,4,296,0,296,0
4_4783042,succumb_boils_lubricity_arugula_earth_uranus,4783042,4,296,0,296,0
4_2214767,succumb_boils_lubricity_shrimp_saturn_earth,2214767,4,269,0,269,0
4_6865444,succumb_boils_lubricity_shrimp_earth_uranus,6865444,4,269,0,269,0
4_7193141,succumb_boils_lubricity_onion_saturn_earth,7193141,4,286,0,286,0
4_3842841,succumb_boils_lubricity_onion_earth_uranus,3842841,4,286,0,286,0
4_7207933,succumb_boils_lubricity_haroset_earth_uranus,7207933,4,287,0,287,0
4_4240782,succumb_boils_lubricity_potato_saturn_earth,4240782,4,286,0,286,0
4_890482,succumb_boils_lubricity_potato_earth_uranus,890482,4,286,0,286,0
4_4190873,succumb_boils_lubricity_ham_earth_uranus,4190873,4,308,0,308,0
4_6541355,succumb_boils_intoxication_shrimp_earth_uranus,6541355,4,243,0,243,0
4_2541056,succumb_boils_satisfaction_turkey_mercury_saturn,2541056,4,275,0,275,0
4_5042589,succumb_boils_satisfaction_onion_mercury_saturn,5042589,4,275,0,275,0
4_2253099,succumb_boils_satisfaction_shrimp_mercury_saturn,2253099,4,259,0,259,0
4_2958824,succumb_boils_satisfaction_potato_mercury_saturn,2958824,4,259,0,259,0
4_7375013,overcome_boils_love_onion_saturn_earth,7375013,4,593,0,593,0
4_4024713,overcome_boils_love_onion_earth_uranus,4024713,4,597,0,597,0
4_5418814,overcome_boils_love_shrimp_earth_uranus,5418814,4,454,0,454,0
4_50365,overcome_boils_love_turkey_earth_uranus,50365,4,645,0,645,0
4_2080970,overcome_boils_rest_onion_mercury_saturn,2080970,4,519,0,519,0
4_4171450,overcome_boils_rest_shrimp_mercury_saturn,4171450,4,348,0,348,0
4_4459407,overcome_boils_rest_turkey_mercury_saturn,4459407,4,568,0,568,0
4_4877175,overcome_boils_rest_potato_mercury_saturn,4877175,4,537,0,537,0
4_6927360,overcome_boils_excitement_onion_earth_uranus,6927360,4,618,0,618,0
4_4555849,overcome_boils_achievement_onion_saturn_earth,4555849,4,619,0,619,0
4_451983,overcome_boils_intoxication_onion_earth_uranus,451983,4,448,0,448,0
4_2911312,overcome_boils_intoxication_shrimp_earth_uranus,2911312,4,241,0,241,0
4_6261612,overcome_boils_intoxication_shrimp_saturn_earth,6261612,4,239,0,239,0
4_5543840,overcome_boils_intoxication_turkey_earth_uranus,5543840,4,468,0,468,0
4_4937327,overcome_boils_intoxication_potato_earth_uranus,4937327,4,446,0,446,0
4_5129769,overcome_boils_intoxication_potato_mercury_saturn,5129769,4,448,0,448,0
4_286650,overcome_boils_intoxication_potato_saturn_earth,286650,4,448,0,448,0
4_6127047,overcome_boils_satiety_onion_mercury_saturn,6127047,4,545,0,545,0
4_7841129,overcome_boils_satiety_shrimp_mercury_saturn,7841129,4,402,0,402,0
4_128109,overcome_boils_satiety_turkey_mercury_saturn,128109,4,593,0,593,0
4_3864913,overcome_boils_satisfaction_onion_mercury_saturn,3864913,4,454,0,454,0
4_4805169,overcome_boils_satisfaction_shrimp_mercury_saturn,4805169,4,222,0,222,0
4_5093126,overcome_boils_satisfaction_turkey_mercury_saturn,5093126,4,464,0,464,0
4_5510894,overcome_boils_satisfaction_potato_mercury_saturn,5510894,4,438,0,438,0
4_4471556,overcome_boils_lubricity_onion_earth_uranus,4471556,4,305,0,305,0
4_7796944,overcome_boils_lubricity_shrimp_earth_uranus,7796944,4,273,0,273,0
4_6105210,overcome_boils_lubricity_shrimp_mercury_saturn,6105210,4,271,0,271,0
4_3146267,overcome_boils_lubricity_shrimp_saturn_earth,3146267,4,271,0,271,0
4_2428495,overcome_boils_lubricity_turkey_earth_uranus,2428495,4,305,0,305,0
4_1821982,overcome_boils_lubricity_potato_earth_uranus,1821982,4,305,0,305,0
4_145726,noop_pain_abrasion-4,145726,4,0,0,0,0
4_6358943,succumb_abrasion-4_intoxication_ham_earth_uranus,6358943,4,237,0,237,0
4_1408533,succumb_abrasion-4_rest_shrimp_mercury_saturn,1408533,4,308,0,308,0
4_6726996,succumb_abrasion-4_rest_onion_mercury_saturn,6726996,4,285,0,285,0
4_7946239,succumb_abrasion-4_rest_marzipan_mercury_saturn,7946239,4,285,0,285,0
4_5425224,succumb_abrasion-4_rest_mutton_mercury_saturn,5425224,4,285,0,285,0
4_7557696,succumb_abrasion-4_rest_yogurt_mercury_saturn,7557696,4,296,0,296,0
4_6351126,succumb_abrasion-4_rest_wonderbread_mercury_saturn,6351126,4,285,0,285,0
4_5831263,succumb_abrasion-4_rest_ham_mercury_saturn,5831263,4,269,0,269,0
4_1310132,succumb_abrasion-4_rest_arugula_mercury_saturn,1310132,4,296,0,296,0
4_1772368,succumb_abrasion-4_lubricity_ham_earth_uranus,1772368,4,339,0,339,0
4_7007189,overcome_abrasion-4_love_mutton_saturn_earth,7007189,4,584,0,584,0
4_3656889,overcome_abrasion-4_love_mutton_earth_uranus,3656889,4,587,0,587,0
4_4407451,overcome_abrasion-4_love_ham_earth_uranus,4407451,4,411,0,411,0
4_7115751,overcome_abrasion-4_love_onion_saturn_earth,7115751,4,576,0,576,0
4_3765451,overcome_abrasion-4_love_onion_earth_uranus,3765451,4,580,0,580,0
4_4754714,overcome_abrasion-4_rest_mutton_mercury_saturn,4754714,4,288,0,288,0
4_6387438,overcome_abrasion-4_rest_wonderbread_mercury_saturn,6387438,4,288,0,288,0
4_6459978,overcome_abrasion-4_rest_ham_mercury_saturn,6459978,4,271,0,271,0
4_5161686,overcome_abrasion-4_rest_onion_mercury_saturn,5161686,4,288,0,288,0
4_1915570,overcome_abrasion-4_excitement_mutton_earth_uranus,1915570,4,596,0,596,0
4_6477731,overcome_abrasion-4_excitement_onion_earth_uranus,6477731,4,589,0,589,0
4_463561,overcome_abrasion-4_achievement_mutton_saturn_earth,463561,4,597,0,597,0
4_1464503,overcome_abrasion-4_achievement_onion_saturn_earth,1464503,4,590,0,590,0
4_1799804,overcome_abrasion-4_intoxication_mutton_earth_uranus,1799804,4,446,0,446,0
4_6001224,overcome_abrasion-4_intoxication_wonderbread_earth_uranus,6001224,4,428,0,428,0
4_169006,overcome_abrasion-4_intoxication_wonderbread_mercury_saturn,169006,4,429,0,429,0
4_1350547,overcome_abrasion-4_intoxication_wonderbread_saturn_earth,1350547,4,429,0,429,0
4_910036,overcome_abrasion-4_intoxication_ham_earth_uranus,910036,4,235,0,235,0
4_4260336,overcome_abrasion-4_intoxication_ham_saturn_earth,4260336,4,231,0,231,0
4_1164130,overcome_abrasion-4_intoxication_onion_earth_uranus,1164130,4,432,0,432,0
4_3407214,overcome_abrasion-4_satiety_mutton_mercury_saturn,3407214,4,538,0,538,0
4_3178806,overcome_abrasion-4_satiety_ham_mercury_saturn,3178806,4,360,0,360,0
4_4531346,overcome_abrasion-4_satiety_onion_mercury_saturn,4531346,4,531,0,531,0
4_1026372,overcome_abrasion-4_satisfaction_wonderbread_mercury_saturn,1026372,4,451,0,451,0
4_7217643,overcome_abrasion-4_satisfaction_ham_mercury_saturn,7217643,4,231,0,231,0
4_5431864,overcome_abrasion-4_satisfaction_onion_mercury_saturn,5431864,4,462,0,462,0
4_7948646,overcome_abrasion-4_lubricity_mutton_earth_uranus,7948646,4,545,0,545,0
4_5911679,overcome_abrasion-4_lubricity_wonderbread_earth_uranus,5911679,4,518,0,518,0
4_1101858,overcome_abrasion-4_lubricity_ham_earth_uranus,1101858,4,336,0,336,0
4_4452158,overcome_abrasion-4_lubricity_ham_saturn_earth,4452158,4,333,0,333,0
4_2875855,overcome_abrasion-4_lubricity_onion_earth_uranus,2875855,4,511,0,511,0
4_997422,overcome_abrasion-4_lubricity_onion_mercury_saturn,997422,4,518,0,518,0
4_6226155,overcome_abrasion-4_lubricity_onion_saturn_earth,6226155,4,518,0,518,0
4_1499025,noop_pain_depression-7,1499025,4,0,0,0,0
4_1551669,succumb_depression-7_satiety_haroset_mercury_saturn,1551669,4,324,0,324,0
4_5089444,succumb_depression-7_lubricity_haroset_earth_uranus,5089444,4,300,0,300,0
4_4206177,succumb_depression-7_love_haroset_earth_uranus,4206177,4,376,0,376,0
4_3926434,overcome_depression-7_love_haroset_saturn_earth,3926434,4,341,0,341,0
4_576134,overcome_depression-7_love_haroset_earth_uranus,576134,4,345,0,345,0
4_7417060,overcome_depression-7_excitement_haroset_earth_uranus,7417060,4,387,0,387,0
4_5258399,overcome_depression-7_achievement_haroset_saturn_earth,5258399,4,388,0,388,0
4_2846564,overcome_depression-7_satiety_haroset_mercury_saturn,2846564,4,293,0,293,0
4_2793540,overcome_depression-7_satisfaction_haroset_mercury_saturn,2793540,4,242,0,242,0
4_6384339,overcome_depression-7_lubricity_haroset_earth_uranus,6384339,4,285,0,285,0
4_1733662,overcome_depression-7_lubricity_haroset_saturn_earth,1733662,4,283,0,283,0
4_2072975,noop_craves_intoxication_arugula,2072975,4,149,0,149,0
4_686471,succumb_sciatica_intoxication_arugula_saturn_earth,686471,4,191,0,191,0
4_5337148,succumb_sciatica_intoxication_arugula_earth_uranus,5337148,4,191,0,191,0
4_5904586,succumb_boils-1_intoxication_arugula_saturn_earth,5904586,4,185,0,185,0
4_2554286,succumb_boils-1_intoxication_arugula_earth_uranus,2554286,4,185,0,185,0
4_6942928,succumb_jealousy-2_intoxication_arugula_saturn_earth,6942928,4,191,0,191,0
4_3592628,succumb_jealousy-2_intoxication_arugula_earth_uranus,3592628,4,191,0,191,0
4_5623854,succumb_loneliness_intoxication_arugula_saturn_earth,5623854,4,220,0,220,0
4_2273554,succumb_loneliness_intoxication_arugula_earth_uranus,2273554,4,220,0,220,0
4_636882,feast_intoxication_arugula_wonderbread_bosnia_alsace,636882,4,198,0,198,0
4_3592004,feast_intoxication_arugula_wonderbread_alsace_surrey,3592004,4,201,0,201,0
4_719918,feast_intoxication_arugula_wonderbread_bavaria_guanabara,719918,4,310,0,310,0
4_7535551,feast_intoxication_arugula_wonderbread_guanabara_bosnia,7535551,4,198,0,198,0
4_4564663,feast_intoxication_arugula_potato_bosnia_alsace,4564663,4,198,0,198,0
4_7519785,feast_intoxication_arugula_potato_alsace_surrey,7519785,4,201,0,201,0
4_6137150,feast_intoxication_arugula_potato_bavaria_guanabara,6137150,4,310,0,310,0
4_7056651,feast_intoxication_arugula_potato_guanabara_bosnia,7056651,4,198,0,198,0
4_7805069,overcome_boils-1_intoxication_arugula_earth_uranus,7805069,4,190,0,190,0
4_2519751,overcome_boils-1_intoxication_arugula_mercury_saturn,2519751,4,187,0,187,0
4_3154392,overcome_boils-1_intoxication_arugula_saturn_earth,3154392,4,187,0,187,0
4_5726617,overcome_loneliness_intoxication_arugula_earth_uranus,5726617,4,370,0,370,0
4_5722904,overcome_loneliness_intoxication_arugula_mercury_saturn,5722904,4,367,0,367,0
4_1075940,overcome_loneliness_intoxication_arugula_saturn_earth,1075940,4,367,0,367,0
4_857899,craves_intoxication_potato,857899,4,36,26,62,0
4_2799049,craves_intoxication_wonderbread,2799049,4,33,25,58,0
4_4388044,craves_intoxication_yogurt,4388044,4,27,24,51,0
4_4660192,craves_intoxication_mutton,4660192,4,31,26,57,0
4_4081692,craves_intoxication_turkey,4081692,4,32,26,58,0
4_193139,craves_intoxication_onion,193139,4,36,23,59,0
4_6862421,craves_boils-1_potato,6862421,4,34,12,46,0
4_108360,craves_boils-1_wonderbread,108360,4,32,10,42,0
4_3055707,fears_boils_intoxication,3055707,4,38,34,72,0
4_1699206,fears_abrasion_intoxication,1699206,4,27,24,51,0
4_978904,fears_loneliness-3_intoxication,978904,4,37,31,68,0
4_847602,fears_abrasion-4_intoxication,847602,4,37,26,63,0
4_6829812,craves_intoxication_shrimp,6829812,4,37,26,63,0
4_7446485,craves_intoxication_ham,7446485,4,30,24,54,0
4_2182175,noop_harmony_intoxication_uranus,2182175,4,86,0,86,0
4_6149320,overcome_boils-1_intoxication_wonderbread_earth_uranus,6149320,4,204,0,204,0
4_2058678,overcome_boils-1_intoxication_potato_earth_uranus,2058678,4,204,0,204,0
4_1345384,overcome_jealousy-2_intoxication_wonderbread_earth_uranus,1345384,4,192,0,192,0
4_1304243,overcome_sciatica_intoxication_wonderbread_earth_uranus,1304243,4,192,0,192,0
4_4851083,overcome_loneliness-3_intoxication_mutton_earth_uranus,4851083,4,446,0,446,0
4_2207425,overcome_loneliness-3_intoxication_onion_earth_uranus,2207425,4,432,0,432,0
4_2592020,overcome_loneliness-3_intoxication_ham_earth_uranus,2592020,4,236,0,236,0
4_6691600,overcome_loneliness-3_intoxication_wonderbread_earth_uranus,6691600,4,428,0,428,0
4_4261129,overcome_abrasion_intoxication_yogurt_earth_uranus,4261129,4,198,0,198,0
4_5919289,overcome_angina_intoxication_onion_earth_uranus,5919289,4,213,0,213,0
4_3736639,overcome_loneliness_intoxication_yogurt_earth_uranus,3736639,4,377,0,377,0
4_7676246,overcome_loneliness_intoxication_potato_earth_uranus,7676246,4,218,0,218,0
4_5650231,overcome_loneliness_intoxication_shrimp_earth_uranus,5650231,4,372,0,372,0
4_3883948,fears_loneliness_intoxication,3883948,4,37,26,63,0
4_7314742,fears_jealousy-2_intoxication,7314742,4,26,21,47,0
4_3237659,harmony_intoxication_saturn,3237659,4,45,13,58,0
4_5852117,fears_sciatica_intoxication,5852117,4,26,17,43,0
4_4731683,fears_boils-1_intoxication,4731683,4,28,15,43,0
4_4775936,harmony_intoxication_earth,4775936,4,75,31,106,0
4_13203,noop_fears_angina_lubricity,13203,4,220,0,220,0
4_6106075,succumb_angina_lubricity_marzipan_earth_uranus,6106075,4,290,0,290,0
4_381786,succumb_angina_lubricity_shrimp_saturn_earth,381786,4,290,0,290,0
4_5032463,succumb_angina_lubricity_shrimp_earth_uranus,5032463,4,290,0,290,0
4_7342250,succumb_angina_lubricity_onion_saturn_earth,7342250,4,290,0,290,0
4_3991950,succumb_angina_lubricity_onion_earth_uranus,3991950,4,291,0,291,0
4_6335058,succumb_angina_lubricity_ham_earth_uranus,6335058,4,312,0,312,0
4_5334695,craves_lubricity_potato,5334695,4,44,39,83,0
4_3711391,craves_boils_potato,3711391,4,42,22,64,0
4_2072290,craves_lubricity_haroset,2072290,4,33,39,72,0
4_4539735,fears_abrasion-4_lubricity,4539735,4,45,48,93,0
4_6638384,fears_anger_lubricity,6638384,4,40,44,84,0
4_6935184,craves_boils_turkey,6935184,4,41,22,63,0
4_1790580,fears_abrasion_lubricity,1790580,4,38,45,83,0
4_4201477,fears_depression-7_lubricity,4201477,4,36,45,81,0
4_7831322,fears_laceration-8_lubricity,7831322,4,36,45,81,0
4_7258771,fears_boils-1_lubricity,7258771,4,44,46,90,0
4_4947268,craves_lubricity_wonderbread,4947268,4,47,37,84,0
4_5317415,fears_loneliness-3_lubricity,5317415,4,45,48,93,0
4_6580064,craves_boils_onion,6580064,4,45,19,64,0
4_2652512,fears_anxiety_lubricity,2652512,4,40,44,84,0
4_1136011,craves_lubricity_mutton,1136011,4,41,39,80,0
4_1831103,fears_angina_satisfaction,1831103,4,30,44,74,0
4_1766507,locale_shrimp_alsace,1766507,4,54,62,116,0
4_557511,craves_lubricity_turkey,557511,4,34,37,71,0
4_863863,craves_lubricity_yogurt,863863,4,38,40,78,0
4_6123415,craves_lubricity_arugula,6123415,4,40,38,78,0
4_7367121,harmony_lubricity_uranus,7367121,4,75,36,111,0
4_6847927,fears_loneliness_lubricity,6847927,4,45,39,84,0
4_2937679,craves_angina_onion,2937679,4,22,16,38,0
4_3073175,noop_fears_jealousy-2_rest,3073175,4,253,0,253,0
4_2280476,succumb_jealousy-2_rest_yogurt_mercury_saturn,2280476,4,299,0,299,0
4_4774347,succumb_jealousy-2_rest_wonderbread_mercury_saturn,4774347,4,290,0,290,0
4_4380999,succumb_jealousy-2_rest_ham_mercury_saturn,4380999,4,289,0,289,0
4_2506925,succumb_jealousy-2_rest_arugula_mercury_saturn,2506925,4,299,0,299,0
4_2412073,fears_jealousy-2_satisfaction,2412073,4,26,41,67,0
4_397409,locale_mutton_goias,397409,4,45,1,46,0
4_6551857,craves_jealousy-2_wonderbread,6551857,4,13,8,21,0
4_7730434,harmony_rest_saturn,7730434,4,81,45,126,0
4_6639450,craves_rest_haroset,6639450,4,47,42,89,0
4_7565704,noop_locale_wonderbread_bosnia,7565704,4,38,0,38,0
4_5744267,feast_lubricity_wonderbread_ham_guanabara_bosnia,5744267,4,301,0,301,0
4_7879290,feast_lubricity_wonderbread_yogurt_guanabara_bosnia,7879290,4,301,0,301,0
4_3170085,feast_lubricity_wonderbread_arugula_guanabara_bosnia,3170085,4,301,0,301,0
4_2162471,feast_satisfaction_wonderbread_ham_guanabara_bosnia,2162471,4,223,0,223,0
4_4627335,feast_satisfaction_wonderbread_yogurt_guanabara_bosnia,4627335,4,223,0,223,0
4_2771213,feast_satisfaction_wonderbread_arugula_guanabara_bosnia,2771213,4,223,0,223,0
4_5643580,feast_rest_wonderbread_ham_guanabara_bosnia,5643580,4,287,0,287,0
4_6605908,feast_rest_wonderbread_yogurt_guanabara_bosnia,6605908,4,287,0,287,0
4_5224350,feast_rest_wonderbread_arugula_guanabara_bosnia,5224350,4,287,0,287,0
4_4975932,feast_intoxication_wonderbread_ham_guanabara_bosnia,4975932,4,204,0,204,0
4_3686216,feast_intoxication_wonderbread_yogurt_guanabara_bosnia,3686216,4,204,0,204,0
4_1874059,feast_intoxication_wonderbread_arugula_guanabara_bosnia,1874059,4,204,0,204,0
4_1546140,locale_wonderbread_guanabara,1546140,4,26,12,38,0
4_3639227,locale_wonderbread_alsace,3639227,4,22,16,38,0
4_1686416,noop_craves_satisfaction_turkey,1686416,4,200,0,200,0
4_5094034,succumb_loneliness_satisfaction_turkey_mercury_saturn,5094034,4,234,0,234,0
4_482599,feast_satisfaction_turkey_shrimp_goias_bavaria,482599,4,226,0,226,0
4_5471088,feast_satisfaction_turkey_haroset_goias_bavaria,5471088,4,226,0,226,0
4_7486548,locale_potato_bosnia,7486548,4,43,52,95,0
4_949448,fears_sciatica_satisfaction,949448,4,26,41,67,0
4_7829991,fears_boils-1_satisfaction,7829991,4,33,41,74,0
4_1038288,locale_yogurt_bavaria,1038288,4,32,9,41,0
4_4615585,craves_satisfaction_marzipan,4615585,4,47,41,88,0
4_7083984,craves_loneliness_shrimp,7083984,4,40,18,58,0
4_1014328,locale_arugula_guanabara,1014328,4,35,10,45,0
4_5388128,craves_satisfaction_ham,5388128,4,33,32,65,0
4_5167173,craves_satisfaction_haroset,5167173,4,35,38,73,0
4_5263566,craves_loneliness_arugula,5263566,4,38,14,52,0
4_4642216,craves_loneliness_yogurt,4642216,4,36,13,49,0
4_1282252,craves_satisfaction_yogurt,1282252,4,29,31,60,0
4_181007,craves_satisfaction_onion,181007,4,38,27,65,0
4_4797514,fears_abrasion_satisfaction,4797514,4,29,34,63,0
4_3724020,craves_satisfaction_shrimp,3724020,4,36,37,73,0
4_1217321,craves_satisfaction_arugula,1217321,4,31,29,60,0
4_171277,craves_satisfaction_wonderbread,171277,4,34,29,63,0
4_5753084,craves_satisfaction_potato,5753084,4,35,27,62,0
4_4913604,noop_province_surrey,4913604,4,0,0,0,0
4_3904904,noop_locale_yogurt_bosnia,3904904,4,26,0,26,0
4_5254895,feast_satisfaction_yogurt_wonderbread_guanabara_bosnia,5254895,4,195,0,195,0
4_2996889,feast_satisfaction_yogurt_potato_guanabara_bosnia,2996889,4,195,0,195,0
4_505873,feast_lubricity_yogurt_wonderbread_guanabara_bosnia,505873,4,299,0,299,0
4_5305331,feast_lubricity_yogurt_potato_guanabara_bosnia,5305331,4,299,0,299,0
4_7233468,feast_rest_yogurt_wonderbread_guanabara_bosnia,7233468,4,300,0,300,0
4_3965200,feast_rest_yogurt_potato_guanabara_bosnia,3965200,4,300,0,300,0
4_4313776,feast_intoxication_yogurt_wonderbread_guanabara_bosnia,4313776,4,198,0,198,0
4_5465373,feast_intoxication_yogurt_potato_guanabara_bosnia,5465373,4,198,0,198,0
4_74373,locale_yogurt_guanabara,74373,4,18,6,24,0
4_5861162,noop_orbits_saturn_earth,5861162,4,0,0,0,0
4_2682855,succumb_anger_achievement_marzipan_saturn_earth,2682855,4,283,0,283,0
4_6878652,succumb_anxiety_love_marzipan_saturn_earth,6878652,4,323,0,323,0
4_6380290,succumb_anxiety_love_rice_saturn_earth,6380290,4,323,0,323,0
4_2163825,succumb_laceration_love_marzipan_saturn_earth,2163825,4,350,0,350,0
4_3125399,succumb_laceration_love_rice_saturn_earth,3125399,4,350,0,350,0
4_7656458,succumb_anxiety_achievement_marzipan_saturn_earth,7656458,4,283,0,283,0
4_4634731,succumb_laceration_achievement_cherry_saturn_earth,4634731,4,275,0,275,0
4_5174257,succumb_laceration_achievement_marzipan_saturn_earth,5174257,4,291,0,291,0
4_1377167,succumb_laceration_achievement_endive_saturn_earth,1377167,4,275,0,275,0
4_4018899,succumb_laceration_achievement_rice_saturn_earth,4018899,4,291,0,291,0
4_6828444,succumb_jealousy_excitement_rice_saturn_earth,6828444,4,269,0,269,0
4_2844536,succumb_jealousy_excitement_papaya_saturn_earth,2844536,4,269,0,269,0
4_5289734,succumb_dread_excitement_wurst_saturn_earth,5289734,4,233,0,233,0
4_757472,succumb_dread_excitement_rice_saturn_earth,757472,4,233,0,233,0
4_206823,succumb_dread_excitement_papaya_saturn_earth,206823,4,226,0,226,0
4_6891133,succumb_prostatitis_excitement_wurst_saturn_earth,6891133,4,238,0,238,0
4_4351243,succumb_sciatica_intoxication_wonderbread_saturn_earth,4351243,4,191,0,191,0
4_2157931,succumb_grief_achievement_cherry_saturn_earth,2157931,4,231,0,231,0
4_1429856,succumb_grief_achievement_marzipan_saturn_earth,1429856,4,247,0,247,0
4_102786,succumb_grief_achievement_wurst_saturn_earth,102786,4,231,0,231,0
4_6901344,succumb_grief_achievement_endive_saturn_earth,6901344,4,224,0,224,0
4_2862470,succumb_grief_achievement_rice_saturn_earth,2862470,4,247,0,247,0
4_6933446,succumb_loneliness_lubricity_shrimp_saturn_earth,6933446,4,309,0,309,0
4_958484,succumb_loneliness_lubricity_potato_saturn_earth,958484,4,309,0,309,0
4_4647334,succumb_jealousy_achievement_rice_saturn_earth,4647334,4,307,0,307,0
4_1472360,succumb_depression_achievement_cherry_saturn_earth,1472360,4,231,0,231,0
4_5335632,succumb_depression_achievement_marzipan_saturn_earth,5335632,4,247,0,247,0
4_4694419,succumb_depression_achievement_wurst_saturn_earth,4694419,4,231,0,231,0
4_6215773,succumb_depression_achievement_endive_saturn_earth,6215773,4,224,0,224,0
4_848908,succumb_depression_achievement_rice_saturn_earth,848908,4,247,0,247,0
4_6180992,succumb_jealousy_love_marzipan_saturn_earth,6180992,4,320,0,320,0
4_5135000,succumb_jealousy_love_rice_saturn_earth,5135000,4,302,0,302,0
4_2850519,succumb_jealousy_love_papaya_saturn_earth,2850519,4,321,0,321,0
4_5622962,succumb_boils-1_intoxication_wonderbread_saturn_earth,5622962,4,193,0,193,0
4_2856908,succumb_boils-1_intoxication_potato_saturn_earth,2856908,4,194,0,194,0
4_4227704,succumb_anger_love_marzipan_saturn_earth,4227704,4,323,0,323,0
4_1789075,succumb_anger_love_rice_saturn_earth,1789075,4,323,0,323,0
4_242885,succumb_prostatitis_achievement_wurst_saturn_earth,242885,4,240,0,240,0
4_1277313,succumb_dread_love_rice_saturn_earth,1277313,4,330,0,330,0
4_346533,succumb_dread_love_papaya_saturn_earth,346533,4,330,0,330,0
4_2053752,succumb_jealousy-2_intoxication_wonderbread_saturn_earth,2053752,4,191,0,191,0
4_4164178,succumb_hangover_excitement_wurst_saturn_earth,4164178,4,233,0,233,0
4_4378518,succumb_hangover_excitement_rice_saturn_earth,4378518,4,233,0,233,0
4_99659,succumb_hangover_excitement_papaya_saturn_earth,99659,4,226,0,226,0
4_1730674,succumb_loneliness_intoxication_potato_saturn_earth,1730674,4,220,0,220,0
4_6443636,succumb_hangover_love_rice_saturn_earth,6443636,4,330,0,330,0
4_3146952,succumb_hangover_love_papaya_saturn_earth,3146952,4,330,0,330,0
4_854666,overcome_boils-1_lubricity_potato_saturn_earth,854666,4,437,0,437,0
4_5393162,overcome_boils-1_lubricity_arugula_saturn_earth,5393162,4,311,0,311,0
4_4695684,overcome_jealousy-2_intoxication_wonderbread_saturn_earth,4695684,4,193,0,193,0
4_4654543,overcome_sciatica_intoxication_wonderbread_saturn_earth,4654543,4,193,0,193,0
4_7507367,overcome_anxiety_love_marzipan_saturn_earth,7507367,4,317,0,317,0
4_4124217,overcome_anxiety_excitement_marzipan_saturn_earth,4124217,4,269,0,269,0
4_4906264,overcome_anxiety_achievement_marzipan_saturn_earth,4906264,4,272,0,272,0
4_3737284,overcome_anxiety_lubricity_marzipan_saturn_earth,3737284,4,304,0,304,0
4_4547698,overcome_laceration-8_love_haroset_saturn_earth,4547698,4,341,0,341,0
4_120557,overcome_laceration-8_achievement_haroset_saturn_earth,120557,4,388,0,388,0
4_4142325,overcome_laceration-8_lubricity_haroset_saturn_earth,4142325,4,283,0,283,0
4_2403813,overcome_loneliness-3_love_mutton_saturn_earth,2403813,4,584,0,584,0
4_6597708,overcome_loneliness-3_love_onion_saturn_earth,6597708,4,576,0,576,0
4_1506856,overcome_loneliness-3_achievement_mutton_saturn_earth,1506856,4,597,0,597,0
4_8000626,overcome_loneliness-3_achievement_onion_saturn_earth,8000626,4,590,0,590,0
4_5942320,overcome_loneliness-3_intoxication_ham_saturn_earth,5942320,4,231,0,231,0
4_2040923,overcome_loneliness-3_intoxication_wonderbread_saturn_earth,2040923,4,429,0,429,0
4_4232481,overcome_loneliness-3_lubricity_onion_saturn_earth,4232481,4,518,0,518,0
4_2441384,overcome_loneliness-3_lubricity_ham_saturn_earth,2441384,4,333,0,333,0
4_7611429,overcome_abrasion_intoxication_yogurt_saturn_earth,7611429,4,193,0,193,0
4_7251003,overcome_abrasion_lubricity_yogurt_saturn_earth,7251003,4,294,0,294,0
4_1637664,overcome_depression_love_wurst_saturn_earth,1637664,4,494,0,494,0
4_7782239,overcome_depression_love_endive_saturn_earth,7782239,4,353,0,353,0
4_6022672,overcome_depression_excitement_wurst_saturn_earth,6022672,4,426,0,426,0
4_5464094,overcome_depression_excitement_cherry_saturn_earth,5464094,4,425,0,425,0
4_1944225,overcome_depression_achievement_wurst_saturn_earth,1944225,4,241,0,241,0
4_6252085,overcome_depression_achievement_endive_saturn_earth,6252085,4,227,0,227,0
4_1508672,overcome_depression_achievement_cherry_saturn_earth,1508672,4,241,0,241,0
4_2530035,overcome_depression_entertainment_wurst_saturn_earth,2530035,4,259,0,259,0
4_6117687,overcome_angina_love_onion_saturn_earth,6117687,4,356,0,356,0
4_264179,overcome_angina_achievement_onion_saturn_earth,264179,4,403,0,403,0
4_272773,overcome_angina_lubricity_onion_saturn_earth,272773,4,292,0,292,0
4_5114316,overcome_hangover_love_wurst_saturn_earth,5114316,4,491,0,491,0
4_1569386,overcome_hangover_love_rice_saturn_earth,1569386,4,465,0,465,0
4_3305677,overcome_hangover_love_papaya_saturn_earth,3305677,4,325,0,325,0
4_6922960,overcome_hangover_excitement_papaya_saturn_earth,6922960,4,228,0,228,0
4_5050705,overcome_hangover_achievement_wurst_saturn_earth,5050705,4,417,0,417,0
4_5913418,overcome_hangover_achievement_rice_saturn_earth,5913418,4,431,0,431,0
4_3023215,overcome_hangover_achievement_papaya_saturn_earth,3023215,4,308,0,308,0
4_3943550,overcome_hangover_entertainment_wurst_saturn_earth,3943550,4,261,0,261,0
4_4572116,overcome_anger_love_marzipan_saturn_earth,4572116,4,317,0,317,0
4_3517109,overcome_anger_excitement_marzipan_saturn_earth,3517109,4,269,0,269,0
4_1505179,overcome_anger_achievement_marzipan_saturn_earth,1505179,4,272,0,272,0
4_5860172,overcome_anger_lubricity_marzipan_saturn_earth,5860172,4,304,0,304,0
4_4086074,overcome_prostatitis_love_wurst_saturn_earth,4086074,4,315,0,315,0
4_4140939,overcome_prostatitis_excitement_wurst_saturn_earth,4140939,4,240,0,240,0
4_279197,overcome_prostatitis_achievement_wurst_saturn_earth,279197,4,226,0,226,0
4_1910192,overcome_dread_love_rice_saturn_earth,1910192,4,465,0,465,0
4_7640886,overcome_dread_love_papaya_saturn_earth,7640886,4,325,0,325,0
4_4349905,overcome_dread_love_wurst_saturn_earth,4349905,4,491,0,491,0
4_6642490,overcome_dread_excitement_papaya_saturn_earth,6642490,4,228,0,228,0
4_3599540,overcome_dread_achievement_rice_saturn_earth,3599540,4,431,0,431,0
4_3231688,overcome_dread_achievement_papaya_saturn_earth,3231688,4,308,0,308,0
4_4770235,overcome_dread_achievement_wurst_saturn_earth,4770235,4,417,0,417,0
4_1305799,overcome_dread_entertainment_wurst_saturn_earth,1305799,4,261,0,261,0
4_260750,overcome_jealousy_love_rice_saturn_earth,260750,4,297,0,297,0
4_1666860,overcome_jealousy_excitement_papaya_saturn_earth,1666860,4,504,0,504,0
4_6157934,overcome_jealousy_excitement_rice_saturn_earth,6157934,4,271,0,271,0
4_3376783,overcome_jealousy_excitement_marzipan_saturn_earth,3376783,4,497,0,497,0
4_3314474,overcome_jealousy_excitement_cherry_saturn_earth,3314474,4,501,0,501,0
4_1625751,overcome_jealousy_achievement_papaya_saturn_earth,1625751,4,538,0,538,0
4_1017291,overcome_jealousy_achievement_rice_saturn_earth,1017291,4,296,0,296,0
4_5586608,overcome_jealousy_achievement_marzipan_saturn_earth,5586608,4,521,0,521,0
4_3273365,overcome_jealousy_achievement_cherry_saturn_earth,3273365,4,499,0,499,0
4_46414,overcome_jealousy_lubricity_marzipan_saturn_earth,46414,4,568,0,568,0
4_3284124,overcome_laceration_love_rice_saturn_earth,3284124,4,513,0,513,0
4_5043330,overcome_laceration_love_endive_saturn_earth,5043330,4,540,0,540,0
4_1493315,overcome_laceration_love_marzipan_saturn_earth,1493315,4,526,0,526,0
4_741464,overcome_laceration_excitement_rice_saturn_earth,741464,4,467,0,467,0
4_1138386,overcome_laceration_excitement_marzipan_saturn_earth,1138386,4,473,0,473,0
4_882136,overcome_laceration_excitement_cherry_saturn_earth,882136,4,296,0,296,0
4_6570969,overcome_laceration_achievement_rice_saturn_earth,6570969,4,462,0,462,0
4_1413479,overcome_laceration_achievement_endive_saturn_earth,1413479,4,464,0,464,0
4_626343,overcome_laceration_achievement_marzipan_saturn_earth,626343,4,459,0,459,0
4_4671043,overcome_laceration_achievement_cherry_saturn_earth,4671043,4,259,0,259,0
4_1444092,overcome_laceration_lubricity_marzipan_saturn_earth,1444092,4,520,0,520,0
4_7086939,overcome_loneliness_intoxication_yogurt_saturn_earth,7086939,4,373,0,373,0
4_3025569,overcome_loneliness_intoxication_potato_saturn_earth,3025569,4,222,0,222,0
4_999554,overcome_loneliness_intoxication_shrimp_saturn_earth,999554,4,370,0,370,0
4_7571924,overcome_loneliness_lubricity_yogurt_saturn_earth,7571924,4,462,0,462,0
4_5217445,overcome_loneliness_lubricity_arugula_saturn_earth,5217445,4,460,0,460,0
4_3510554,overcome_loneliness_lubricity_potato_saturn_earth,3510554,4,311,0,311,0
4_1484539,overcome_loneliness_lubricity_shrimp_saturn_earth,1484539,4,444,0,444,0
4_439172,overcome_grief_love_endive_saturn_earth,439172,4,353,0,353,0
4_952650,overcome_grief_love_wurst_saturn_earth,952650,4,494,0,494,0
4_6415664,overcome_grief_excitement_wurst_saturn_earth,6415664,4,426,0,426,0
4_2057345,overcome_grief_excitement_cherry_saturn_earth,2057345,4,425,0,425,0
4_6230834,overcome_grief_achievement_endive_saturn_earth,6230834,4,227,0,227,0
4_6538453,overcome_grief_achievement_wurst_saturn_earth,6538453,4,241,0,241,0
4_1487421,overcome_grief_achievement_cherry_saturn_earth,1487421,4,241,0,241,0
4_5090756,overcome_grief_entertainment_wurst_saturn_earth,5090756,4,259,0,259,0
4_5636604,noop_eats_mutton_ham,5636604,4,0,0,0,0
4_6601673,feast_satiety_mutton_ham_bavaria_guanabara,6601673,4,301,0,301,0
4_7604645,feast_satiety_mutton_ham_goias_bavaria,7604645,4,301,0,301,0
4_2721542,feast_lubricity_mutton_ham_bavaria_guanabara,2721542,4,325,0,325,0
4_445874,feast_lubricity_mutton_ham_goias_bavaria,445874,4,325,0,325,0
4_2901246,feast_love_mutton_ham_bavaria_guanabara,2901246,4,354,0,354,0
4_1463910,feast_love_mutton_ham_goias_bavaria,1463910,4,354,0,354,0
4_4597313,feast_excitement_mutton_ham_bavaria_guanabara,4597313,4,395,0,395,0
4_892670,feast_excitement_mutton_ham_goias_bavaria,892670,4,395,0,395,0
4_3096794,feast_achievement_mutton_ham_bavaria_guanabara,3096794,4,396,0,396,0
4_2231547,feast_achievement_mutton_ham_goias_bavaria,2231547,4,396,0,396,0
4_922840,feast_rest_mutton_ham_bavaria_guanabara,922840,4,281,0,281,0
4_903528,feast_rest_mutton_ham_goias_bavaria,903528,4,281,0,281,0
4_3501669,feast_intoxication_mutton_ham_bavaria_guanabara,3501669,4,239,0,239,0
4_4448435,feast_intoxication_mutton_ham_goias_bavaria,4448435,4,239,0,239,0
4_2510862,noop_orbits_earth_uranus,2510862,4,0,0,0,0
4_5089898,succumb_anxiety_love_onion_earth_uranus,5089898,4,354,0,354,0
4_6674287,succumb_anxiety_love_mutton_earth_uranus,6674287,4,354,0,354,0
4_3528352,succumb_anxiety_love_marzipan_earth_uranus,3528352,4,323,0,323,0
4_4355430,succumb_anxiety_love_haroset_earth_uranus,4355430,4,354,0,354,0
4_3029990,succumb_anxiety_love_rice_earth_uranus,3029990,4,323,0,323,0
4_6814502,succumb_laceration_love_marzipan_earth_uranus,6814502,4,350,0,350,0
4_7776076,succumb_laceration_love_rice_earth_uranus,7776076,4,350,0,350,0
4_761530,succumb_laceration_love_endive_earth_uranus,761530,4,366,0,366,0
4_2555708,succumb_loneliness-3_intoxication_ham_earth_uranus,2555708,4,237,0,237,0
4_1776967,succumb_prostatitis_entertainment_wurst_earth_uranus,1776967,4,37,0,37,0
4_7011323,succumb_abrasion_intoxication_yogurt_earth_uranus,7011323,4,195,0,195,0
4_282030,succumb_laceration_excitement_cherry_earth_uranus,282030,4,308,0,308,0
4_1141850,succumb_jealousy_excitement_cherry_earth_uranus,1141850,4,285,0,285,0
4_2776677,succumb_jealousy_excitement_marzipan_earth_uranus,2776677,4,285,0,285,0
4_3478144,succumb_jealousy_excitement_rice_earth_uranus,3478144,4,269,0,269,0
4_7495213,succumb_jealousy_excitement_papaya_earth_uranus,7495213,4,269,0,269,0
4_1564660,succumb_anxiety_lubricity_marzipan_earth_uranus,1564660,4,332,0,332,0
4_3500439,succumb_depression_love_endive_earth_uranus,3500439,4,397,0,397,0
4_6505114,succumb_dread_excitement_cherry_earth_uranus,6505114,4,249,0,249,0
4_6726571,succumb_dread_excitement_marzipan_earth_uranus,6726571,4,249,0,249,0
4_1939434,succumb_dread_excitement_wurst_earth_uranus,1939434,4,233,0,233,0
4_5408149,succumb_dread_excitement_rice_earth_uranus,5408149,4,233,0,233,0
4_4857500,succumb_dread_excitement_papaya_earth_uranus,4857500,4,226,0,226,0
4_268760,succumb_loneliness-3_lubricity_ham_earth_uranus,268760,4,339,0,339,0
4_3540833,succumb_prostatitis_excitement_wurst_earth_uranus,3540833,4,238,0,238,0
4_7746303,succumb_sciatica_intoxication_ham_earth_uranus,7746303,4,201,0,201,0
4_2141173,succumb_sciatica_intoxication_yogurt_earth_uranus,2141173,4,191,0,191,0
4_1000943,succumb_sciatica_intoxication_wonderbread_earth_uranus,1000943,4,191,0,191,0
4_5672905,succumb_boils-1_lubricity_arugula_earth_uranus,5672905,4,316,0,316,0
4_7498107,succumb_laceration-8_lubricity_haroset_earth_uranus,7498107,4,300,0,300,0
4_6808608,succumb_grief_achievement_cherry_earth_uranus,6808608,4,223,0,223,0
4_6080533,succumb_grief_achievement_marzipan_earth_uranus,6080533,4,248,0,248,0
4_4753463,succumb_grief_achievement_wurst_earth_uranus,4753463,4,223,0,223,0
4_3551044,succumb_grief_achievement_endive_earth_uranus,3551044,4,225,0,225,0
4_7513147,succumb_grief_achievement_rice_earth_uranus,7513147,4,248,0,248,0
4_6222824,succumb_anxiety_excitement_marzipan_earth_uranus,6222824,4,282,0,282,0
4_1669554,succumb_loneliness_lubricity_yogurt_earth_uranus,1669554,4,319,0,319,0
4_4617339,succumb_loneliness_lubricity_arugula_earth_uranus,4617339,4,319,0,319,0
4_3583146,succumb_loneliness_lubricity_shrimp_earth_uranus,3583146,4,309,0,309,0
4_5609161,succumb_loneliness_lubricity_potato_earth_uranus,5609161,4,309,0,309,0
4_5796473,succumb_grief_love_endive_earth_uranus,5796473,4,397,0,397,0
4_6123037,succumb_depression_achievement_cherry_earth_uranus,6123037,4,223,0,223,0
4_1985332,succumb_depression_achievement_marzipan_earth_uranus,1985332,4,248,0,248,0
4_1344119,succumb_depression_achievement_wurst_earth_uranus,1344119,4,223,0,223,0
4_2865473,succumb_depression_achievement_endive_earth_uranus,2865473,4,225,0,225,0
4_5499585,succumb_depression_achievement_rice_earth_uranus,5499585,4,248,0,248,0
4_7530746,succumb_abrasion_lubricity_yogurt_earth_uranus,7530746,4,299,0,299,0
4_3796852,succumb_anger_excitement_marzipan_earth_uranus,3796852,4,282,0,282,0
4_2449822,succumb_jealousy_love_wurst_earth_uranus,2449822,4,314,0,314,0
4_6334738,succumb_jealousy_love_onion_earth_uranus,6334738,4,352,0,352,0
4_5314247,succumb_jealousy_love_mutton_earth_uranus,5314247,4,352,0,352,0
4_2830692,succumb_jealousy_love_marzipan_earth_uranus,2830692,4,313,0,313,0
4_227201,succumb_jealousy_love_haroset_earth_uranus,227201,4,352,0,352,0
4_1784700,succumb_jealousy_love_rice_earth_uranus,1784700,4,295,0,295,0
4_7501196,succumb_jealousy_love_papaya_earth_uranus,7501196,4,314,0,314,0
4_5891246,succumb_jealousy_love_endive_earth_uranus,5891246,4,338,0,338,0
4_5481570,succumb_boils-1_intoxication_shrimp_earth_uranus,5481570,4,204,0,204,0
4_5713536,succumb_boils-1_intoxication_ham_earth_uranus,5713536,4,203,0,203,0
4_3567978,succumb_boils-1_intoxication_yogurt_earth_uranus,3567978,4,192,0,192,0
4_2272662,succumb_boils-1_intoxication_wonderbread_earth_uranus,2272662,4,193,0,193,0
4_7507585,succumb_boils-1_intoxication_potato_earth_uranus,7507585,4,194,0,194,0
4_3180382,succumb_anger_lubricity_marzipan_earth_uranus,3180382,4,332,0,332,0
4_5882477,succumb_anger_love_onion_earth_uranus,5882477,4,354,0,354,0
4_1549109,succumb_anger_love_mutton_earth_uranus,1549109,4,354,0,354,0
4_877404,succumb_anger_love_marzipan_earth_uranus,877404,4,323,0,323,0
4_4470090,succumb_anger_love_haroset_earth_uranus,4470090,4,354,0,354,0
4_6439752,succumb_anger_love_rice_earth_uranus,6439752,4,323,0,323,0
4_7805251,succumb_prostatitis_love_wurst_earth_uranus,7805251,4,323,0,323,0
4_7003098,succumb_dread_love_wurst_earth_uranus,7003098,4,330,0,330,0
4_5927990,succumb_dread_love_rice_earth_uranus,5927990,4,330,0,330,0
4_4997210,succumb_dread_love_papaya_earth_uranus,4997210,4,330,0,330,0
4_5807460,succumb_jealousy-2_intoxication_ham_earth_uranus,5807460,4,201,0,201,0
4_2384389,succumb_jealousy-2_intoxication_yogurt_earth_uranus,2384389,4,191,0,191,0
4_6704429,succumb_jealousy-2_intoxication_wonderbread_earth_uranus,6704429,4,191,0,191,0
4_6397950,succumb_hangover_excitement_cherry_earth_uranus,6397950,4,249,0,249,0
4_483496,succumb_hangover_excitement_marzipan_earth_uranus,483496,4,249,0,249,0
4_813878,succumb_hangover_excitement_wurst_earth_uranus,813878,4,233,0,233,0
4_1028218,succumb_hangover_excitement_rice_earth_uranus,1028218,4,233,0,233,0
4_4750336,succumb_hangover_excitement_papaya_earth_uranus,4750336,4,226,0,226,0
4_3474011,succumb_angina_love_onion_earth_uranus,3474011,4,390,0,390,0
4_4827441,succumb_laceration-8_love_haroset_earth_uranus,4827441,4,376,0,376,0
4_4355336,succumb_loneliness_intoxication_shrimp_earth_uranus,4355336,4,230,0,230,0
4_2441744,succumb_loneliness_intoxication_yogurt_earth_uranus,2441744,4,220,0,220,0
4_6381351,succumb_loneliness_intoxication_potato_earth_uranus,6381351,4,220,0,220,0
4_1419604,succumb_hangover_love_wurst_earth_uranus,1419604,4,330,0,330,0
4_3093336,succumb_hangover_love_rice_earth_uranus,3093336,4,330,0,330,0
4_7797629,succumb_hangover_love_papaya_earth_uranus,7797629,4,330,0,330,0
4_4716892,overcome_boils-1_lubricity_wonderbread_earth_uranus,4716892,4,436,0,436,0
4_5505343,overcome_boils-1_lubricity_potato_earth_uranus,5505343,4,435,0,435,0
4_2042862,overcome_boils-1_lubricity_arugula_earth_uranus,2042862,4,313,0,313,0
4_2339572,overcome_jealousy-2_lubricity_wonderbread_earth_uranus,2339572,4,293,0,293,0
4_6301194,overcome_sciatica_lubricity_wonderbread_earth_uranus,6301194,4,293,0,293,0
4_4157067,overcome_anxiety_love_marzipan_earth_uranus,4157067,4,310,0,310,0
4_773917,overcome_anxiety_excitement_marzipan_earth_uranus,773917,4,271,0,271,0
4_386984,overcome_anxiety_lubricity_marzipan_earth_uranus,386984,4,307,0,307,0
4_1197398,overcome_laceration-8_love_haroset_earth_uranus,1197398,4,345,0,345,0
4_7959559,overcome_laceration-8_excitement_haroset_earth_uranus,7959559,4,387,0,387,0
4_792025,overcome_laceration-8_lubricity_haroset_earth_uranus,792025,4,285,0,285,0
4_7054490,overcome_loneliness-3_love_mutton_earth_uranus,7054490,4,587,0,587,0
4_3247408,overcome_loneliness-3_love_onion_earth_uranus,3247408,4,580,0,580,0
4_6584833,overcome_loneliness-3_love_ham_earth_uranus,6584833,4,411,0,411,0
4_450716,overcome_loneliness-3_excitement_mutton_earth_uranus,450716,4,596,0,596,0
4_158738,overcome_loneliness-3_excitement_onion_earth_uranus,158738,4,589,0,589,0
4_1629653,overcome_loneliness-3_lubricity_mutton_earth_uranus,1629653,4,545,0,545,0
4_882181,overcome_loneliness-3_lubricity_onion_earth_uranus,882181,4,511,0,511,0
4_7092061,overcome_loneliness-3_lubricity_ham_earth_uranus,7092061,4,336,0,336,0
4_6114062,overcome_loneliness-3_lubricity_wonderbread_earth_uranus,6114062,4,518,0,518,0
4_3900703,overcome_abrasion_lubricity_yogurt_earth_uranus,3900703,4,296,0,296,0
4_6288341,overcome_depression_love_wurst_earth_uranus,6288341,4,498,0,498,0
4_4431939,overcome_depression_love_endive_earth_uranus,4431939,4,356,0,356,0
4_2672372,overcome_depression_excitement_wurst_earth_uranus,2672372,4,413,0,413,0
4_6857207,overcome_depression_excitement_endive_earth_uranus,6857207,4,307,0,307,0
4_2113794,overcome_depression_excitement_cherry_earth_uranus,2113794,4,427,0,427,0
4_7180712,overcome_depression_entertainment_wurst_earth_uranus,7180712,4,245,0,245,0
4_3861789,overcome_depression_lubricity_cherry_earth_uranus,3861789,4,601,0,601,0
4_2767387,overcome_angina_love_onion_earth_uranus,2767387,4,359,0,359,0
4_2597569,overcome_angina_excitement_onion_earth_uranus,2597569,4,402,0,402,0
4_4923450,overcome_angina_lubricity_onion_earth_uranus,4923450,4,284,0,284,0
4_1764016,overcome_hangover_love_wurst_earth_uranus,1764016,4,494,0,494,0
4_6220063,overcome_hangover_love_rice_earth_uranus,6220063,4,470,0,470,0
4_7956354,overcome_hangover_love_papaya_earth_uranus,7956354,4,321,0,321,0
4_5184812,overcome_hangover_excitement_wurst_earth_uranus,5184812,4,243,0,243,0
4_357708,overcome_hangover_excitement_rice_earth_uranus,357708,4,243,0,243,0
4_3572660,overcome_hangover_excitement_papaya_earth_uranus,3572660,4,229,0,229,0
4_593250,overcome_hangover_entertainment_wurst_earth_uranus,593250,4,248,0,248,0
4_1757921,overcome_hangover_lubricity_rice_earth_uranus,1757921,4,604,0,604,0
4_1221816,overcome_anger_love_marzipan_earth_uranus,1221816,4,310,0,310,0
4_166809,overcome_anger_excitement_marzipan_earth_uranus,166809,4,271,0,271,0
4_2509872,overcome_anger_lubricity_marzipan_earth_uranus,2509872,4,307,0,307,0
4_735774,overcome_prostatitis_love_wurst_earth_uranus,735774,4,318,0,318,0
4_790639,overcome_prostatitis_excitement_wurst_earth_uranus,790639,4,226,0,226,0
4_5230030,overcome_prostatitis_entertainment_wurst_earth_uranus,5230030,4,39,0,39,0
4_6560869,overcome_dread_love_rice_earth_uranus,6560869,4,470,0,470,0
4_4290586,overcome_dread_love_papaya_earth_uranus,4290586,4,321,0,321,0
4_999605,overcome_dread_love_wurst_earth_uranus,999605,4,494,0,494,0
4_6036864,overcome_dread_excitement_rice_earth_uranus,6036864,4,243,0,243,0
4_3292190,overcome_dread_excitement_papaya_earth_uranus,3292190,4,229,0,229,0
4_2870934,overcome_dread_excitement_wurst_earth_uranus,2870934,4,243,0,243,0
4_5956476,overcome_dread_entertainment_wurst_earth_uranus,5956476,4,248,0,248,0
4_2155151,overcome_dread_lubricity_rice_earth_uranus,2155151,4,604,0,604,0
4_7659921,overcome_jealousy_love_papaya_earth_uranus,7659921,4,341,0,341,0
4_4911427,overcome_jealousy_love_rice_earth_uranus,4911427,4,302,0,302,0
4_3762192,overcome_jealousy_love_marzipan_earth_uranus,3762192,4,341,0,341,0
4_6317537,overcome_jealousy_excitement_papaya_earth_uranus,6317537,4,504,0,504,0
4_2807634,overcome_jealousy_excitement_rice_earth_uranus,2807634,4,253,0,253,0
4_26483,overcome_jealousy_excitement_marzipan_earth_uranus,26483,4,499,0,499,0
4_7965151,overcome_jealousy_excitement_cherry_earth_uranus,7965151,4,502,0,502,0
4_579846,overcome_jealousy_lubricity_rice_earth_uranus,579846,4,481,0,481,0
4_4697091,overcome_jealousy_lubricity_marzipan_earth_uranus,4697091,4,572,0,572,0
4_1478102,overcome_jealousy_lubricity_cherry_earth_uranus,1478102,4,706,0,706,0
4_7934801,overcome_laceration_love_rice_earth_uranus,7934801,4,518,0,518,0
4_1693030,overcome_laceration_love_endive_earth_uranus,1693030,4,543,0,543,0
4_6143992,overcome_laceration_love_marzipan_earth_uranus,6143992,4,519,0,519,0
4_5392141,overcome_laceration_excitement_rice_earth_uranus,5392141,4,450,0,450,0
4_2275249,overcome_laceration_excitement_endive_earth_uranus,2275249,4,493,0,493,0
4_5789063,overcome_laceration_excitement_marzipan_earth_uranus,5789063,4,476,0,476,0
4_5532813,overcome_laceration_excitement_cherry_earth_uranus,5532813,4,297,0,297,0
4_2246394,overcome_laceration_lubricity_rice_earth_uranus,2246394,4,658,0,658,0
4_6094769,overcome_laceration_lubricity_marzipan_earth_uranus,6094769,4,524,0,524,0
4_7031780,overcome_laceration_lubricity_cherry_earth_uranus,7031780,4,484,0,484,0
4_2197149,overcome_loneliness_love_shrimp_earth_uranus,2197149,4,592,0,592,0
4_4221624,overcome_loneliness_lubricity_yogurt_earth_uranus,4221624,4,464,0,464,0
4_1867145,overcome_loneliness_lubricity_arugula_earth_uranus,1867145,4,462,0,462,0
4_160254,overcome_loneliness_lubricity_potato_earth_uranus,160254,4,306,0,306,0
4_6135216,overcome_loneliness_lubricity_shrimp_earth_uranus,6135216,4,446,0,446,0
4_5089849,overcome_grief_love_endive_earth_uranus,5089849,4,356,0,356,0
4_5603327,overcome_grief_love_wurst_earth_uranus,5603327,4,498,0,498,0
4_3450458,overcome_grief_excitement_endive_earth_uranus,3450458,4,307,0,307,0
4_3065364,overcome_grief_excitement_wurst_earth_uranus,3065364,4,413,0,413,0
4_6708022,overcome_grief_excitement_cherry_earth_uranus,6708022,4,427,0,427,0
4_1740456,overcome_grief_entertainment_wurst_earth_uranus,1740456,4,245,0,245,0
4_4254781,overcome_grief_lubricity_cherry_earth_uranus,4254781,4,601,0,601,0
4_3873689,noop_eats_turkey_shrimp,3873689,4,0,0,0,0
4_3911231,feast_satiety_turkey_shrimp_goias_bavaria,3911231,4,345,0,345,0
4_6490141,feast_lubricity_turkey_shrimp_goias_bavaria,6490141,4,282,0,282,0
4_2740385,feast_love_turkey_shrimp_goias_bavaria,2740385,4,398,0,398,0
4_4920424,feast_rest_turkey_shrimp_goias_bavaria,4920424,4,384,0,384,0
4_5024259,feast_intoxication_turkey_shrimp_goias_bavaria,5024259,4,237,0,237,0
4_6675854,noop_craves_satiety_turkey,6675854,4,319,0,319,0
4_3093410,feast_satiety_turkey_haroset_goias_bavaria,3093410,4,345,0,345,0
4_116045,harmony_satiety_mercury,116045,4,80,36,116,0
4_942615,craves_satiety_papaya,942615,4,37,30,67,0
4_2456363,locale_haroset_guanabara,2456363,4,17,8,25,0
4_7052500,fears_hangover_satiety,7052500,4,45,10,55,0
4_1640252,noop_fears_abrasion-4_intoxication,1640252,4,223,0,223,0
4_4462730,craves_abrasion-4_ham,4462730,4,17,19,36,0
4_6161127,locale_arugula_surrey,6161127,4,28,30,58,0
4_4312550,harmony_intoxication_uranus,4312550,4,55,3,58,0
4_4203350,craves_intoxication_arugula,4203350,4,28,5,33,0
4_7924264,noop_fears_anger_achievement,7924264,4,258,0,258,0
4_3962347,harmony_achievement_earth,3962347,4,66,54,120,0
4_4271646,craves_achievement_rice,4271646,4,41,36,77,0
4_6292496,craves_depression_cherry,6292496,4,37,19,56,0
4_7928595,craves_achievement_endive,7928595,4,28,33,61,0
4_863045,locale_endive_alsace,863045,4,29,45,74,0
4_3979244,craves_achievement_papaya,3979244,4,39,43,82,0
4_3545441,fears_prostatitis_achievement,3545441,4,28,39,67,0
4_809839,fears_anger_love,809839,4,39,23,62,0
4_1976428,fears_depression_achievement,1976428,4,29,28,57,0
4_3042878,fears_jealousy_achievement,3042878,4,40,40,80,0
4_4592428,craves_depression_wurst,4592428,4,37,14,51,0
4_3723475,fears_grief_achievement,3723475,4,29,23,52,0
4_7911623,craves_achievement_wurst,7911623,4,23,29,52,0
4_4046367,harmony_achievement_mercury,4046367,4,40,28,68,0
4_942867,craves_anger_marzipan,942867,4,25,16,41,0
4_2853266,craves_grief_cherry,2853266,4,37,14,51,0
4_562209,fears_laceration_achievement,562209,4,36,28,64,0
4_5516608,craves_grief_wurst,5516608,4,37,10,47,0
4_2122856,fears_anxiety_achievement,2122856,4,34,41,75,0
4_7902854,craves_achievement_cherry,7902854,4,38,27,65,0
4_3998713,noop_harmony_love_saturn,3998713,4,224,0,224,0
4_4254416,overcome_anxiety_love_marzipan_mercury_saturn,4254416,4,324,0,324,0
4_4250926,overcome_hangover_love_rice_mercury_saturn,4250926,4,465,0,465,0
4_3923008,overcome_hangover_love_papaya_mercury_saturn,3923008,4,332,0,332,0
4_7134891,overcome_anger_love_marzipan_mercury_saturn,7134891,4,324,0,324,0
4_585158,overcome_dread_love_rice_mercury_saturn,585158,4,465,0,465,0
4_1486762,overcome_dread_love_papaya_mercury_saturn,1486762,4,332,0,332,0
4_3954493,overcome_jealousy_love_rice_mercury_saturn,3954493,4,304,0,304,0
4_7598529,overcome_laceration_love_rice_mercury_saturn,7598529,4,518,0,518,0
4_3470541,overcome_laceration_love_marzipan_mercury_saturn,3470541,4,531,0,531,0
4_575897,craves_jealousy_cherry,575897,4,46,23,69,0
4_2928243,harmony_love_uranus,2928243,4,87,47,134,0
4_4864290,harmony_love_earth,4864290,4,126,63,189,0
4_4968840,locale_papaya_bavaria,4968840,4,53,8,61,0
4_4815813,noop_craves_satiety_rice,4815813,4,210,0,210,0
4_7099223,succumb_jealousy_satiety_rice_mercury_saturn,7099223,4,305,0,305,0
4_1677712,succumb_anxiety_satiety_rice_mercury_saturn,1677712,4,277,0,277,0
4_2829527,succumb_laceration_satiety_rice_mercury_saturn,2829527,4,267,0,267,0
4_3118069,succumb_anger_satiety_rice_mercury_saturn,3118069,4,277,0,277,0
4_2732655,feast_satiety_rice_papaya_bavaria_guanabara,2732655,4,289,0,289,0
4_4011732,feast_satiety_rice_papaya_guanabara_bosnia,4011732,4,289,0,289,0
4_4373908,feast_satiety_rice_papaya_bosnia_alsace,4373908,4,621,0,621,0
4_7080972,feast_satiety_rice_papaya_goias_bavaria,7080972,4,312,0,312,0
4_3178308,feast_satiety_rice_marzipan_bavaria_guanabara,3178308,4,289,0,289,0
4_5857448,feast_satiety_rice_marzipan_guanabara_bosnia,5857448,4,289,0,289,0
4_592492,feast_satiety_rice_marzipan_bosnia_alsace,592492,4,621,0,621,0
4_3299556,feast_satiety_rice_marzipan_goias_bavaria,3299556,4,312,0,312,0
4_2683688,feast_satiety_rice_cherry_bavaria_guanabara,2683688,4,289,0,289,0
4_729890,feast_satiety_rice_cherry_guanabara_bosnia,729890,4,289,0,289,0
4_2111311,feast_satiety_rice_cherry_bosnia_alsace,2111311,4,621,0,621,0
4_4818375,feast_satiety_rice_cherry_goias_bavaria,4818375,4,312,0,312,0
4_6711988,overcome_hangover_satiety_rice_mercury_saturn,6711988,4,435,0,435,0
4_7109218,overcome_dread_satiety_rice_mercury_saturn,7109218,4,435,0,435,0
4_5533913,overcome_jealousy_satiety_rice_mercury_saturn,5533913,4,289,0,289,0
4_7200461,overcome_laceration_satiety_rice_mercury_saturn,7200461,4,292,0,292,0
4_1992768,noop_craves_satisfaction_yogurt,1992768,4,163,0,163,0
4_2954263,succumb_loneliness_satisfaction_yogurt_mercury_saturn,2954263,4,204,0,204,0
4_6315474,succumb_abrasion_satisfaction_yogurt_mercury_saturn,6315474,4,224,0,224,0
4_943303,feast_satisfaction_yogurt_wonderbread_bavaria_guanabara,943303,4,194,0,194,0
4_7270672,feast_satisfaction_yogurt_wonderbread_goias_bavaria,7270672,4,224,0,224,0
4_6965088,feast_satisfaction_yogurt_potato_bavaria_guanabara,6965088,4,194,0,194,0
4_4317975,feast_satisfaction_yogurt_potato_goias_bavaria,4317975,4,224,0,224,0
4_7610369,overcome_abrasion_satisfaction_yogurt_mercury_saturn,7610369,4,190,0,190,0
4_6830921,overcome_loneliness_satisfaction_yogurt_mercury_saturn,6830921,4,237,0,237,0
4_6154015,fears_boils_satisfaction,6154015,4,35,44,79,0
4_975900,craves_satisfaction_turkey,975900,4,29,30,59,0
4_1903589,noop_food_ham,1903589,4,0,0,0,0
4_7929137,succumb_sciatica_rest_ham_mercury_saturn,7929137,4,289,0,289,0
4_7507245,succumb_loneliness-3_rest_ham_mercury_saturn,7507245,4,269,0,269,0
4_6168538,succumb_angina_rest_ham_mercury_saturn,6168538,4,298,0,298,0
4_2037512,feast_rest_onion_ham_bavaria_guanabara,2037512,4,313,0,313,0
4_1727488,feast_rest_onion_ham_guanabara_bosnia,1727488,4,313,0,313,0
4_5995026,feast_rest_onion_ham_bosnia_alsace,5995026,4,420,0,420,0
4_5600664,feast_satisfaction_onion_ham_bavaria_guanabara,5600664,4,274,0,274,0
4_5241834,feast_satisfaction_onion_ham_guanabara_bosnia,5241834,4,274,0,274,0
4_1522582,feast_satisfaction_onion_ham_bosnia_alsace,1522582,4,378,0,378,0
4_2552410,feast_satiety_ham_onion_bavaria_guanabara,2552410,4,569,0,569,0
4_6136629,feast_satiety_ham_onion_goias_bavaria,6136629,4,339,0,339,0
4_1554855,feast_satiety_ham_mutton_bavaria_guanabara,1554855,4,569,0,569,0
4_102332,feast_satiety_ham_mutton_goias_bavaria,102332,4,339,0,339,0
4_5460315,feast_satiety_ham_wonderbread_bavaria_guanabara,5460315,4,569,0,569,0
4_7611715,feast_satiety_ham_wonderbread_goias_bavaria,7611715,4,339,0,339,0
4_1270520,feast_excitement_onion_ham_bavaria_guanabara,1270520,4,429,0,429,0
4_2224553,feast_excitement_onion_ham_guanabara_bosnia,2224553,4,429,0,429,0
4_306789,feast_excitement_onion_ham_bosnia_alsace,306789,4,526,0,526,0
4_7858450,feast_love_onion_ham_bavaria_guanabara,7858450,4,392,0,392,0
4_2437810,feast_love_onion_ham_guanabara_bosnia,2437810,4,392,0,392,0
4_1059112,feast_love_onion_ham_bosnia_alsace,1059112,4,503,0,503,0
4_7338256,feast_lubricity_wonderbread_ham_bosnia_alsace,7338256,4,358,0,358,0
4_6207880,feast_lubricity_wonderbread_ham_bavaria_guanabara,6207880,4,301,0,301,0
4_1381564,feast_love_ham_onion_bavaria_guanabara,1381564,4,618,0,618,0
4_6581449,feast_love_ham_onion_goias_bavaria,6581449,4,392,0,392,0
4_5855405,feast_love_ham_mutton_bavaria_guanabara,5855405,4,618,0,618,0
4_1962574,feast_love_ham_mutton_goias_bavaria,1962574,4,392,0,392,0
4_29662,feast_love_ham_wonderbread_bavaria_guanabara,29662,4,618,0,618,0
4_4417689,feast_love_ham_wonderbread_goias_bavaria,4417689,4,392,0,392,0
4_1140983,feast_satisfaction_wonderbread_ham_bosnia_alsace,1140983,4,277,0,277,0
4_1379482,feast_satisfaction_wonderbread_ham_bavaria_guanabara,1379482,4,222,0,222,0
4_7124755,feast_satisfaction_ham_onion_bavaria_guanabara,7124755,4,449,0,449,0
4_7044919,feast_satisfaction_ham_onion_goias_bavaria,7044919,4,215,0,215,0
4_3932533,feast_satisfaction_ham_mutton_bavaria_guanabara,3932533,4,449,0,449,0
4_596239,feast_satisfaction_ham_mutton_goias_bavaria,596239,4,215,0,215,0
4_6906997,feast_satisfaction_ham_wonderbread_bavaria_guanabara,6906997,4,449,0,449,0
4_222054,feast_satisfaction_ham_wonderbread_goias_bavaria,222054,4,215,0,215,0
4_6984107,feast_achievement_onion_ham_bavaria_guanabara,6984107,4,430,0,430,0
4_152866,feast_achievement_onion_ham_guanabara_bosnia,152866,4,430,0,430,0
4_4906330,feast_achievement_onion_ham_bosnia_alsace,4906330,4,527,0,527,0
4_3665438,feast_intoxication_ham_onion_bavaria_guanabara,3665438,4,441,0,441,0
4_686136,feast_intoxication_ham_onion_goias_bavaria,686136,4,219,0,219,0
4_6455828,feast_intoxication_ham_mutton_bavaria_guanabara,6455828,4,441,0,441,0
4_4947099,feast_intoxication_ham_mutton_goias_bavaria,4947099,4,219,0,219,0
4_7065083,feast_intoxication_ham_wonderbread_bavaria_guanabara,7065083,4,441,0,441,0
4_6107414,feast_intoxication_ham_wonderbread_goias_bavaria,6107414,4,219,0,219,0
4_3607229,feast_lubricity_onion_ham_bavaria_guanabara,3607229,4,324,0,324,0
4_4577717,feast_lubricity_onion_ham_guanabara_bosnia,4577717,4,324,0,324,0
4_4680578,feast_lubricity_onion_ham_bosnia_alsace,4680578,4,388,0,388,0
4_2141347,feast_intoxication_onion_ham_bavaria_guanabara,2141347,4,248,0,248,0
4_4384468,feast_intoxication_onion_ham_guanabara_bosnia,4384468,4,248,0,248,0
4_3164776,feast_intoxication_onion_ham_bosnia_alsace,3164776,4,384,0,384,0
4_2926233,feast_rest_wonderbread_ham_bosnia_alsace,2926233,4,306,0,306,0
4_4434939,feast_rest_wonderbread_ham_bavaria_guanabara,4434939,4,286,0,286,0
4_3561603,feast_rest_ham_onion_bavaria_guanabara,3561603,4,293,0,293,0
4_3516386,feast_rest_ham_onion_goias_bavaria,3516386,4,284,0,284,0
4_3876999,feast_rest_ham_mutton_bavaria_guanabara,3876999,4,293,0,293,0
4_1402192,feast_rest_ham_mutton_goias_bavaria,1402192,4,284,0,284,0
4_1961477,feast_rest_ham_wonderbread_bavaria_guanabara,1961477,4,293,0,293,0
4_2007304,feast_rest_ham_wonderbread_goias_bavaria,2007304,4,284,0,284,0
4_1028319,feast_satiety_onion_ham_bavaria_guanabara,1028319,4,339,0,339,0
4_504647,feast_satiety_onion_ham_guanabara_bosnia,504647,4,339,0,339,0
4_614292,feast_satiety_onion_ham_bosnia_alsace,614292,4,450,0,450,0
4_7026343,feast_intoxication_wonderbread_ham_bosnia_alsace,7026343,4,233,0,233,0
4_1537568,feast_intoxication_wonderbread_ham_bavaria_guanabara,1537568,4,203,0,203,0
4_5131320,feast_lubricity_ham_onion_bavaria_guanabara,5131320,4,546,0,546,0
4_2201938,feast_lubricity_ham_onion_goias_bavaria,2201938,4,321,0,321,0
4_5675701,feast_lubricity_ham_mutton_bavaria_guanabara,5675701,4,546,0,546,0
4_944538,feast_lubricity_ham_mutton_goias_bavaria,944538,4,321,0,321,0
4_3734418,feast_lubricity_ham_wonderbread_bavaria_guanabara,3734418,4,546,0,546,0
4_6419327,feast_lubricity_ham_wonderbread_goias_bavaria,6419327,4,321,0,321,0
4_5941935,overcome_loneliness-3_rest_ham_mercury_saturn,5941935,4,271,0,271,0
4_1168032,overcome_loneliness-3_satiety_ham_mercury_saturn,1168032,4,360,0,360,0
4_259961,overcome_loneliness-3_satisfaction_ham_mercury_saturn,259961,4,231,0,231,0
4_496858,noop_pain_boils-1,496858,4,0,0,0,0
4_5683581,succumb_boils-1_rest_arugula_mercury_saturn,5683581,4,326,0,326,0
4_2781132,succumb_boils-1_satisfaction_arugula_mercury_saturn,2781132,4,243,0,243,0
4_3825697,succumb_boils-1_satisfaction_wonderbread_mercury_saturn,3825697,4,243,0,243,0
4_5370401,succumb_boils-1_satisfaction_potato_mercury_saturn,5370401,4,243,0,243,0
4_944720,overcome_boils-1_rest_wonderbread_mercury_saturn,944720,4,430,0,430,0
4_6979322,overcome_boils-1_rest_potato_mercury_saturn,6979322,4,439,0,439,0
4_6615081,overcome_boils-1_rest_arugula_mercury_saturn,6615081,4,319,0,319,0
4_1460727,overcome_boils-1_satisfaction_wonderbread_mercury_saturn,1460727,4,359,0,359,0
4_5406713,overcome_boils-1_satisfaction_potato_mercury_saturn,5406713,4,341,0,341,0
4_4076027,overcome_boils-1_satisfaction_arugula_mercury_saturn,4076027,4,208,0,208,0
4_2080364,overcome_boils-1_lubricity_potato_mercury_saturn,2080364,4,437,0,437,0
4_5887254,noop_eats_marzipan_haroset,5887254,4,0,0,0,0
4_2394754,feast_excitement_marzipan_haroset_guanabara_bosnia,2394754,4,324,0,324,0
4_349869,feast_excitement_marzipan_haroset_alsace_surrey,349869,4,568,0,568,0
4_5395724,feast_excitement_marzipan_haroset_bosnia_alsace,5395724,4,324,0,324,0
4_4080806,feast_lubricity_marzipan_haroset_guanabara_bosnia,4080806,4,359,0,359,0
4_4833218,feast_lubricity_marzipan_haroset_alsace_surrey,4833218,4,594,0,594,0
4_1878096,feast_lubricity_marzipan_haroset_bosnia_alsace,1878096,4,359,0,359,0
4_4569317,feast_achievement_marzipan_haroset_guanabara_bosnia,4569317,4,325,0,325,0
4_2344992,feast_achievement_marzipan_haroset_alsace_surrey,2344992,4,569,0,569,0
4_7390847,feast_achievement_marzipan_haroset_bosnia_alsace,7390847,4,325,0,325,0
4_2307865,feast_rest_marzipan_haroset_guanabara_bosnia,2307865,4,360,0,360,0
4_3493087,feast_rest_marzipan_haroset_alsace_surrey,3493087,4,575,0,575,0
4_537965,feast_rest_marzipan_haroset_bosnia_alsace,537965,4,360,0,360,0
4_376050,feast_love_marzipan_haroset_guanabara_bosnia,376050,4,370,0,370,0
4_4476418,feast_love_marzipan_haroset_alsace_surrey,4476418,4,565,0,565,0
4_1521296,feast_love_marzipan_haroset_bosnia_alsace,1521296,4,370,0,370,0
4_7253385,feast_satisfaction_marzipan_haroset_guanabara_bosnia,7253385,4,349,0,349,0
4_2524776,feast_satisfaction_marzipan_haroset_alsace_surrey,2524776,4,589,0,589,0
4_7570631,feast_satisfaction_marzipan_haroset_bosnia_alsace,7570631,4,349,0,349,0
4_5806703,feast_satiety_marzipan_haroset_guanabara_bosnia,5806703,4,316,0,316,0
4_6047420,feast_satiety_marzipan_haroset_alsace_surrey,6047420,4,519,0,519,0
4_3092298,feast_satiety_marzipan_haroset_bosnia_alsace,3092298,4,316,0,316,0
4_6462913,noop_eats_marzipan_onion,6462913,4,0,0,0,0
4_82049,feast_excitement_marzipan_onion_guanabara_bosnia,82049,4,324,0,324,0
4_7899276,feast_excitement_marzipan_onion_alsace_surrey,7899276,4,568,0,568,0
4_4944154,feast_excitement_marzipan_onion_bosnia_alsace,4944154,4,324,0,324,0
4_3679682,feast_lubricity_marzipan_onion_guanabara_bosnia,3679682,4,359,0,359,0
4_6023505,feast_lubricity_marzipan_onion_alsace_surrey,6023505,4,594,0,594,0
4_3068383,feast_lubricity_marzipan_onion_bosnia_alsace,3068383,4,359,0,359,0
4_6771986,feast_achievement_marzipan_onion_guanabara_bosnia,6771986,4,325,0,325,0
4_6398757,feast_achievement_marzipan_onion_alsace_surrey,6398757,4,569,0,569,0
4_3443635,feast_achievement_marzipan_onion_bosnia_alsace,3443635,4,325,0,325,0
4_4648157,feast_rest_marzipan_onion_guanabara_bosnia,4648157,4,360,0,360,0
4_4224803,feast_rest_marzipan_onion_alsace_surrey,4224803,4,575,0,575,0
4_1269681,feast_rest_marzipan_onion_bosnia_alsace,1269681,4,360,0,360,0
4_349629,feast_love_marzipan_onion_guanabara_bosnia,349629,4,370,0,370,0
4_6203209,feast_love_marzipan_onion_alsace_surrey,6203209,4,565,0,565,0
4_3248087,feast_love_marzipan_onion_bosnia_alsace,3248087,4,370,0,370,0
4_4790828,feast_satisfaction_marzipan_onion_guanabara_bosnia,4790828,4,349,0,349,0
4_4280337,feast_satisfaction_marzipan_onion_alsace_surrey,4280337,4,589,0,589,0
4_1325215,feast_satisfaction_marzipan_onion_bosnia_alsace,1325215,4,349,0,349,0
4_2477291,feast_satiety_marzipan_onion_guanabara_bosnia,2477291,4,316,0,316,0
4_1902659,feast_satiety_marzipan_onion_alsace_surrey,1902659,4,519,0,519,0
4_6948514,feast_satiety_marzipan_onion_bosnia_alsace,6948514,4,316,0,316,0
4_1413190,noop_fears_anxiety_love,1413190,4,213,0,213,0
4_3246453,fears_laceration_love,3246453,4,49,35,84,0
4_7323719,craves_anxiety_marzipan,7323719,4,25,16,41,0
4_7254354,noop_craves_satiety_mutton,7254354,4,263,0,263,0
4_7974847,succumb_anxiety_satiety_mutton_mercury_saturn,7974847,4,308,0,308,0
4_4104692,succumb_laceration_satiety_mutton_mercury_saturn,4104692,4,305,0,305,0
4_7684553,succumb_anger_satiety_mutton_mercury_saturn,7684553,4,308,0,308,0
4_2776295,feast_satiety_mutton_marzipan_bavaria_guanabara,2776295,4,302,0,302,0
4_3502772,feast_satiety_mutton_marzipan_goias_bavaria,3502772,4,302,0,302,0
4_5089198,overcome_loneliness-3_satiety_mutton_mercury_saturn,5089198,4,538,0,538,0
4_5543869,noop_craves_excitement_cherry,5543869,4,214,0,214,0
4_3479644,feast_excitement_cherry_marzipan_bavaria_guanabara,3479644,4,297,0,297,0
4_1108045,feast_excitement_cherry_marzipan_guanabara_bosnia,1108045,4,297,0,297,0
4_3099929,feast_excitement_cherry_marzipan_bosnia_alsace,3099929,4,591,0,591,0
4_5806993,feast_excitement_cherry_marzipan_goias_bavaria,5806993,4,322,0,322,0
4_3000235,feast_excitement_cherry_endive_bavaria_guanabara,3000235,4,297,0,297,0
4_137304,feast_excitement_cherry_endive_guanabara_bosnia,137304,4,297,0,297,0
4_2960861,feast_excitement_cherry_endive_bosnia_alsace,2960861,4,591,0,591,0
4_5667925,feast_excitement_cherry_endive_goias_bavaria,5667925,4,322,0,322,0
4_4704340,feast_excitement_cherry_rice_bavaria_guanabara,4704340,4,297,0,297,0
4_5363348,feast_excitement_cherry_rice_guanabara_bosnia,5363348,4,297,0,297,0
4_2566589,feast_excitement_cherry_rice_bosnia_alsace,2566589,4,591,0,591,0
4_5273653,feast_excitement_cherry_rice_goias_bavaria,5273653,4,322,0,322,0
4_2407942,craves_excitement_papaya,2407942,4,28,37,65,0
4_2490887,craves_excitement_rice,2490887,4,39,39,78,0
4_6688887,craves_dread_wurst,6688887,4,36,16,52,0
4_1168384,harmony_excitement_mercury,1168384,4,31,31,62,0
4_6767175,craves_dread_rice,6767175,4,38,15,53,0
4_7539959,craves_excitement_marzipan,7539959,4,48,27,75,0
4_4037416,fears_prostatitis_excitement,4037416,4,30,36,66,0
4_7477118,locale_papaya_alsace,7477118,4,29,39,68,0
4_2441720,harmony_excitement_saturn,2441720,4,51,36,87,0
4_92031,craves_excitement_wurst,92031,4,24,29,53,0
4_7551117,noop_craves_rest_shrimp,7551117,4,279,0,279,0
4_7905902,succumb_loneliness-3_rest_shrimp_mercury_saturn,7905902,4,308,0,308,0
4_5971223,succumb_angina_rest_shrimp_mercury_saturn,5971223,4,320,0,320,0
4_5976931,feast_rest_shrimp_onion_guanabara_bosnia,5976931,4,356,0,356,0
4_4666379,feast_rest_shrimp_onion_bosnia_alsace,4666379,4,611,0,611,0
4_7373443,feast_rest_shrimp_onion_goias_bavaria,7373443,4,453,0,453,0
4_1762048,feast_rest_shrimp_onion_bavaria_guanabara,1762048,4,356,0,356,0
4_4995154,feast_rest_shrimp_turkey_guanabara_bosnia,4995154,4,356,0,356,0
4_1904476,feast_rest_shrimp_turkey_bosnia_alsace,1904476,4,611,0,611,0
4_4611540,feast_rest_shrimp_turkey_goias_bavaria,4611540,4,453,0,453,0
4_6458400,feast_rest_shrimp_turkey_bavaria_guanabara,6458400,4,356,0,356,0
4_4495508,feast_rest_shrimp_potato_guanabara_bosnia,4495508,4,356,0,356,0
4_6656688,feast_rest_shrimp_potato_bosnia_alsace,6656688,4,611,0,611,0
4_1362775,feast_rest_shrimp_potato_goias_bavaria,1362775,4,453,0,453,0
4_6564656,feast_rest_shrimp_potato_bavaria_guanabara,6564656,4,356,0,356,0
4_6916063,overcome_loneliness_rest_shrimp_mercury_saturn,6916063,4,493,0,493,0
4_7131947,locale_onion_alsace,7131947,4,40,48,88,0
4_3200037,noop_fears_boils_rest,3200037,4,374,0,374,0
4_1682327,craves_boils_shrimp,1682327,4,21,20,41,0
4_5022204,fears_boils_lubricity,5022204,4,38,24,62,0
4_5809964,noop_fears_abrasion_rest,5809964,4,294,0,294,0
4_4011309,succumb_abrasion_rest_yogurt_mercury_saturn,4011309,4,307,0,307,0
4_5051695,craves_abrasion_yogurt,5051695,4,14,12,26,0
4_208680,noop_fears_angina_satisfaction,208680,4,223,0,223,0
4_6926845,succumb_angina_satisfaction_onion_mercury_saturn,6926845,4,239,0,239,0
4_131867,harmony_satisfaction_saturn,131867,4,55,25,80,0
4_6982256,fears_loneliness_satisfaction,6982256,4,27,32,59,0
4_2249450,fears_angina_lubricity,2249450,4,37,13,50,0
4_5915405,noop_craves_rest_onion,5915405,4,234,0,234,0
4_6471092,succumb_loneliness-3_rest_onion_mercury_saturn,6471092,4,285,0,285,0
4_3681945,succumb_angina_rest_onion_mercury_saturn,3681945,4,298,0,298,0
4_505963,feast_rest_onion_marzipan_bavaria_guanabara,505963,4,313,0,313,0
4_2127805,feast_rest_onion_marzipan_guanabara_bosnia,2127805,4,314,0,314,0
4_513134,feast_rest_onion_marzipan_bosnia_alsace,513134,4,421,0,421,0
4_5387050,feast_rest_onion_shrimp_bavaria_guanabara,5387050,4,313,0,313,0
4_5678553,feast_rest_onion_shrimp_guanabara_bosnia,5678553,4,314,0,314,0
4_7149765,feast_rest_onion_shrimp_bosnia_alsace,7149765,4,421,0,421,0
4_2841049,overcome_loneliness-3_rest_onion_mercury_saturn,2841049,4,288,0,288,0
4_4026357,overcome_angina_rest_onion_mercury_saturn,4026357,4,277,0,277,0
4_1016330,noop_pleasure_love,1016330,4,0,0,0,0
4_4217621,feast_love_onion_marzipan_bavaria_guanabara,4217621,4,392,0,392,0
4_5830254,feast_love_onion_marzipan_guanabara_bosnia,5830254,4,392,0,392,0
4_2491540,feast_love_onion_marzipan_bosnia_alsace,2491540,4,503,0,503,0
4_6370381,feast_love_onion_shrimp_bavaria_guanabara,6370381,4,392,0,392,0
4_87961,feast_love_onion_shrimp_guanabara_bosnia,87961,4,392,0,392,0
4_7860087,feast_love_onion_shrimp_bosnia_alsace,7860087,4,503,0,503,0
4_7393960,feast_love_turkey_haroset_goias_bavaria,7393960,4,398,0,398,0
4_5346619,feast_love_mutton_marzipan_bavaria_guanabara,5346619,4,354,0,354,0
4_308746,feast_love_mutton_marzipan_goias_bavaria,308746,4,354,0,354,0
4_5053592,feast_love_marzipan_mutton_guanabara_bosnia,5053592,4,370,0,370,0
4_1897884,feast_love_marzipan_mutton_alsace_surrey,1897884,4,565,0,565,0
4_6943739,feast_love_marzipan_mutton_bosnia_alsace,6943739,4,370,0,370,0
4_2444222,feast_love_marzipan_rice_guanabara_bosnia,2444222,4,370,0,370,0
4_7626089,feast_love_marzipan_rice_alsace_surrey,7626089,4,565,0,565,0
4_4670967,feast_love_marzipan_rice_bosnia_alsace,4670967,4,370,0,370,0
4_6075113,feast_love_marzipan_cherry_guanabara_bosnia,6075113,4,370,0,370,0
4_7426818,feast_love_marzipan_cherry_alsace_surrey,7426818,4,565,0,565,0
4_4471696,feast_love_marzipan_cherry_bosnia_alsace,4471696,4,370,0,370,0
4_6379374,feast_love_haroset_marzipan_bavaria_guanabara,6379374,4,355,0,355,0
4_5334275,feast_love_haroset_marzipan_goias_bavaria,5334275,4,351,0,351,0
4_7479070,feast_love_haroset_turkey_bavaria_guanabara,7479070,4,355,0,355,0
4_4746400,feast_love_haroset_turkey_goias_bavaria,4746400,4,351,0,351,0
4_7539606,feast_love_rice_papaya_bavaria_guanabara,7539606,4,333,0,333,0
4_311305,feast_love_rice_papaya_guanabara_bosnia,311305,4,333,0,333,0
4_537240,feast_love_rice_papaya_bosnia_alsace,537240,4,462,0,462,0
4_3244304,feast_love_rice_papaya_goias_bavaria,3244304,4,333,0,333,0
4_1050646,feast_love_rice_marzipan_bavaria_guanabara,1050646,4,333,0,333,0
4_4286446,feast_love_rice_marzipan_guanabara_bosnia,4286446,4,333,0,333,0
4_7422623,feast_love_rice_marzipan_bosnia_alsace,7422623,4,462,0,462,0
4_2128710,feast_love_rice_marzipan_goias_bavaria,2128710,4,333,0,333,0
4_7490639,feast_love_rice_cherry_bavaria_guanabara,7490639,4,333,0,333,0
4_5030440,feast_love_rice_cherry_guanabara_bosnia,5030440,4,333,0,333,0
4_6275620,feast_love_rice_cherry_bosnia_alsace,6275620,4,462,0,462,0
4_981707,feast_love_rice_cherry_goias_bavaria,981707,4,333,0,333,0
4_1320041,feast_love_papaya_rice_bosnia_alsace,1320041,4,473,0,473,0
4_2917389,feast_love_papaya_rice_bavaria_guanabara,2917389,4,310,0,310,0
4_4027105,feast_love_papaya_rice_goias_bavaria,4027105,4,396,0,396,0
4_2074717,feast_love_papaya_rice_guanabara_bosnia,2074717,4,310,0,310,0
4_7099199,feast_love_papaya_wurst_bosnia_alsace,7099199,4,473,0,473,0
4_882237,feast_love_papaya_wurst_bavaria_guanabara,882237,4,310,0,310,0
4_1805286,feast_love_papaya_wurst_goias_bavaria,1805286,4,396,0,396,0
4_566584,feast_love_papaya_wurst_guanabara_bosnia,566584,4,310,0,310,0
4_1850201,feast_love_endive_cherry_goias_bavaria,1850201,4,542,0,542,0
4_4914153,feast_love_endive_cherry_bavaria_guanabara,4914153,4,339,0,339,0
4_1207410,feast_love_endive_cherry_guanabara_bosnia,1207410,4,339,0,339,0
4_7144114,feast_love_endive_cherry_bosnia_alsace,7144114,4,503,0,503,0
4_7486223,feast_love_endive_wurst_goias_bavaria,7486223,4,542,0,542,0
4_937812,feast_love_endive_wurst_bavaria_guanabara,937812,4,339,0,339,0
4_5348635,feast_love_endive_wurst_guanabara_bosnia,5348635,4,339,0,339,0
4_4779159,feast_love_endive_wurst_bosnia_alsace,4779159,4,503,0,503,0
4_386339,feast_love_shrimp_onion_guanabara_bosnia,386339,4,454,0,454,0
4_5376701,feast_love_shrimp_onion_bosnia_alsace,5376701,4,695,0,695,0
4_82788,feast_love_shrimp_onion_goias_bavaria,82788,4,561,0,561,0
4_2745379,feast_love_shrimp_onion_bavaria_guanabara,2745379,4,454,0,454,0
4_5978485,feast_love_shrimp_turkey_guanabara_bosnia,5978485,4,454,0,454,0
4_7725414,feast_love_shrimp_turkey_bosnia_alsace,7725414,4,695,0,695,0
4_2431501,feast_love_shrimp_turkey_goias_bavaria,2431501,4,561,0,561,0
4_2159872,feast_love_shrimp_turkey_bavaria_guanabara,2159872,4,454,0,454,0
4_5478839,feast_love_shrimp_potato_guanabara_bosnia,5478839,4,454,0,454,0
4_4476649,feast_love_shrimp_potato_bosnia_alsace,4476649,4,695,0,695,0
4_7183713,feast_love_shrimp_potato_goias_bavaria,7183713,4,561,0,561,0
4_2266128,feast_love_shrimp_potato_bavaria_guanabara,2266128,4,454,0,454,0
4_456128,noop_fears_laceration_love,456128,4,272,0,272,0
4_3324635,craves_laceration_cherry,3324635,4,23,22,45,0
4_5436552,fears_anxiety_love,5436552,4,39,13,52,0
4_6094164,noop_fears_sciatica_rest,6094164,4,253,0,253,0
4_2950032,succumb_sciatica_rest_yogurt_mercury_saturn,2950032,4,299,0,299,0
4_5273458,succumb_sciatica_rest_wonderbread_mercury_saturn,5273458,4,290,0,290,0
4_5892744,succumb_sciatica_rest_arugula_mercury_saturn,5892744,4,299,0,299,0
4_6255097,craves_sciatica_wonderbread,6255097,4,13,13,26,0
4_176606,noop_craves_satiety_haroset,176606,4,259,0,259,0
4_184908,succumb_anxiety_satiety_haroset_mercury_saturn,184908,4,308,0,308,0
4_3960332,succumb_laceration-8_satiety_haroset_mercury_saturn,3960332,4,324,0,324,0
4_1546376,succumb_laceration_satiety_haroset_mercury_saturn,1546376,4,305,0,305,0
4_5879414,succumb_anger_satiety_haroset_mercury_saturn,5879414,4,308,0,308,0
4_4456544,feast_satiety_haroset_marzipan_bavaria_guanabara,4456544,4,303,0,303,0
4_6905277,feast_satiety_haroset_marzipan_goias_bavaria,6905277,4,298,0,298,0
4_93129,feast_satiety_haroset_turkey_bavaria_guanabara,93129,4,303,0,303,0
4_445850,feast_satiety_haroset_turkey_goias_bavaria,445850,4,298,0,298,0
4_5255227,overcome_laceration-8_satiety_haroset_mercury_saturn,5255227,4,293,0,293,0
4_5746620,noop_fears_loneliness-3_intoxication,5746620,4,223,0,223,0
4_4737077,craves_loneliness-3_ham,4737077,4,17,19,36,0
4_6280431,noop_craves_achievement_cherry,6280431,4,179,0,179,0
4_6170330,succumb_laceration_achievement_cherry_mercury_saturn,6170330,4,275,0,275,0
4_2425929,succumb_grief_achievement_cherry_mercury_saturn,2425929,4,231,0,231,0
4_6331705,succumb_depression_achievement_cherry_mercury_saturn,6331705,4,231,0,231,0
4_5654207,feast_achievement_cherry_marzipan_bavaria_guanabara,5654207,4,264,0,264,0
4_1522839,feast_achievement_cherry_marzipan_guanabara_bosnia,1522839,4,264,0,264,0
4_3013961,feast_achievement_cherry_marzipan_bosnia_alsace,3013961,4,480,0,480,0
4_5721025,feast_achievement_cherry_marzipan_goias_bavaria,5721025,4,289,0,289,0
4_1689195,feast_achievement_cherry_endive_bavaria_guanabara,1689195,4,264,0,264,0
4_2132427,feast_achievement_cherry_endive_guanabara_bosnia,2132427,4,264,0,264,0
4_673471,feast_achievement_cherry_endive_bosnia_alsace,673471,4,480,0,480,0
4_3380535,feast_achievement_cherry_endive_goias_bavaria,3380535,4,289,0,289,0
4_4618372,feast_achievement_cherry_rice_bavaria_guanabara,4618372,4,264,0,264,0
4_3862829,feast_achievement_cherry_rice_guanabara_bosnia,3862829,4,264,0,264,0
4_1277090,feast_achievement_cherry_rice_bosnia_alsace,1277090,4,480,0,480,0
4_3984154,feast_achievement_cherry_rice_goias_bavaria,3984154,4,289,0,289,0
4_6582681,overcome_jealousy_achievement_cherry_mercury_saturn,6582681,4,512,0,512,0
4_1622416,overcome_laceration_achievement_cherry_mercury_saturn,1622416,4,277,0,277,0
4_3812864,craves_achievement_marzipan,3812864,4,47,31,78,0
4_4333152,fears_anger_achievement,4333152,4,34,39,73,0
4_2231879,noop_fears_boils_lubricity,2231879,4,146,0,146,0
4_2227981,noop_food_marzipan,2227981,4,0,0,0,0
4_214883,succumb_jealousy_satiety_marzipan_mercury_saturn,214883,4,305,0,305,0
4_7635499,succumb_anxiety_satiety_marzipan_mercury_saturn,7635499,4,277,0,277,0
4_4128319,succumb_laceration_satiety_marzipan_mercury_saturn,4128319,4,267,0,267,0
4_7525083,succumb_loneliness-3_rest_marzipan_mercury_saturn,7525083,4,285,0,285,0
4_7884658,succumb_angina_rest_marzipan_mercury_saturn,7884658,4,298,0,298,0
4_2754663,succumb_anxiety_rest_marzipan_mercury_saturn,2754663,4,308,0,308,0
4_1250244,succumb_anger_satiety_marzipan_mercury_saturn,1250244,4,277,0,277,0
4_3441113,succumb_anger_rest_marzipan_mercury_saturn,3441113,4,308,0,308,0
4_3392755,feast_rest_cherry_marzipan_bavaria_guanabara,3392755,4,438,0,438,0
4_1889051,feast_rest_cherry_marzipan_guanabara_bosnia,1889051,4,438,0,438,0
4_6550127,feast_rest_cherry_marzipan_bosnia_alsace,6550127,4,719,0,719,0
4_1256214,feast_rest_cherry_marzipan_goias_bavaria,1256214,4,467,0,467,0
4_5025831,feast_satisfaction_onion_marzipan_bavaria_guanabara,5025831,4,274,0,274,0
4_2270476,feast_satisfaction_onion_marzipan_guanabara_bosnia,2270476,4,274,0,274,0
4_568668,feast_satisfaction_onion_marzipan_bosnia_alsace,568668,4,378,0,378,0
4_7724808,feast_achievement_haroset_marzipan_bavaria_guanabara,7724808,4,399,0,399,0
4_3202849,feast_achievement_haroset_marzipan_goias_bavaria,3202849,4,391,0,391,0
4_5349174,feast_rest_rice_marzipan_bavaria_guanabara,5349174,4,438,0,438,0
4_3303115,feast_rest_rice_marzipan_guanabara_bosnia,3303115,4,438,0,438,0
4_1601685,feast_rest_rice_marzipan_bosnia_alsace,1601685,4,752,0,752,0
4_4308749,feast_rest_rice_marzipan_goias_bavaria,4308749,4,462,0,462,0
4_560928,feast_excitement_marzipan_mutton_guanabara_bosnia,560928,4,324,0,324,0
4_4038278,feast_excitement_marzipan_mutton_alsace_surrey,4038278,4,568,0,568,0
4_1083156,feast_excitement_marzipan_mutton_bosnia_alsace,1083156,4,324,0,324,0
4_6318650,feast_excitement_marzipan_rice_guanabara_bosnia,6318650,4,324,0,324,0
4_1038159,feast_excitement_marzipan_rice_alsace_surrey,1038159,4,568,0,568,0
4_6084014,feast_excitement_marzipan_rice_bosnia_alsace,6084014,4,324,0,324,0
4_1582449,feast_excitement_marzipan_cherry_guanabara_bosnia,1582449,4,324,0,324,0
4_1566235,feast_excitement_marzipan_cherry_alsace_surrey,1566235,4,568,0,568,0
4_6612090,feast_excitement_marzipan_cherry_bosnia_alsace,6612090,4,324,0,324,0
4_1442621,feast_lubricity_marzipan_mutton_guanabara_bosnia,1442621,4,359,0,359,0
4_3899522,feast_lubricity_marzipan_mutton_alsace_surrey,3899522,4,594,0,594,0
4_944400,feast_lubricity_marzipan_mutton_bosnia_alsace,944400,4,359,0,359,0
4_2801022,feast_lubricity_marzipan_rice_guanabara_bosnia,2801022,4,359,0,359,0
4_3374868,feast_lubricity_marzipan_rice_alsace_surrey,3374868,4,594,0,594,0
4_419746,feast_lubricity_marzipan_rice_bosnia_alsace,419746,4,359,0,359,0
4_2464142,feast_lubricity_marzipan_cherry_guanabara_bosnia,2464142,4,359,0,359,0
4_1427479,feast_lubricity_marzipan_cherry_alsace_surrey,1427479,4,594,0,594,0
4_6473334,feast_lubricity_marzipan_cherry_bosnia_alsace,6473334,4,359,0,359,0
4_1050398,feast_lubricity_mutton_marzipan_bavaria_guanabara,1050398,4,325,0,325,0
4_2310384,feast_lubricity_mutton_marzipan_goias_bavaria,2310384,4,325,0,325,0
4_4380699,feast_lubricity_rice_marzipan_bavaria_guanabara,4380699,4,470,0,470,0
4_4643246,feast_lubricity_rice_marzipan_guanabara_bosnia,4643246,4,470,0,470,0
4_3171402,feast_lubricity_rice_marzipan_bosnia_alsace,3171402,4,785,0,785,0
4_5878466,feast_lubricity_rice_marzipan_goias_bavaria,5878466,4,493,0,493,0
4_975722,feast_achievement_marzipan_mutton_guanabara_bosnia,975722,4,325,0,325,0
4_3952310,feast_achievement_marzipan_mutton_alsace_surrey,3952310,4,569,0,569,0
4_997188,feast_achievement_marzipan_mutton_bosnia_alsace,997188,4,325,0,325,0
4_312796,feast_achievement_marzipan_rice_guanabara_bosnia,312796,4,325,0,325,0
4_6751746,feast_achievement_marzipan_rice_alsace_surrey,6751746,4,569,0,569,0
4_3796624,feast_achievement_marzipan_rice_bosnia_alsace,3796624,4,325,0,325,0
4_1997243,feast_achievement_marzipan_cherry_guanabara_bosnia,1997243,4,325,0,325,0
4_1480267,feast_achievement_marzipan_cherry_alsace_surrey,1480267,4,569,0,569,0
4_6526122,feast_achievement_marzipan_cherry_bosnia_alsace,6526122,4,325,0,325,0
4_7725934,feast_excitement_onion_marzipan_bavaria_guanabara,7725934,4,429,0,429,0
4_5562674,feast_excitement_onion_marzipan_guanabara_bosnia,5562674,4,429,0,429,0
4_4187607,feast_excitement_onion_marzipan_bosnia_alsace,4187607,4,526,0,526,0
4_6762194,feast_satisfaction_haroset_marzipan_bavaria_guanabara,6762194,4,257,0,257,0
4_3382633,feast_satisfaction_haroset_marzipan_goias_bavaria,3382633,4,253,0,253,0
4_6891593,feast_satiety_cherry_marzipan_bavaria_guanabara,6891593,4,281,0,281,0
4_6215745,feast_satiety_cherry_marzipan_guanabara_bosnia,6215745,4,281,0,281,0
4_4153561,feast_satiety_cherry_marzipan_bosnia_alsace,4153561,4,416,0,416,0
4_6860625,feast_satiety_cherry_marzipan_goias_bavaria,6860625,4,281,0,281,0
4_1341934,feast_rest_marzipan_mutton_guanabara_bosnia,1341934,4,360,0,360,0
4_7488476,feast_rest_marzipan_mutton_alsace_surrey,7488476,4,575,0,575,0
4_4533354,feast_rest_marzipan_mutton_bosnia_alsace,4533354,4,360,0,360,0
4_1460891,feast_rest_marzipan_rice_guanabara_bosnia,1460891,4,360,0,360,0
4_1805151,feast_rest_marzipan_rice_alsace_surrey,1805151,4,575,0,575,0
4_6851006,feast_rest_marzipan_rice_bosnia_alsace,6851006,4,360,0,360,0
4_2363455,feast_rest_marzipan_cherry_guanabara_bosnia,2363455,4,360,0,360,0
4_5016433,feast_rest_marzipan_cherry_alsace_surrey,5016433,4,575,0,575,0
4_2061311,feast_rest_marzipan_cherry_bosnia_alsace,2061311,4,360,0,360,0
4_7365323,feast_excitement_mutton_marzipan_bavaria_guanabara,7365323,4,395,0,395,0
4_2449140,feast_excitement_mutton_marzipan_goias_bavaria,2449140,4,395,0,395,0
4_1538909,feast_achievement_mutton_marzipan_bavaria_guanabara,1538909,4,396,0,396,0
4_2363172,feast_achievement_mutton_marzipan_goias_bavaria,2363172,4,396,0,396,0
4_139751,feast_achievement_onion_marzipan_bavaria_guanabara,139751,4,430,0,430,0
4_4251634,feast_achievement_onion_marzipan_guanabara_bosnia,4251634,4,430,0,430,0
4_2687088,feast_achievement_onion_marzipan_bosnia_alsace,2687088,4,527,0,527,0
4_7278434,feast_rest_mutton_marzipan_bavaria_guanabara,7278434,4,281,0,281,0
4_5899338,feast_rest_mutton_marzipan_goias_bavaria,5899338,4,281,0,281,0
4_5165696,feast_lubricity_cherry_marzipan_bavaria_guanabara,5165696,4,470,0,470,0
4_1989738,feast_lubricity_cherry_marzipan_guanabara_bosnia,1989738,4,470,0,470,0
4_2961173,feast_lubricity_cherry_marzipan_bosnia_alsace,2961173,4,749,0,749,0
4_5668237,feast_lubricity_cherry_marzipan_goias_bavaria,5668237,4,498,0,498,0
4_5861802,feast_satisfaction_marzipan_mutton_guanabara_bosnia,5861802,4,349,0,349,0
4_5703226,feast_satisfaction_marzipan_mutton_alsace_surrey,5703226,4,589,0,589,0
4_2748104,feast_satisfaction_marzipan_mutton_bosnia_alsace,2748104,4,349,0,349,0
4_492580,feast_satisfaction_marzipan_rice_guanabara_bosnia,492580,4,349,0,349,0
4_5368303,feast_satisfaction_marzipan_rice_alsace_surrey,5368303,4,589,0,589,0
4_2413181,feast_satisfaction_marzipan_rice_bosnia_alsace,2413181,4,349,0,349,0
4_6883323,feast_satisfaction_marzipan_cherry_guanabara_bosnia,6883323,4,349,0,349,0
4_3231183,feast_satisfaction_marzipan_cherry_alsace_surrey,3231183,4,589,0,589,0
4_276061,feast_satisfaction_marzipan_cherry_bosnia_alsace,276061,4,349,0,349,0
4_606650,feast_lubricity_onion_marzipan_bavaria_guanabara,606650,4,324,0,324,0
4_1159330,feast_lubricity_onion_marzipan_guanabara_bosnia,1159330,4,324,0,324,0
4_2311836,feast_lubricity_onion_marzipan_bosnia_alsace,2311836,4,388,0,388,0
4_783066,feast_excitement_rice_marzipan_bavaria_guanabara,783066,4,262,0,262,0
4_159897,feast_excitement_rice_marzipan_guanabara_bosnia,159897,4,262,0,262,0
4_834693,feast_excitement_rice_marzipan_bosnia_alsace,834693,4,516,0,516,0
4_3541757,feast_excitement_rice_marzipan_goias_bavaria,3541757,4,282,0,282,0
4_7839292,feast_intoxication_onion_marzipan_bavaria_guanabara,7839292,4,248,0,248,0
4_2125197,feast_intoxication_onion_marzipan_guanabara_bosnia,2125197,4,248,0,248,0
4_3091963,feast_intoxication_onion_marzipan_bosnia_alsace,3091963,4,384,0,384,0
4_2680647,feast_lubricity_haroset_marzipan_bavaria_guanabara,2680647,4,299,0,299,0
4_5691075,feast_lubricity_haroset_marzipan_goias_bavaria,5691075,4,293,0,293,0
4_5668628,feast_satiety_marzipan_mutton_guanabara_bosnia,5668628,4,316,0,316,0
4_5091910,feast_satiety_marzipan_mutton_alsace_surrey,5091910,4,519,0,519,0
4_2136788,feast_satiety_marzipan_mutton_bosnia_alsace,2136788,4,316,0,316,0
4_4015224,feast_satiety_marzipan_rice_guanabara_bosnia,4015224,4,316,0,316,0
4_795958,feast_satiety_marzipan_rice_alsace_surrey,795958,4,519,0,519,0
4_5841813,feast_satiety_marzipan_rice_bosnia_alsace,5841813,4,316,0,316,0
4_6690149,feast_satiety_marzipan_cherry_guanabara_bosnia,6690149,4,316,0,316,0
4_2619867,feast_satiety_marzipan_cherry_alsace_surrey,2619867,4,519,0,519,0
4_7665722,feast_satiety_marzipan_cherry_bosnia_alsace,7665722,4,316,0,316,0
4_4381063,feast_intoxication_mutton_marzipan_bavaria_guanabara,4381063,4,239,0,239,0
4_1998471,feast_intoxication_mutton_marzipan_goias_bavaria,1998471,4,239,0,239,0
4_4832657,feast_satiety_onion_marzipan_bavaria_guanabara,4832657,4,339,0,339,0
4_7957916,feast_satiety_onion_marzipan_guanabara_bosnia,7957916,4,339,0,339,0
4_6191967,feast_satiety_onion_marzipan_bosnia_alsace,6191967,4,450,0,450,0
4_3104093,feast_excitement_haroset_marzipan_bavaria_guanabara,3104093,4,398,0,398,0
4_1207726,feast_excitement_haroset_marzipan_goias_bavaria,1207726,4,390,0,390,0
4_7473003,feast_achievement_rice_marzipan_bavaria_guanabara,7473003,4,297,0,297,0
4_2155020,feast_achievement_rice_marzipan_guanabara_bosnia,2155020,4,297,0,297,0
4_6548280,feast_achievement_rice_marzipan_bosnia_alsace,6548280,4,623,0,623,0
4_1254367,feast_achievement_rice_marzipan_goias_bavaria,1254367,4,319,0,319,0
4_1189353,overcome_anxiety_rest_marzipan_mercury_saturn,1189353,4,310,0,310,0
4_7184170,overcome_anxiety_achievement_marzipan_mercury_saturn,7184170,4,270,0,270,0
4_6457823,overcome_anxiety_satiety_marzipan_mercury_saturn,6457823,4,260,0,260,0
4_3748730,overcome_anxiety_satisfaction_marzipan_mercury_saturn,3748730,4,295,0,295,0
4_4069828,overcome_anger_rest_marzipan_mercury_saturn,4069828,4,310,0,310,0
4_4894876,overcome_anger_achievement_marzipan_mercury_saturn,4894876,4,270,0,270,0
4_579734,overcome_anger_satiety_marzipan_mercury_saturn,579734,4,260,0,260,0
4_1760787,overcome_anger_satisfaction_marzipan_mercury_saturn,1760787,4,295,0,295,0
4_5821948,overcome_jealousy_rest_marzipan_mercury_saturn,5821948,4,570,0,570,0
4_4763733,overcome_jealousy_achievement_marzipan_mercury_saturn,4763733,4,518,0,518,0
4_2766953,overcome_jealousy_satiety_marzipan_mercury_saturn,2766953,4,520,0,520,0
4_192087,overcome_jealousy_satisfaction_marzipan_mercury_saturn,192087,4,554,0,554,0
4_405478,overcome_laceration_rest_marzipan_mercury_saturn,405478,4,525,0,525,0
4_531226,overcome_laceration_achievement_marzipan_mercury_saturn,531226,4,457,0,457,0
4_4164631,overcome_laceration_satiety_marzipan_mercury_saturn,4164631,4,292,0,292,0
4_4803167,overcome_laceration_satisfaction_marzipan_mercury_saturn,4803167,4,505,0,505,0
4_5424666,noop_eats_yogurt_wonderbread,5424666,4,0,0,0,0
4_1342175,feast_lubricity_yogurt_wonderbread_bavaria_guanabara,1342175,4,298,0,298,0
4_2851491,feast_lubricity_yogurt_wonderbread_goias_bavaria,2851491,4,399,0,399,0
4_3396440,feast_rest_yogurt_wonderbread_bavaria_guanabara,3396440,4,299,0,299,0
4_2750804,feast_rest_yogurt_wonderbread_goias_bavaria,2750804,4,414,0,414,0
4_46149,feast_intoxication_yogurt_wonderbread_bavaria_guanabara,46149,4,197,0,197,0
4_2083156,feast_intoxication_yogurt_wonderbread_goias_bavaria,2083156,4,310,0,310,0
4_5648606,noop_locale_rice_guanabara,5648606,4,75,0,75,0
4_5129221,feast_rest_rice_papaya_bavaria_guanabara,5129221,4,438,0,438,0
4_5080254,feast_rest_rice_cherry_bavaria_guanabara,5080254,4,438,0,438,0
4_1540267,feast_lubricity_rice_papaya_bavaria_guanabara,1540267,4,470,0,470,0
4_1491300,feast_lubricity_rice_cherry_bavaria_guanabara,1491300,4,470,0,470,0
4_1679023,feast_excitement_rice_papaya_bavaria_guanabara,1679023,4,263,0,263,0
4_1630056,feast_excitement_rice_cherry_bavaria_guanabara,1630056,4,263,0,263,0
4_1593055,feast_achievement_rice_papaya_bavaria_guanabara,1593055,4,298,0,298,0
4_1544088,feast_achievement_rice_cherry_bavaria_guanabara,1544088,4,298,0,298,0
4_5580230,locale_rice_bavaria,5580230,4,42,13,55,0
4_6090059,locale_rice_bosnia,6090059,4,39,7,46,0
4_203043,noop_craves_rest_cherry,203043,4,376,0,376,0
4_7566343,feast_rest_cherry_endive_bavaria_guanabara,7566343,4,438,0,438,0
4_3280522,feast_rest_cherry_endive_guanabara_bosnia,3280522,4,438,0,438,0
4_3727853,feast_rest_cherry_endive_bosnia_alsace,3727853,4,719,0,719,0
4_6434917,feast_rest_cherry_endive_goias_bavaria,6434917,4,467,0,467,0
4_153561,feast_rest_cherry_rice_bavaria_guanabara,153561,4,438,0,438,0
4_1688875,feast_rest_cherry_rice_guanabara_bosnia,1688875,4,438,0,438,0
4_5346237,feast_rest_cherry_rice_bosnia_alsace,5346237,4,719,0,719,0
4_52324,feast_rest_cherry_rice_goias_bavaria,52324,4,467,0,467,0
4_5874531,overcome_depression_rest_cherry_mercury_saturn,5874531,4,569,0,569,0
4_270525,overcome_jealousy_rest_cherry_mercury_saturn,270525,4,673,0,673,0
4_2652325,overcome_laceration_rest_cherry_mercury_saturn,2652325,4,453,0,453,0
4_5399238,overcome_grief_rest_cherry_mercury_saturn,5399238,4,569,0,569,0
4_5636866,noop_locale_potato_goias,5636866,4,64,0,64,0
4_3037449,locale_potato_bavaria,3037449,4,27,12,39,0
4_1091294,locale_potato_guanabara,1091294,4,27,8,35,0
4_59058,noop_harmony_rest_mercury,59058,4,165,0,165,0
4_3921616,succumb_loneliness-3_rest_mutton_mercury_saturn,3921616,4,286,0,286,0
4_6054088,succumb_loneliness-3_rest_yogurt_mercury_saturn,6054088,4,296,0,296,0
4_3977670,succumb_loneliness-3_rest_wonderbread_mercury_saturn,3977670,4,286,0,286,0
4_433380,succumb_loneliness-3_rest_arugula_mercury_saturn,433380,4,296,0,296,0
4_7577871,noop_fears_prostatitis_entertainment,7577871,4,26,0,26,0
4_4565062,craves_prostatitis_wurst,4565062,4,22,7,29,0
4_3477531,harmony_entertainment_uranus,3477531,4,8,10,18,0
4_3651421,noop_food_papaya,3651421,4,0,0,0,0
4_7121790,succumb_jealousy_satiety_papaya_mercury_saturn,7121790,4,321,0,321,0
4_6226455,succumb_dread_excitement_papaya_mercury_saturn,6226455,4,234,0,234,0
4_6493355,succumb_laceration_satiety_papaya_mercury_saturn,6493355,4,290,0,290,0
4_5142496,succumb_dread_satiety_papaya_mercury_saturn,5142496,4,347,0,347,0
4_7984357,succumb_hangover_excitement_papaya_mercury_saturn,7984357,4,234,0,234,0
4_6333876,feast_rest_rice_papaya_guanabara_bosnia,6333876,4,438,0,438,0
4_1097034,feast_rest_rice_papaya_bosnia_alsace,1097034,4,752,0,752,0
4_3804098,feast_rest_rice_papaya_goias_bavaria,3804098,4,462,0,462,0
4_131601,feast_lubricity_rice_papaya_guanabara_bosnia,131601,4,470,0,470,0
4_3952265,feast_lubricity_rice_papaya_bosnia_alsace,3952265,4,785,0,785,0
4_6659329,feast_lubricity_rice_papaya_goias_bavaria,6659329,4,493,0,493,0
4_5156709,feast_satiety_papaya_rice_bosnia_alsace,5156709,4,450,0,450,0
4_6111415,feast_satiety_papaya_rice_bavaria_guanabara,6111415,4,286,0,286,0
4_7863773,feast_satiety_papaya_rice_goias_bavaria,7863773,4,532,0,532,0
4_5775144,feast_satiety_papaya_rice_guanabara_bosnia,5775144,4,286,0,286,0
4_5166036,feast_satiety_papaya_wurst_bosnia_alsace,5166036,4,450,0,450,0
4_2453239,feast_satiety_papaya_wurst_bavaria_guanabara,2453239,4,286,0,286,0
4_7873100,feast_satiety_papaya_wurst_goias_bavaria,7873100,4,532,0,532,0
4_3760610,feast_satiety_papaya_wurst_guanabara_bosnia,3760610,4,286,0,286,0
4_2007372,feast_excitement_rice_papaya_guanabara_bosnia,2007372,4,262,0,262,0
4_6318363,feast_excitement_rice_papaya_bosnia_alsace,6318363,4,516,0,516,0
4_1024450,feast_excitement_rice_papaya_goias_bavaria,1024450,4,282,0,282,0
4_7101164,feast_excitement_papaya_rice_bosnia_alsace,7101164,4,239,0,239,0
4_5057783,feast_excitement_papaya_rice_bavaria_guanabara,5057783,4,236,0,236,0
4_1807251,feast_excitement_papaya_rice_goias_bavaria,1807251,4,421,0,421,0
4_3770784,feast_excitement_papaya_rice_guanabara_bosnia,3770784,4,236,0,236,0
4_6885942,feast_excitement_papaya_wurst_bosnia_alsace,6885942,4,239,0,239,0
4_4756665,feast_excitement_papaya_wurst_bavaria_guanabara,4756665,4,236,0,236,0
4_1592029,feast_excitement_papaya_wurst_goias_bavaria,1592029,4,421,0,421,0
4_2706978,feast_excitement_papaya_wurst_guanabara_bosnia,2706978,4,236,0,236,0
4_5811665,feast_achievement_papaya_rice_bosnia_alsace,5811665,4,447,0,447,0
4_4971815,feast_achievement_papaya_rice_bavaria_guanabara,4971815,4,293,0,293,0
4_517752,feast_achievement_papaya_rice_goias_bavaria,517752,4,528,0,528,0
4_2270265,feast_achievement_papaya_rice_guanabara_bosnia,2270265,4,293,0,293,0
4_4814255,feast_achievement_papaya_wurst_bosnia_alsace,4814255,4,447,0,447,0
4_6751788,feast_achievement_papaya_wurst_bavaria_guanabara,6751788,4,293,0,293,0
4_7521319,feast_achievement_papaya_wurst_goias_bavaria,7521319,4,528,0,528,0
4_2621010,feast_achievement_papaya_wurst_guanabara_bosnia,2621010,4,293,0,293,0
4_506853,feast_achievement_rice_papaya_guanabara_bosnia,506853,4,297,0,297,0
4_5028864,feast_achievement_rice_papaya_bosnia_alsace,5028864,4,623,0,623,0
4_7735928,feast_achievement_rice_papaya_goias_bavaria,7735928,4,319,0,319,0
4_5234163,overcome_hangover_excitement_papaya_mercury_saturn,5234163,4,228,0,228,0
4_386897,overcome_hangover_satiety_papaya_mercury_saturn,386897,4,306,0,306,0
4_2596412,overcome_dread_excitement_papaya_mercury_saturn,2596412,4,228,0,228,0
4_6073996,overcome_dread_satiety_papaya_mercury_saturn,6073996,4,306,0,306,0
4_7527344,overcome_jealousy_excitement_papaya_mercury_saturn,7527344,4,504,0,504,0
4_3491747,overcome_jealousy_satiety_papaya_mercury_saturn,3491747,4,544,0,544,0
4_7971067,noop_locale_mutton_guanabara,7971067,4,30,0,30,0
4_5123081,locale_mutton_bavaria,5123081,4,30,10,40,0
4_7106972,noop_eats_arugula_wonderbread,7106972,4,0,0,0,0
4_5307194,feast_lubricity_arugula_wonderbread_bosnia_alsace,5307194,4,305,0,305,0
4_261339,feast_lubricity_arugula_wonderbread_alsace_surrey,261339,4,440,0,440,0
4_4462517,feast_lubricity_arugula_wonderbread_bavaria_guanabara,4462517,4,414,0,414,0
4_830600,feast_lubricity_arugula_wonderbread_guanabara_bosnia,830600,4,305,0,305,0
4_478796,feast_satisfaction_arugula_wonderbread_bosnia_alsace,478796,4,200,0,200,0
4_3433918,feast_satisfaction_arugula_wonderbread_alsace_surrey,3433918,4,341,0,341,0
4_6363986,feast_satisfaction_arugula_wonderbread_bavaria_guanabara,6363986,4,241,0,241,0
4_431728,feast_satisfaction_arugula_wonderbread_guanabara_bosnia,431728,4,200,0,200,0
4_3534253,feast_rest_arugula_wonderbread_bosnia_alsace,3534253,4,306,0,306,0
4_6489375,feast_rest_arugula_wonderbread_alsace_surrey,6489375,4,438,0,438,0
4_2289875,feast_rest_arugula_wonderbread_bavaria_guanabara,2289875,4,431,0,431,0
4_2884865,feast_rest_arugula_wonderbread_guanabara_bosnia,2884865,4,306,0,306,0
4_7565557,noop_craves_depression-7_haroset,7565557,4,15,0,15,0
4_797622,noop_craves_loneliness-3_mutton,797622,4,275,0,275,0
4_2743940,overcome_loneliness-3_rest_mutton_mercury_saturn,2743940,4,288,0,288,0
4_500433,noop_fears_anxiety_achievement,500433,4,258,0,258,0
4_7569808,noop_fears_abrasion_intoxication,7569808,4,181,0,181,0
4_7774906,noop_fears_loneliness_satisfaction,7774906,4,126,0,126,0
4_5490115,succumb_loneliness_satisfaction_onion_mercury_saturn,5490115,4,234,0,234,0
4_4806077,succumb_loneliness_satisfaction_shrimp_mercury_saturn,4806077,4,205,0,205,0
4_6975880,succumb_loneliness_satisfaction_arugula_mercury_saturn,6975880,4,205,0,205,0
4_2152429,succumb_loneliness_satisfaction_wonderbread_mercury_saturn,2152429,4,220,0,220,0
4_5511802,succumb_loneliness_satisfaction_potato_mercury_saturn,5511802,4,195,0,195,0
4_1112071,craves_loneliness_potato,1112071,4,19,15,34,0
4_7600772,noop_food_endive,7600772,4,0,0,0,0
4_524340,succumb_laceration_achievement_endive_mercury_saturn,524340,4,275,0,275,0
4_5693854,succumb_laceration_satiety_endive_mercury_saturn,5693854,4,267,0,267,0
4_2523863,succumb_depression_satiety_endive_mercury_saturn,2523863,4,287,0,287,0
4_4780916,succumb_grief_achievement_endive_mercury_saturn,4780916,4,224,0,224,0
4_685715,succumb_depression_achievement_endive_mercury_saturn,685715,4,224,0,224,0
4_4537425,succumb_grief_satiety_endive_mercury_saturn,4537425,4,287,0,287,0
4_3021047,feast_satiety_endive_cherry_goias_bavaria,3021047,4,348,0,348,0
4_7041815,feast_satiety_endive_cherry_bavaria_guanabara,7041815,4,258,0,258,0
4_2778412,feast_satiety_endive_cherry_guanabara_bosnia,2778412,4,258,0,258,0
4_313983,feast_satiety_endive_cherry_bosnia_alsace,313983,4,432,0,432,0
4_5553060,feast_satiety_endive_wurst_goias_bavaria,5553060,4,348,0,348,0
4_2508814,feast_satiety_endive_wurst_bavaria_guanabara,2508814,4,258,0,258,0
4_541684,feast_satiety_endive_wurst_guanabara_bosnia,541684,4,258,0,258,0
4_2845996,feast_satiety_endive_wurst_bosnia_alsace,2845996,4,432,0,432,0
4_5395477,feast_satiety_cherry_endive_bavaria_guanabara,5395477,4,281,0,281,0
4_5834855,feast_satiety_cherry_endive_guanabara_bosnia,5834855,4,281,0,281,0
4_2718660,feast_satiety_cherry_endive_bosnia_alsace,2718660,4,416,0,416,0
4_5425724,feast_satiety_cherry_endive_goias_bavaria,5425724,4,281,0,281,0
4_6597868,feast_lubricity_cherry_endive_bavaria_guanabara,6597868,4,470,0,470,0
4_4620653,feast_lubricity_cherry_endive_guanabara_bosnia,4620653,4,470,0,470,0
4_5297570,feast_lubricity_cherry_endive_bosnia_alsace,5297570,4,749,0,749,0
4_3657,feast_lubricity_cherry_endive_goias_bavaria,3657,4,498,0,498,0
4_3263248,feast_excitement_endive_cherry_goias_bavaria,3263248,4,491,0,491,0
4_4646573,feast_excitement_endive_cherry_bavaria_guanabara,4646573,4,292,0,292,0
4_5081838,feast_excitement_endive_cherry_guanabara_bosnia,5081838,4,292,0,292,0
4_556184,feast_excitement_endive_cherry_bosnia_alsace,556184,4,451,0,451,0
4_7272966,feast_excitement_endive_wurst_goias_bavaria,7272966,4,491,0,491,0
4_4812240,feast_excitement_endive_wurst_bavaria_guanabara,4812240,4,292,0,292,0
4_7489029,feast_excitement_endive_wurst_guanabara_bosnia,7489029,4,292,0,292,0
4_4565902,feast_excitement_endive_wurst_bosnia_alsace,4565902,4,451,0,451,0
4_975858,feast_achievement_endive_cherry_goias_bavaria,975858,4,389,0,389,0
4_3335533,feast_achievement_endive_cherry_bavaria_guanabara,3335533,4,238,0,238,0
4_7076961,feast_achievement_endive_cherry_guanabara_bosnia,7076961,4,238,0,238,0
4_6269771,feast_achievement_endive_cherry_bosnia_alsace,6269771,4,241,0,241,0
4_5201279,feast_achievement_endive_wurst_goias_bavaria,5201279,4,389,0,389,0
4_6807363,feast_achievement_endive_wurst_bavaria_guanabara,6807363,4,238,0,238,0
4_7403061,feast_achievement_endive_wurst_guanabara_bosnia,7403061,4,238,0,238,0
4_2494215,feast_achievement_endive_wurst_bosnia_alsace,2494215,4,241,0,241,0
4_4138778,overcome_depression_achievement_endive_mercury_saturn,4138778,4,226,0,226,0
4_5075933,overcome_depression_satiety_endive_mercury_saturn,5075933,4,276,0,276,0
4_3977403,overcome_laceration_achievement_endive_mercury_saturn,3977403,4,464,0,464,0
4_244947,overcome_laceration_satiety_endive_mercury_saturn,244947,4,292,0,292,0
4_3603240,overcome_grief_achievement_endive_mercury_saturn,3603240,4,226,0,226,0
4_5468925,overcome_grief_satiety_endive_mercury_saturn,5468925,4,276,0,276,0
4_2967144,noop_eats_ham_onion,2967144,4,0,0,0,0
4_1525959,noop_eats_marzipan_mutton,1525959,4,0,0,0,0
4_2268024,noop_fears_boils_intoxication,2268024,4,223,0,223,0
4_3895632,noop_fears_laceration_excitement,3895632,4,286,0,286,0
4_4020164,fears_dread_excitement,4020164,4,26,20,46,0
4_3516611,harmony_excitement_uranus,3516611,4,57,19,76,0
4_1628909,fears_jealousy_excitement,1628909,4,39,27,66,0
4_4460410,noop_locale_shrimp_bosnia,4460410,4,75,0,75,0
4_2076064,feast_intoxication_shrimp_onion_guanabara_bosnia,2076064,4,253,0,253,0
4_6495327,feast_intoxication_shrimp_turkey_guanabara_bosnia,6495327,4,253,0,253,0
4_5995681,feast_intoxication_shrimp_potato_guanabara_bosnia,5995681,4,253,0,253,0
4_4191681,feast_satisfaction_shrimp_onion_guanabara_bosnia,4191681,4,235,0,235,0
4_4026843,feast_satisfaction_shrimp_turkey_guanabara_bosnia,4026843,4,235,0,235,0
4_3527197,feast_satisfaction_shrimp_potato_guanabara_bosnia,3527197,4,235,0,235,0
4_3580365,feast_satiety_shrimp_onion_guanabara_bosnia,3580365,4,401,0,401,0
4_7549487,feast_satiety_shrimp_turkey_guanabara_bosnia,7549487,4,401,0,401,0
4_7049841,feast_satiety_shrimp_potato_guanabara_bosnia,7049841,4,401,0,401,0
4_2387977,feast_lubricity_shrimp_onion_guanabara_bosnia,2387977,4,315,0,315,0
4_6335285,feast_lubricity_shrimp_turkey_guanabara_bosnia,6335285,4,315,0,315,0
4_5835639,feast_lubricity_shrimp_potato_guanabara_bosnia,5835639,4,315,0,315,0
4_2178943,locale_shrimp_guanabara,2178943,4,39,19,58,0
4_7231215,locale_shrimp_bavaria,7231215,4,54,10,64,0
4_6912487,noop_locale_shrimp_alsace,6912487,4,357,0,357,0
4_7323359,feast_intoxication_shrimp_onion_bosnia_alsace,7323359,4,518,0,518,0
4_2008311,feast_intoxication_shrimp_turkey_bosnia_alsace,2008311,4,518,0,518,0
4_6760523,feast_intoxication_shrimp_potato_bosnia_alsace,6760523,4,518,0,518,0
4_179748,feast_satisfaction_shrimp_onion_bosnia_alsace,179748,4,458,0,458,0
4_5467628,feast_satisfaction_shrimp_turkey_bosnia_alsace,5467628,4,458,0,458,0
4_2218863,feast_satisfaction_shrimp_potato_bosnia_alsace,2218863,4,458,0,458,0
4_3443538,feast_satiety_shrimp_onion_bosnia_alsace,3443538,4,643,0,643,0
4_895283,feast_satiety_shrimp_turkey_bosnia_alsace,895283,4,643,0,643,0
4_5647495,feast_satiety_shrimp_potato_bosnia_alsace,5647495,4,643,0,643,0
4_7516608,feast_lubricity_shrimp_onion_bosnia_alsace,7516608,4,373,0,373,0
4_3474193,feast_lubricity_shrimp_turkey_bosnia_alsace,3474193,4,373,0,373,0
4_225428,feast_lubricity_shrimp_potato_bosnia_alsace,225428,4,373,0,373,0
4_3190749,craves_lubricity_ham,3190749,4,39,41,80,0
4_2335886,craves_lubricity_onion,2335886,4,42,38,80,0
4_7315407,locale_shrimp_bosnia,7315407,4,39,7,46,0
4_4422260,craves_lubricity_marzipan,4422260,4,54,31,85,0
4_1607211,locale_turkey_goias,1607211,4,14,0,14,0
4_5024368,noop_craves_grief_endive,5024368,4,46,0,46,0
4_7344507,noop_craves_jealousy-2_wonderbread,7344507,4,20,0,20,0
4_4810659,overcome_jealousy-2_rest_wonderbread_mercury_saturn,4810659,4,279,0,279,0
4_297638,overcome_jealousy-2_intoxication_wonderbread_mercury_saturn,297638,4,193,0,193,0
4_1155004,overcome_jealousy-2_satisfaction_wonderbread_mercury_saturn,1155004,4,219,0,219,0
4_6559561,noop_craves_satisfaction_onion,6559561,4,195,0,195,0
4_4418739,feast_satisfaction_onion_shrimp_bavaria_guanabara,4418739,4,274,0,274,0
4_3893303,feast_satisfaction_onion_shrimp_guanabara_bosnia,3893303,4,275,0,275,0
4_2663134,feast_satisfaction_onion_shrimp_bosnia_alsace,2663134,4,379,0,379,0
4_2463542,overcome_loneliness-3_satisfaction_onion_mercury_saturn,2463542,4,462,0,462,0
4_1477938,overcome_angina_satisfaction_onion_mercury_saturn,1477938,4,241,0,241,0
4_1493246,noop_craves_grief_wurst,1493246,4,228,0,228,0
4_3142942,overcome_grief_excitement_wurst_mercury_saturn,3142942,4,426,0,426,0
4_3111247,overcome_grief_satiety_wurst_mercury_saturn,3111247,4,449,0,449,0
4_2984277,harmony_achievement_saturn,2984277,4,84,31,115,0
4_2879007,craves_grief_endive,2879007,4,16,9,25,0
4_4405624,noop_craves_achievement_haroset,4405624,4,365,0,365,0
4_3401200,feast_achievement_haroset_turkey_bavaria_guanabara,3401200,4,399,0,399,0
4_4941948,feast_achievement_haroset_turkey_goias_bavaria,4941948,4,391,0,391,0
4_4786061,noop_fears_angina_satiety,4786061,4,322,0,322,0
4_5647441,succumb_angina_satiety_onion_mercury_saturn,5647441,4,338,0,338,0
4_1264033,noop_craves_love_wurst,1264033,4,268,0,268,0
4_1853352,harmony_love_saturn,1853352,4,77,17,94,0
4_6350300,craves_love_cherry,6350300,4,45,4,49,0
4_2542770,noop_locale_mutton_goias,2542770,4,270,0,270,0
4_4379955,locale_mutton_guanabara,4379955,4,16,2,18,0
4_6551470,noop_craves_rest_rice,6551470,4,376,0,376,0
4_3052034,feast_rest_rice_cherry_guanabara_bosnia,3052034,4,438,0,438,0
4_6835414,feast_rest_rice_cherry_bosnia_alsace,6835414,4,752,0,752,0
4_1541501,feast_rest_rice_cherry_goias_bavaria,1541501,4,462,0,462,0
4_7308797,overcome_hangover_rest_rice_mercury_saturn,7308797,4,572,0,572,0
4_3643029,overcome_dread_rest_rice_mercury_saturn,3643029,4,572,0,572,0
4_7012364,overcome_jealousy_rest_rice_mercury_saturn,7012364,4,450,0,450,0
4_2655423,overcome_laceration_rest_rice_mercury_saturn,2655423,4,628,0,628,0
4_4362024,noop_craves_satiety_ham,4362024,4,304,0,304,0
4_1807686,noop_fears_prostatitis_satiety,1807686,4,264,0,264,0
4_5207110,succumb_prostatitis_satiety_wurst_mercury_saturn,5207110,4,271,0,271,0
4_3616283,harmony_entertainment_earth,3616283,4,16,6,22,0
4_2810155,fears_prostatitis_entertainment,2810155,4,8,4,12,0
4_1107284,noop_harmony_intoxication_saturn,1107284,4,137,0,137,0
4_410311,overcome_sciatica_intoxication_wonderbread_mercury_saturn,410311,4,193,0,193,0
4_7126584,overcome_loneliness-3_intoxication_wonderbread_mercury_saturn,7126584,4,429,0,429,0
4_1006358,overcome_loneliness_intoxication_potato_mercury_saturn,1006358,4,222,0,222,0
4_2066697,noop_locale_rice_bosnia,2066697,4,75,0,75,0
4_4850736,feast_lubricity_rice_cherry_guanabara_bosnia,4850736,4,470,0,470,0
4_6726507,feast_excitement_rice_cherry_guanabara_bosnia,6726507,4,263,0,263,0
4_5225988,feast_achievement_rice_cherry_guanabara_bosnia,5225988,4,298,0,298,0
4_437954,locale_rice_guanabara,437954,4,39,4,43,0
4_3833315,noop_food_arugula,3833315,4,0,0,0,0
4_3784536,feast_lubricity_arugula_potato_bosnia_alsace,3784536,4,305,0,305,0
4_6739658,feast_lubricity_arugula_potato_alsace_surrey,6739658,4,440,0,440,0
4_6905485,feast_lubricity_arugula_potato_bavaria_guanabara,6905485,4,414,0,414,0
4_6090784,feast_lubricity_arugula_potato_guanabara_bosnia,6090784,4,305,0,305,0
4_2947656,feast_rest_potato_arugula_bavaria_guanabara,2947656,4,305,0,305,0
4_7731776,feast_rest_potato_arugula_guanabara_bosnia,7731776,4,513,0,513,0
4_6825610,feast_rest_potato_arugula_goias_bavaria,6825610,4,305,0,305,0
4_1747305,feast_lubricity_wonderbread_arugula_bosnia_alsace,1747305,4,358,0,358,0
4_3297402,feast_lubricity_wonderbread_arugula_bavaria_guanabara,3297402,4,301,0,301,0
4_2041368,feast_satisfaction_arugula_potato_bosnia_alsace,2041368,4,200,0,200,0
4_4996490,feast_satisfaction_arugula_potato_alsace_surrey,4996490,4,341,0,341,0
4_3323689,feast_satisfaction_arugula_potato_bavaria_guanabara,3323689,4,241,0,241,0
4_7201930,feast_satisfaction_arugula_potato_guanabara_bosnia,7201930,4,200,0,200,0
4_4919884,feast_satisfaction_wonderbread_arugula_bosnia_alsace,4919884,4,277,0,277,0
4_5198871,feast_satisfaction_wonderbread_arugula_bavaria_guanabara,5198871,4,222,0,222,0
4_7467524,feast_satisfaction_potato_arugula_bavaria_guanabara,7467524,4,198,0,198,0
4_7874447,feast_satisfaction_potato_arugula_guanabara_bosnia,7874447,4,275,0,275,0
4_6881144,feast_satisfaction_potato_arugula_goias_bavaria,6881144,4,198,0,198,0
4_7975341,feast_rest_wonderbread_arugula_bosnia_alsace,7975341,4,306,0,306,0
4_1124760,feast_rest_wonderbread_arugula_bavaria_guanabara,1124760,4,286,0,286,0
4_3048343,feast_lubricity_potato_arugula_bavaria_guanabara,3048343,4,292,0,292,0
4_6763301,feast_lubricity_potato_arugula_guanabara_bosnia,6763301,4,470,0,470,0
4_623335,feast_lubricity_potato_arugula_goias_bavaria,623335,4,292,0,292,0
4_1985834,feast_rest_arugula_potato_bosnia_alsace,1985834,4,306,0,306,0
4_4940956,feast_rest_arugula_potato_alsace_surrey,4940956,4,438,0,438,0
4_6804798,feast_rest_arugula_potato_bavaria_guanabara,6804798,4,431,0,431,0
4_7059259,feast_rest_arugula_potato_guanabara_bosnia,7059259,4,306,0,306,0
4_5077970,feast_intoxication_wonderbread_arugula_bosnia_alsace,5077970,4,233,0,233,0
4_7555780,feast_intoxication_wonderbread_arugula_bavaria_guanabara,7555780,4,203,0,203,0
4_2280008,feast_intoxication_potato_arugula_bavaria_guanabara,2280008,4,203,0,203,0
4_7729168,feast_intoxication_potato_arugula_guanabara_bosnia,7729168,4,389,0,389,0
4_1403462,feast_intoxication_potato_arugula_goias_bavaria,1403462,4,203,0,203,0
4_3065860,overcome_loneliness_rest_arugula_mercury_saturn,3065860,4,484,0,484,0
4_7279180,overcome_loneliness_satisfaction_arugula_mercury_saturn,7279180,4,237,0,237,0
4_1066285,noop_pain_jealousy-2,1066285,4,0,0,0,0
4_641732,succumb_jealousy-2_satisfaction_wonderbread_mercury_saturn,641732,4,216,0,216,0
4_3800886,noop_pain_sciatica,3800886,4,0,0,0,0
4_6626722,succumb_sciatica_satisfaction_wonderbread_mercury_saturn,6626722,4,216,0,216,0
4_7825528,overcome_sciatica_rest_wonderbread_mercury_saturn,7825528,4,278,0,278,0
4_1267677,overcome_sciatica_satisfaction_wonderbread_mercury_saturn,1267677,4,218,0,218,0
4_5342989,noop_eats_wonderbread_ham,5342989,4,0,0,0,0
4_6272389,noop_locale_ham_guanabara,6272389,4,282,0,282,0
4_157616,locale_ham_goias,157616,4,20,2,22,0
4_3967861,locale_ham_bavaria,3967861,4,38,5,43,0
4_4518774,noop_locale_rice_alsace,4518774,4,441,0,441,0
4_1689668,feast_lubricity_rice_cherry_bosnia_alsace,1689668,4,785,0,785,0
4_4055766,feast_excitement_rice_cherry_bosnia_alsace,4055766,4,517,0,517,0
4_2766267,feast_achievement_rice_cherry_bosnia_alsace,2766267,4,624,0,624,0
4_6331552,craves_excitement_cherry,6331552,4,42,25,67,0
4_7253622,noop_fears_laceration_achievement,7253622,4,198,0,198,0
4_1369212,noop_fears_jealousy_satiety,1369212,4,251,0,251,0
4_3967302,succumb_jealousy_satiety_cherry_mercury_saturn,3967302,4,305,0,305,0
4_3282766,craves_jealousy_rice,3282766,4,24,18,42,0
4_4484680,fears_jealousy_love,4484680,4,36,22,58,0
4_6486,noop_fears_jealousy_excitement,6486,4,189,0,189,0
4_4894934,noop_fears_anxiety_satiety,4894934,4,212,0,212,0
4_7209022,succumb_anxiety_satiety_cherry_mercury_saturn,7209022,4,277,0,277,0
4_517446,succumb_anxiety_satiety_onion_mercury_saturn,517446,4,308,0,308,0
4_249498,noop_craves_excitement_marzipan,249498,4,212,0,212,0
4_6468077,noop_craves_abrasion-4_mutton,6468077,4,275,0,275,0
4_7444260,noop_craves_abrasion-4_wonderbread,7444260,4,267,0,267,0
4_818876,noop_craves_boils-1_wonderbread,818876,4,182,0,182,0
4_5173398,craves_boils-1_arugula,5173398,4,18,16,34,0
4_2853163,noop_locale_marzipan_bosnia,2853163,4,107,0,107,0
4_7541487,locale_marzipan_alsace,7541487,4,72,33,105,0
4_6772543,noop_pain_anxiety,6772543,4,0,0,0,0
4_4847635,noop_eats_wurst_papaya,4847635,4,0,0,0,0
4_2799837,noop_craves_lubricity_marzipan,2799837,4,248,0,248,0
4_6292230,harmony_lubricity_saturn,6292230,4,56,34,90,0
4_3305631,craves_lubricity_shrimp,3305631,4,42,44,86,0
4_4727123,noop_craves_lubricity_mutton,4727123,4,290,0,290,0
4_4944137,harmony_lubricity_earth,4944137,4,97,51,148,0
4_4148623,noop_craves_lubricity_turkey,4148623,4,255,0,255,0
4_7214256,feast_lubricity_turkey_haroset_goias_bavaria,7214256,4,283,0,283,0
4_7945476,noop_locale_ham_bavaria,7945476,4,38,0,38,0
4_1894188,noop_harmony_excitement_uranus,1894188,4,92,0,92,0
4_2366283,harmony_excitement_earth,2366283,4,85,35,120,0
4_3752572,noop_locale_turkey_goias,3752572,4,32,0,32,0
4_1024883,locale_turkey_bavaria,1024883,4,16,13,29,0
4_490589,noop_craves_loneliness-3_onion,490589,4,268,0,268,0
4_2537672,overcome_loneliness-3_satiety_onion_mercury_saturn,2537672,4,531,0,531,0
4_7533545,overcome_loneliness-3_lubricity_onion_mercury_saturn,7533545,4,518,0,518,0
4_6216214,noop_craves_lubricity_rice,6216214,4,408,0,408,0
4_4396732,feast_lubricity_rice_cherry_goias_bavaria,4396732,4,493,0,493,0
4_6243624,noop_fears_anxiety_lubricity,6243624,4,307,0,307,0
4_4389637,noop_fears_depression_love,4389637,4,380,0,380,0
4_6318237,craves_depression_endive,6318237,4,16,14,30,0
4_6922128,noop_food_shrimp,6922128,4,0,0,0,0
4_2029446,feast_intoxication_shrimp_onion_goias_bavaria,2029446,4,335,0,335,0
4_3262221,feast_intoxication_shrimp_onion_bavaria_guanabara,3262221,4,252,0,252,0
4_4715375,feast_intoxication_shrimp_turkey_goias_bavaria,4715375,4,335,0,335,0
4_6455792,feast_intoxication_shrimp_turkey_bavaria_guanabara,6455792,4,252,0,252,0
4_1466610,feast_intoxication_shrimp_potato_goias_bavaria,1466610,4,335,0,335,0
4_6562048,feast_intoxication_shrimp_potato_bavaria_guanabara,6562048,4,252,0,252,0
4_6987273,feast_rest_potato_shrimp_bavaria_guanabara,6987273,4,305,0,305,0
4_215386,feast_rest_potato_shrimp_guanabara_bosnia,215386,4,513,0,513,0
4_3100304,feast_rest_potato_shrimp_goias_bavaria,3100304,4,305,0,305,0
4_2243832,feast_excitement_onion_shrimp_bavaria_guanabara,2243832,4,429,0,429,0
4_2228355,feast_excitement_onion_shrimp_guanabara_bosnia,2228355,4,429,0,429,0
4_7646830,feast_excitement_onion_shrimp_bosnia_alsace,7646830,4,526,0,526,0
4_2886812,feast_satisfaction_shrimp_onion_goias_bavaria,2886812,4,279,0,279,0
4_793737,feast_satisfaction_shrimp_onion_bavaria_guanabara,793737,4,234,0,234,0
4_173715,feast_satisfaction_shrimp_turkey_goias_bavaria,173715,4,279,0,279,0
4_6601071,feast_satisfaction_shrimp_turkey_bavaria_guanabara,6601071,4,234,0,234,0
4_4925927,feast_satisfaction_shrimp_potato_goias_bavaria,4925927,4,279,0,279,0
4_6707327,feast_satisfaction_shrimp_potato_bavaria_guanabara,6707327,4,234,0,234,0
4_6150602,feast_satiety_shrimp_onion_goias_bavaria,6150602,4,509,0,509,0
4_4316381,feast_satiety_shrimp_onion_bavaria_guanabara,4316381,4,401,0,401,0
4_3602347,feast_satiety_shrimp_turkey_goias_bavaria,3602347,4,509,0,509,0
4_4287534,feast_satiety_shrimp_turkey_bavaria_guanabara,4287534,4,401,0,401,0
4_353582,feast_satiety_shrimp_potato_goias_bavaria,353582,4,509,0,509,0
4_4393790,feast_satiety_shrimp_potato_bavaria_guanabara,4393790,4,401,0,401,0
4_2222695,feast_lubricity_shrimp_onion_goias_bavaria,2222695,4,389,0,389,0
4_3102179,feast_lubricity_shrimp_onion_bavaria_guanabara,3102179,4,314,0,314,0
4_6181257,feast_lubricity_shrimp_turkey_goias_bavaria,6181257,4,389,0,389,0
4_5489925,feast_lubricity_shrimp_turkey_bavaria_guanabara,5489925,4,314,0,314,0
4_2932492,feast_lubricity_shrimp_potato_goias_bavaria,2932492,4,389,0,389,0
4_5596181,feast_lubricity_shrimp_potato_bavaria_guanabara,5596181,4,314,0,314,0
4_4238955,feast_achievement_onion_shrimp_bavaria_guanabara,4238955,4,430,0,430,0
4_2142387,feast_achievement_onion_shrimp_guanabara_bosnia,2142387,4,430,0,430,0
4_5575143,feast_achievement_onion_shrimp_bosnia_alsace,5575143,4,527,0,527,0
4_7129944,feast_satisfaction_potato_shrimp_bavaria_guanabara,7129944,4,198,0,198,0
4_7248052,feast_satisfaction_potato_shrimp_guanabara_bosnia,7248052,4,275,0,275,0
4_6663456,feast_satisfaction_potato_shrimp_goias_bavaria,6663456,4,198,0,198,0
4_6727181,feast_lubricity_onion_shrimp_bavaria_guanabara,6727181,4,324,0,324,0
4_2089599,feast_lubricity_onion_shrimp_guanabara_bosnia,2089599,4,324,0,324,0
4_1999017,feast_lubricity_onion_shrimp_bosnia_alsace,1999017,4,388,0,388,0
4_6887223,feast_intoxication_onion_shrimp_bavaria_guanabara,6887223,4,248,0,248,0
4_1777686,feast_intoxication_onion_shrimp_guanabara_bosnia,1777686,4,248,0,248,0
4_1805768,feast_intoxication_onion_shrimp_bosnia_alsace,1805768,4,384,0,384,0
4_6018798,feast_lubricity_potato_shrimp_bavaria_guanabara,6018798,4,292,0,292,0
4_1555517,feast_lubricity_potato_shrimp_guanabara_bosnia,1555517,4,470,0,470,0
4_4670021,feast_lubricity_potato_shrimp_goias_bavaria,4670021,4,292,0,292,0
4_7941383,feast_satiety_onion_shrimp_bavaria_guanabara,7941383,4,339,0,339,0
4_3281987,feast_satiety_onion_shrimp_guanabara_bosnia,3281987,4,339,0,339,0
4_5926924,feast_satiety_onion_shrimp_bosnia_alsace,5926924,4,450,0,450,0
4_6984665,feast_intoxication_potato_shrimp_bavaria_guanabara,6984665,4,203,0,203,0
4_1715559,feast_intoxication_potato_shrimp_guanabara_bosnia,1715559,4,389,0,389,0
4_3204139,feast_intoxication_potato_shrimp_goias_bavaria,3204139,4,203,0,203,0
4_6179401,overcome_loneliness_satiety_shrimp_mercury_saturn,6179401,4,539,0,539,0
4_681758,overcome_loneliness_satisfaction_shrimp_mercury_saturn,681758,4,237,0,237,0
4_4396949,overcome_loneliness_lubricity_shrimp_mercury_saturn,4396949,4,444,0,444,0
4_5011789,noop_pleasure_rest,5011789,4,0,0,0,0
4_5268046,feast_rest_potato_yogurt_bavaria_guanabara,5268046,4,305,0,305,0
4_6553195,feast_rest_potato_yogurt_guanabara_bosnia,6553195,4,513,0,513,0
4_1280349,feast_rest_potato_yogurt_goias_bavaria,1280349,4,305,0,305,0
4_5415554,feast_rest_turkey_haroset_goias_bavaria,5415554,4,384,0,384,0
4_6822417,feast_rest_yogurt_potato_bavaria_guanabara,6822417,4,299,0,299,0
4_754823,feast_rest_yogurt_potato_goias_bavaria,754823,4,414,0,414,0
4_1244925,feast_rest_wonderbread_yogurt_bosnia_alsace,1244925,4,306,0,306,0
4_2760620,feast_rest_wonderbread_yogurt_bavaria_guanabara,2760620,4,286,0,286,0
4_7430733,overcome_loneliness-3_rest_wonderbread_mercury_saturn,7430733,4,288,0,288,0
4_4942809,overcome_abrasion_rest_yogurt_mercury_saturn,4942809,4,300,0,300,0
4_5064249,overcome_loneliness_rest_yogurt_mercury_saturn,5064249,4,486,0,486,0
4_7621788,overcome_loneliness_rest_potato_mercury_saturn,7621788,4,328,0,328,0
4_3777379,noop_craves_prostatitis_wurst,3777379,4,26,0,26,0
4_968806,overcome_prostatitis_excitement_wurst_mercury_saturn,968806,4,240,0,240,0
4_4749558,overcome_prostatitis_achievement_wurst_mercury_saturn,4749558,4,243,0,243,0
4_7759180,overcome_prostatitis_satiety_wurst_mercury_saturn,7759180,4,267,0,267,0
4_7540328,noop_craves_intoxication_shrimp,7540328,4,175,0,175,0
4_520538,noop_pain_laceration-8,520538,4,0,0,0,0
4_3514708,overcome_laceration-8_satisfaction_haroset_mercury_saturn,3514708,4,242,0,242,0
4_1668680,noop_locale_haroset_guanabara,1668680,4,37,0,37,0
4_286303,feast_satisfaction_haroset_turkey_bavaria_guanabara,286303,4,257,0,257,0
4_3868099,feast_lubricity_haroset_turkey_bavaria_guanabara,3868099,4,300,0,300,0
4_2986406,feast_excitement_haroset_turkey_bavaria_guanabara,2986406,4,398,0,398,0
4_7733722,locale_haroset_bavaria,7733722,4,29,8,37,0
4_4454975,noop_craves_lubricity_yogurt,4454975,4,264,0,264,0
4_5853942,feast_lubricity_yogurt_potato_bavaria_guanabara,5853942,4,299,0,299,0
4_2324540,feast_lubricity_yogurt_potato_goias_bavaria,2324540,4,399,0,399,0
4_2556702,noop_craves_boils_onion,2556702,4,284,0,284,0
4_2417017,noop_craves_jealousy_papaya,2417017,4,324,0,324,0
4_188553,noop_fears_laceration-8_satiety,188553,4,313,0,313,0
4_1006816,craves_laceration-8_haroset,1006816,4,15,9,24,0
4_1783917,noop_fears_dread_excitement,1783917,4,91,0,91,0
4_2996931,craves_dread_papaya,2996931,4,19,15,34,0
4_608750,noop_harmony_satisfaction_mercury,608750,4,98,0,98,0
4_3626488,succumb_abrasion_satisfaction_wonderbread_mercury_saturn,3626488,4,224,0,224,0
4_872036,succumb_abrasion_satisfaction_potato_mercury_saturn,872036,4,224,0,224,0
4_5044939,noop_pain_loneliness-3,5044939,4,0,0,0,0
4_7983950,overcome_loneliness-3_satisfaction_wonderbread_mercury_saturn,7983950,4,451,0,451,0
4_564420,noop_planet_earth,564420,4,0,0,0,0
4_3216798,noop_eats_rice_papaya,3216798,4,0,0,0,0
4_223167,noop_locale_marzipan_surrey,223167,4,389,0,389,0
4_5089410,locale_marzipan_bosnia,5089410,4,72,12,84,0
4_2667139,noop_fears_abrasion_satisfaction,2667139,4,196,0,196,0
4_1682489,noop_craves_achievement_marzipan,1682489,4,211,0,211,0
4_4440890,noop_locale_shrimp_bavaria,4440890,4,188,0,188,0
4_4007851,noop_fears_loneliness-3_lubricity,4007851,4,325,0,325,0
4_7575031,noop_food_cherry,7575031,4,0,0,0,0
4_3338867,succumb_laceration_satiety_cherry_mercury_saturn,3338867,4,251,0,251,0
4_168876,succumb_depression_satiety_cherry_mercury_saturn,168876,4,287,0,287,0
4_6918728,succumb_anger_satiety_cherry_mercury_saturn,6918728,4,277,0,277,0
4_2182438,succumb_grief_satiety_cherry_mercury_saturn,2182438,4,287,0,287,0
4_5757972,feast_satiety_cherry_rice_bavaria_guanabara,5757972,4,281,0,281,0
4_7367708,feast_satiety_cherry_rice_guanabara_bosnia,7367708,4,281,0,281,0
4_622134,feast_satiety_cherry_rice_bosnia_alsace,622134,4,416,0,416,0
4_3329198,feast_satiety_cherry_rice_goias_bavaria,3329198,4,281,0,281,0
4_4565584,feast_lubricity_cherry_rice_bavaria_guanabara,4565584,4,470,0,470,0
4_3487577,feast_lubricity_cherry_rice_guanabara_bosnia,3487577,4,470,0,470,0
4_200491,feast_lubricity_cherry_rice_bosnia_alsace,200491,4,749,0,749,0
4_2907555,feast_lubricity_cherry_rice_goias_bavaria,2907555,4,498,0,498,0
4_6762830,feast_excitement_rice_cherry_goias_bavaria,6762830,4,282,0,282,0
4_5473331,feast_achievement_rice_cherry_goias_bavaria,5473331,4,319,0,319,0
4_2720946,overcome_depression_satiety_cherry_mercury_saturn,2720946,4,425,0,425,0
4_337259,overcome_jealousy_satiety_cherry_mercury_saturn,337259,4,519,0,519,0
4_5890937,overcome_laceration_satiety_cherry_mercury_saturn,5890937,4,253,0,253,0
4_3113938,overcome_grief_satiety_cherry_mercury_saturn,3113938,4,425,0,425,0
4_2295368,noop_harmony_satiety_saturn,2295368,4,86,0,86,0
4_4109834,overcome_depression_satiety_wurst_mercury_saturn,4109834,4,449,0,449,0
4_6578941,overcome_angina_satiety_onion_mercury_saturn,6578941,4,308,0,308,0
4_6369923,overcome_hangover_satiety_wurst_mercury_saturn,6369923,4,454,0,454,0
4_4048102,overcome_dread_satiety_wurst_mercury_saturn,4048102,4,454,0,454,0
4_5136068,noop_eats_mutton_marzipan,5136068,4,0,0,0,0
4_5366332,noop_fears_boils_satisfaction,5366332,4,223,0,223,0
4_5335732,noop_craves_lubricity_arugula,5335732,4,264,0,264,0
4_143900,noop_locale_cherry_guanabara,143900,4,75,0,75,0
4_800046,locale_cherry_bavaria,800046,4,42,22,64,0
4_6821478,locale_cherry_bosnia,6821478,4,39,19,58,0
4_6153267,noop_craves_satiety_papaya,6153267,4,245,0,245,0
4_3854533,noop_craves_loneliness_yogurt,3854533,4,223,0,223,0
4_1918314,harmony_satisfaction_mercury,1918314,4,54,20,74,0
4_3491505,locale_potato_goias,3491505,4,18,1,19,0
4_3641143,noop_craves_loneliness_arugula,3641143,4,221,0,221,0
4_4998627,noop_craves_grief_cherry,4998627,4,217,0,217,0
4_1579204,noop_craves_rest_potato,1579204,4,265,0,265,0
4_5865527,noop_locale_ham_goias,5865527,4,38,0,38,0
4_2101641,noop_craves_satiety_endive,2101641,4,218,0,218,0
4_2718519,noop_eats_ham_mutton,2718519,4,0,0,0,0
4_6877418,noop_craves_laceration-8_haroset,6877418,4,15,0,15,0
4_427769,noop_craves_jealousy_rice,427769,4,66,0,66,0
4_2612109,overcome_jealousy_excitement_rice_mercury_saturn,2612109,4,271,0,271,0
4_2571000,overcome_jealousy_achievement_rice_mercury_saturn,2571000,4,295,0,295,0
4_2727852,noop_fears_prostatitis_excitement,2727852,4,222,0,222,0
4_2205884,noop_craves_jealousy_marzipan,2205884,4,314,0,314,0
4_2123302,noop_craves_excitement_onion,2123302,4,362,0,362,0
4_6153519,noop_craves_anger_marzipan,6153519,4,37,0,37,0
4_6002469,noop_harmony_satisfaction_saturn,6002469,4,55,0,55,0
4_1387483,overcome_loneliness_satisfaction_potato_mercury_saturn,1387483,4,197,0,197,0
4_1915992,noop_harmony_achievement_mercury,1915992,4,183,0,183,0
4_4890027,succumb_grief_achievement_wurst_mercury_saturn,4890027,4,231,0,231,0
4_5405345,succumb_depression_achievement_wurst_mercury_saturn,5405345,4,231,0,231,0
4_1296495,succumb_prostatitis_achievement_wurst_mercury_saturn,1296495,4,240,0,240,0
4_3721742,noop_fears_sciatica_intoxication,3721742,4,127,0,127,0
4_7705169,noop_craves_love_onion,7705169,4,308,0,308,0
4_3637704,noop_craves_lubricity_wonderbread,3637704,4,260,0,260,0
4_1345612,feast_lubricity_wonderbread_yogurt_bosnia_alsace,1345612,4,358,0,358,0
4_706355,feast_lubricity_wonderbread_yogurt_bavaria_guanabara,706355,4,301,0,301,0
4_1696785,noop_fears_laceration_satiety,1696785,4,164,0,164,0
4_4581055,succumb_laceration_satiety_wurst_mercury_saturn,4581055,4,267,0,267,0
4_7346914,succumb_laceration_satiety_onion_mercury_saturn,7346914,4,305,0,305,0
4_7547979,noop_food_wonderbread,7547979,4,0,0,0,0
4_5764793,feast_satisfaction_wonderbread_yogurt_bosnia_alsace,5764793,4,277,0,277,0
4_307483,feast_satisfaction_wonderbread_yogurt_bavaria_guanabara,307483,4,222,0,222,0
4_577277,feast_intoxication_wonderbread_yogurt_bosnia_alsace,577277,4,233,0,233,0
4_7411306,feast_intoxication_wonderbread_yogurt_bavaria_guanabara,7411306,4,203,0,203,0
4_4622121,noop_locale_papaya_alsace,4622121,4,217,0,217,0
4_5025041,locale_papaya_bosnia,5025041,4,19,8,27,0
4_1275730,locale_papaya_guanabara,1275730,4,19,6,25,0
4_6194333,noop_eats_potato_shrimp,6194333,4,0,0,0,0
4_5772633,noop_eats_endive_cherry,5772633,4,0,0,0,0
4_4696431,noop_fears_loneliness-3_rest,4696431,4,186,0,186,0
4_1584472,noop_eats_ham_wonderbread,1584472,4,0,0,0,0
4_2913854,noop_craves_anxiety_marzipan,2913854,4,37,0,37,0
4_1376386,noop_fears_depression_satiety,1376386,4,263,0,263,0
4_5287510,succumb_depression_satiety_wurst_mercury_saturn,5287510,4,287,0,287,0
4_1756423,noop_locale_onion_guanabara,1756423,4,74,0,74,0
4_4679870,locale_onion_bosnia,4679870,4,50,14,64,0
4_4434536,noop_craves_satisfaction_shrimp,4434536,4,160,0,160,0
4_6628497,noop_pain_abrasion,6628497,4,0,0,0,0
4_1065095,noop_eats_shrimp_onion,1065095,4,0,0,0,0
4_819297,noop_harmony_excitement_saturn,819297,4,182,0,182,0
4_3164193,overcome_depression_excitement_wurst_mercury_saturn,3164193,4,426,0,426,0
4_179771,overcome_laceration_excitement_rice_mercury_saturn,179771,4,467,0,467,0
4_6825231,noop_locale_onion_bosnia,6825231,4,74,0,74,0
4_3992670,locale_onion_guanabara,3992670,4,50,15,65,0
4_4072096,noop_craves_boils-1_potato,4072096,4,184,0,184,0
4_2617696,noop_craves_hangover_wurst,2617696,4,231,0,231,0
4_112778,overcome_hangover_achievement_wurst_mercury_saturn,112778,4,430,0,430,0
4_2848906,noop_fears_boils-1_lubricity,2848906,4,300,0,300,0
4_7087923,noop_craves_satisfaction_arugula,7087923,4,162,0,162,0
4_6579438,noop_harmony_lubricity_uranus,6579438,4,108,0,108,0
4_324388,noop_craves_loneliness_potato,324388,4,55,0,55,0
4_5102674,overcome_loneliness_lubricity_potato_mercury_saturn,5102674,4,311,0,311,0
4_5497475,noop_locale_haroset_bavaria,5497475,4,29,0,29,0
4_2823528,feast_satisfaction_haroset_turkey_goias_bavaria,2823528,4,253,0,253,0
4_4566696,feast_lubricity_haroset_turkey_goias_bavaria,4566696,4,293,0,293,0
4_6442467,feast_excitement_haroset_turkey_goias_bavaria,6442467,4,390,0,390,0
4_1422997,noop_craves_satiety_shrimp,1422997,4,341,0,341,0
4_6521758,noop_fears_laceration-8_lubricity,6521758,4,288,0,288,0
4_6296349,noop_planet_uranus,6296349,4,0,0,0,0
4_3036798,noop_craves_satisfaction_haroset,3036798,4,219,0,219,0
4_3204723,noop_fears_jealousy-2_satisfaction,3204723,4,200,0,200,0
4_451898,noop_locale_arugula_alsace,451898,4,35,0,35,0
4_790146,locale_arugula_bosnia,790146,4,19,10,29,0
4_7123940,noop_craves_achievement_wurst,7123940,4,177,0,177,0
4_5476004,overcome_dread_achievement_wurst_mercury_saturn,5476004,4,430,0,430,0
4_461749,noop_pain_depression,461749,4,0,0,0,0
4_3663839,noop_pain_angina,3663839,4,0,0,0,0
4_7798075,overcome_angina_lubricity_onion_mercury_saturn,7798075,4,292,0,292,0
4_1640807,noop_province_bavaria,1640807,4,0,0,0,0
4_3665485,noop_locale_yogurt_guanabara,3665485,4,26,0,26,0
4_6819809,feast_intoxication_yogurt_potato_bavaria_guanabara,6819809,4,198,0,198,0
4_6759901,locale_yogurt_bosnia,6759901,4,10,1,11,0
4_3433327,noop_craves_laceration_rice,3433327,4,268,0,268,0
4_3968678,overcome_laceration_achievement_rice_mercury_saturn,3968678,4,461,0,461,0
4_1938062,noop_province_guanabara,1938062,4,0,0,0,0
4_3813600,noop_craves_dread_rice,3813600,4,220,0,220,0
4_4176937,overcome_dread_achievement_rice_mercury_saturn,4176937,4,429,0,429,0
4_3837028,noop_craves_love_ham,3837028,4,357,0,357,0
4_7314587,noop_fears_grief_achievement,7314587,4,92,0,92,0
4_7594879,noop_pain_hangover,7594879,4,0,0,0,0
4_3968464,overcome_hangover_achievement_rice_mercury_saturn,3968464,4,429,0,429,0
4_433650,noop_eats_haroset_marzipan,433650,4,0,0,0,0
4_2075900,noop_craves_satiety_cherry,2075900,4,201,0,201,0
4_2562693,noop_craves_laceration_endive,2562693,4,275,0,275,0
4_5182951,noop_locale_endive_bavaria,5182951,4,281,0,281,0
4_6411945,locale_endive_bosnia,6411945,4,19,12,31,0
4_3950433,locale_endive_guanabara,3950433,4,19,5,24,0
4_876692,noop_fears_depression-7_satiety,876692,4,313,0,313,0
4_1694955,craves_depression-7_haroset,1694955,4,15,7,22,0
4_950215,noop_food_potato,950215,4,0,0,0,0
4_5410717,feast_satisfaction_potato_yogurt_bavaria_guanabara,5410717,4,198,0,198,0
4_5584884,feast_satisfaction_potato_yogurt_guanabara_bosnia,5584884,4,275,0,275,0
4_4843501,feast_satisfaction_potato_yogurt_goias_bavaria,4843501,4,198,0,198,0
4_858658,feast_intoxication_yogurt_potato_goias_bavaria,858658,4,310,0,310,0
4_4299571,feast_lubricity_potato_yogurt_bavaria_guanabara,4299571,4,292,0,292,0
4_7893326,feast_lubricity_potato_yogurt_guanabara_bosnia,7893326,4,470,0,470,0
4_2850066,feast_lubricity_potato_yogurt_goias_bavaria,2850066,4,292,0,292,0
4_5265438,feast_intoxication_potato_yogurt_bavaria_guanabara,5265438,4,203,0,203,0
4_52391,feast_intoxication_potato_yogurt_guanabara_bosnia,52391,4,389,0,389,0
4_1384184,feast_intoxication_potato_yogurt_goias_bavaria,1384184,4,203,0,203,0
4_7076654,noop_pain_anger,7076654,4,0,0,0,0
4_1203896,succumb_anger_satiety_onion_mercury_saturn,1203896,4,308,0,308,0
4_3231060,noop_eats_papaya_rice,3231060,4,0,0,0,0
4_740351,noop_fears_angina_rest,740351,4,249,0,249,0
4_6926892,noop_craves_love_turkey,6926892,4,372,0,372,0
4_2891913,noop_fears_depression-7_lubricity,2891913,4,288,0,288,0
4_525094,noop_fears_anxiety_excitement,525094,4,257,0,257,0
4_3694793,noop_harmony_achievement_saturn,3694793,4,151,0,151,0
4_2878478,noop_food_wurst,2878478,4,0,0,0,0
4_2482532,succumb_grief_satiety_wurst_mercury_saturn,2482532,4,287,0,287,0
4_3370802,noop_locale_arugula_surrey,3370802,4,185,0,185,0
4_3242223,locale_arugula_alsace,3242223,4,19,10,29,0
4_3752565,noop_eats_potato_yogurt,3752565,4,0,0,0,0
4_2016804,noop_locale_wonderbread_alsace,2016804,4,95,0,95,0
4_1187150,locale_wonderbread_bosnia,1187150,4,26,0,26,0
4_327212,noop_craves_loneliness-3_ham,327212,4,49,0,49,0
4_6105244,noop_attacks_guanabara_bosnia,6105244,4,0,0,0,0
4_3827688,noop_craves_boils_shrimp,3827688,4,55,0,55,0
4_6948529,noop_attacks_bosnia_alsace,6948529,4,0,0,0,0
4_7558443,noop_fears_loneliness_lubricity,7558443,4,254,0,254,0
4_7505392,noop_craves_love_mutton,7505392,4,314,0,314,0
4_4938993,noop_craves_satisfaction_wonderbread,4938993,4,176,0,176,0
4_182563,noop_craves_depression_wurst,182563,4,228,0,228,0
4_978263,noop_craves_satisfaction_ham,978263,4,174,0,174,0
4_226645,noop_locale_arugula_guanabara,226645,4,175,0,175,0
4_3753394,noop_fears_jealousy_achievement,3753394,4,285,0,285,0
4_2726012,noop_fears_grief_love,2726012,4,380,0,380,0
4_3966481,noop_locale_cherry_bosnia,3966481,4,75,0,75,0
4_4553765,locale_cherry_guanabara,4553765,4,39,13,52,0
4_666864,noop_fears_depression_achievement,666864,4,92,0,92,0
4_2928166,noop_eats_marzipan_rice,2928166,4,0,0,0,0
4_6418558,noop_locale_cherry_alsace,6418558,4,404,0,404,0
4_2617581,noop_craves_rest_marzipan,2617581,4,252,0,252,0
4_2721346,noop_craves_excitement_mutton,2721346,4,364,0,364,0
4_1203432,noop_craves_love_marzipan,1203432,4,253,0,253,0
4_5375631,noop_fears_abrasion-4_rest,5375631,4,186,0,186,0
4_3737404,noop_orbits_mercury_saturn,3737404,4,0,0,0,0
4_4348482,noop_eats_marzipan_cherry,4348482,4,0,0,0,0
4_5083040,noop_craves_angina_onion,5083040,4,29,0,29,0
4_3000496,noop_craves_laceration_marzipan,3000496,4,265,0,265,0
4_7725591,noop_locale_rice_bavaria,7725591,4,102,0,102,0
4_1002897,noop_fears_abrasion_lubricity,1002897,4,285,0,285,0
4_3335683,noop_fears_anger_excitement,3335683,4,257,0,257,0
4_5504547,noop_harmony_lubricity_saturn,5504547,4,214,0,214,0
4_6630041,noop_fears_jealousy_love,6630041,4,134,0,134,0
4_1672405,noop_craves_abrasion-4_ham,1672405,4,49,0,49,0
4_4866842,noop_locale_papaya_guanabara,4866842,4,35,0,35,0
4_3457908,noop_craves_achievement_mutton,3457908,4,365,0,365,0
4_1986619,noop_fears_boils-1_rest,1986619,4,311,0,311,0
4_3683143,noop_craves_excitement_wurst,3683143,4,177,0,177,0
4_3418815,noop_pain_prostatitis,3418815,4,0,0,0,0
4_5221458,noop_planet_saturn,5221458,4,0,0,0,0
4_6896743,noop_craves_lubricity_shrimp,6896743,4,232,0,232,0
4_5142292,noop_craves_dread_papaya,5142292,4,45,0,45,0
4_2167967,noop_harmony_entertainment_uranus,2167967,4,12,0,12,0
4_2573934,noop_eats_cherry_marzipan,2573934,4,0,0,0,0
4_4470546,noop_locale_wurst_goias,4470546,4,0,0,0,0
4_2332756,noop_locale_mutton_bavaria,2332756,4,30,0,30,0
4_4802997,noop_craves_rest_turkey,4802997,4,356,0,356,0
4_5564099,noop_craves_achievement_onion,5564099,4,363,0,363,0
4_5381497,noop_craves_rest_mutton,5381497,4,244,0,244,0
4_5077393,noop_pleasure_excitement,5077393,4,0,0,0,0
4_5747312,noop_pleasure_achievement,5747312,4,0,0,0,0
4_5373533,noop_pain_dread,5373533,4,0,0,0,0
4_2749009,noop_pain_jealousy,2749009,4,0,0,0,0
4_1540266,noop_eats_potato_arugula,1540266,4,0,0,0,0
4_5442199,noop_fears_boils-1_intoxication,5442199,4,84,0,84,0
4_1485908,noop_harmony_entertainment_earth,1485908,4,30,0,30,0
4_1578600,noop_harmony_excitement_earth,1578600,4,150,0,150,0
4_6976685,noop_pleasure_intoxication,6976685,4,0,0,0,0
4_7994383,feast_intoxication_turkey_haroset_goias_bavaria,7994383,4,237,0,237,0
4_2616621,noop_province_goias,2616621,4,0,0,0,0
4_5808271,noop_eats_onion_ham,5808271,4,0,0,0,0
4_630322,noop_craves_entertainment_wurst,630322,4,0,0,0,0
4_6235535,noop_locale_turkey_bavaria,6235535,4,24,0,24,0
4_7541545,noop_locale_endive_guanabara,7541545,4,35,0,35,0
4_1079568,noop_craves_boils_turkey,1079568,4,294,0,294,0
4_6296301,noop_craves_loneliness_shrimp,6296301,4,218,0,218,0
4_7549646,noop_craves_lubricity_cherry,7549646,4,408,0,408,0
4_5408649,noop_fears_anxiety_rest,5408649,4,286,0,286,0
4_3848059,noop_fears_anger_lubricity,3848059,4,307,0,307,0
4_1878900,noop_harmony_excitement_mercury,1878900,4,207,0,207,0
4_7783167,noop_food_haroset,7783167,4,0,0,0,0
4_1874818,noop_harmony_rest_saturn,1874818,4,81,0,81,0
4_796009,noop_eats_wurst_endive,796009,4,0,0,0,0
4_6463600,noop_craves_satisfaction_potato,6463600,4,154,0,154,0
4_3275072,noop_eats_shrimp_turkey,3275072,4,0,0,0,0
4_5109349,noop_craves_rest_yogurt,5109349,4,265,0,265,0
4_434518,noop_craves_love_haroset,434518,4,310,0,310,0
4_1969438,noop_craves_hangover_rice,1969438,4,220,0,220,0
4_3306021,noop_craves_satisfaction_marzipan,3306021,4,246,0,246,0
4_5250251,noop_fears_abrasion-4_lubricity,5250251,4,325,0,325,0
4_7496750,noop_eats_yogurt_potato,7496750,4,0,0,0,0
4_2536952,noop_craves_laceration_cherry,2536952,4,69,0,69,0
4_6433446,noop_craves_love_rice,6433446,4,239,0,239,0
4_2253173,noop_eats_rice_marzipan,2253173,4,0,0,0,0
4_3036620,noop_craves_intoxication_ham,3036620,4,171,0,171,0
4_99639,noop_craves_lubricity_onion,99639,4,238,0,238,0
4_5486452,noop_harmony_intoxication_earth,5486452,4,106,0,106,0
4_1318637,noop_food_onion,1318637,4,0,0,0,0
4_7007816,noop_pleasure_entertainment,7007816,4,0,0,0,0
4_3200789,noop_craves_satiety_wurst,3200789,4,220,0,220,0
4_2665525,noop_craves_dread_wurst,2665525,4,231,0,231,0
4_254640,noop_craves_excitement_rice,254640,4,178,0,178,0
4_534272,noop_harmony_lubricity_earth,534272,4,159,0,159,0
4_5530554,noop_craves_depression_endive,5530554,4,46,0,46,0
4_2491698,noop_eats_arugula_potato,2491698,4,0,0,0,0
4_5305240,noop_locale_marzipan_alsace,5305240,4,107,0,107,0
4_6248940,noop_locale_yogurt_bavaria,6248940,4,154,0,154,0
4_6718449,noop_fears_dread_satiety,6718449,4,332,0,332,0
4_7533636,noop_food_rice,7533636,4,0,0,0,0
4_3987172,noop_pleasure_satiety,3987172,4,0,0,0,0
4_4356899,noop_eats_onion_marzipan,4356899,4,0,0,0,0
4_4294451,noop_craves_abrasion-4_onion,4294451,4,268,0,268,0
4_6571693,noop_craves_intoxication_onion,6571693,4,172,0,172,0
4_2484442,noop_pain_laceration,2484442,4,0,0,0,0
4_6517750,noop_fears_anger_love,6517750,4,213,0,213,0
4_2178515,noop_locale_papaya_bavaria,2178515,4,316,0,316,0
4_236576,noop_locale_wonderbread_guanabara,236576,4,38,0,38,0
4_7819070,noop_fears_prostatitis_love,7819070,4,312,0,312,0
4_6404305,noop_craves_love_papaya,6404305,4,263,0,263,0
4_4740452,noop_craves_rest_wonderbread,4740452,4,241,0,241,0
4_840928,noop_harmony_love_earth,840928,4,179,0,179,0
4_1284607,noop_craves_lubricity_haroset,1284607,4,254,0,254,0
4_5856752,noop_craves_boils_potato,5856752,4,285,0,285,0
4_7186753,noop_craves_satiety_marzipan,7186753,4,209,0,209,0
4_2170044,noop_locale_papaya_bosnia,2170044,4,35,0,35,0
4_2074016,noop_pleasure_satisfaction,2074016,4,0,0,0,0
4_6935494,noop_pain_loneliness,6935494,4,0,0,0,0
4_1654616,noop_attacks_goias_bavaria,1654616,4,0,0,0,0
4_3477552,noop_eats_turkey_haroset,3477552,4,0,0,0,0
4_2606268,noop_attacks_bavaria_guanabara,2606268,4,0,0,0,0
4_51279,noop_eats_shrimp_potato,51279,4,0,0,0,0
4_4852816,noop_eats_onion_shrimp,4852816,4,0,0,0,0
4_4338091,noop_fears_prostatitis_achievement,4338091,4,226,0,226,0
4_539530,noop_fears_boils-1_satisfaction,539530,4,213,0,213,0
4_2352679,noop_craves_love_endive,2352679,4,295,0,295,0
4_2933531,noop_craves_loneliness-3_wonderbread,2933531,4,267,0,267,0
4_4792208,noop_craves_intoxication_turkey,4792208,4,209,0,209,0
4_5370708,noop_craves_intoxication_mutton,5370708,4,204,0,204,0
4_4752508,noop_food_mutton,4752508,4,0,0,0,0
4_4174008,noop_food_turkey,4174008,4,0,0,0,0
4_1620259,noop_craves_excitement_papaya,1620259,4,185,0,185,0
4_6207907,noop_eats_cherry_endive,6207907,4,0,0,0,0
4_899045,noop_craves_hangover_papaya,899045,4,45,0,45,0
4_6512303,noop_fears_dread_love,6512303,4,283,0,283,0
4_106415,noop_fears_jealousy-2_intoxication,106415,4,127,0,127,0
4_5569610,noop_craves_excitement_endive,5569610,4,255,0,255,0
4_1584320,noop_fears_hangover_excitement,1584320,4,91,0,91,0
4_964644,noop_pain_grief,964644,4,0,0,0,0
4_5073604,noop_harmony_love_uranus,5073604,4,144,0,144,0
4_5770055,noop_locale_shrimp_guanabara,5770055,4,75,0,75,0
4_2356821,noop_craves_achievement_papaya,2356821,4,256,0,256,0
4_4745869,noop_fears_angina_love,4745869,4,371,0,371,0
4_4682406,noop_locale_potato_guanabara,4682406,4,39,0,39,0
4_4480360,noop_food_yogurt,4480360,4,0,0,0,0
4_7587947,noop_craves_rest_ham,7587947,4,238,0,238,0
4_5098560,noop_craves_intoxication_yogurt,5098560,4,161,0,161,0
4_3121130,noop_fears_laceration-8_love,3121130,4,364,0,364,0
4_924830,noop_craves_lubricity_potato,924830,4,244,0,244,0
4_3556948,noop_locale_endive_bosnia,3556948,4,35,0,35,0
4_3707157,noop_harmony_satiety_mercury,3707157,4,126,0,126,0
4_2815448,noop_craves_abrasion_yogurt,2815448,4,16,0,16,0
4_6009025,noop_locale_endive_alsace,6009025,4,222,0,222,0
4_6306172,noop_craves_achievement_endive,6306172,4,190,0,190,0
4_1640948,noop_craves_satiety_onion,1640948,4,259,0,259,0
4_5504813,noop_craves_depression_cherry,5504813,4,217,0,217,0
4_7869200,noop_craves_excitement_haroset,7869200,4,364,0,364,0
4_6010698,noop_locale_cherry_bavaria,6010698,4,107,0,107,0
4_5553848,noop_eats_papaya_wurst,5553848,4,0,0,0,0
4_4398007,noop_eats_haroset_turkey,4398007,4,0,0,0,0
4_5054707,noop_fears_anger_satiety,5054707,4,212,0,212,0
4_6000798,noop_locale_arugula_bosnia,6000798,4,35,0,35,0
4_7862758,noop_craves_achievement_rice,7862758,4,213,0,213,0
4_6340627,noop_craves_jealousy_cherry,6340627,4,317,0,317,0
4_1674035,noop_craves_love_shrimp,1674035,4,394,0,394,0
4_4722509,noop_fears_depression-7_love,4722509,4,364,0,364,0
4_7543600,noop_province_bosnia,7543600,4,0,0,0,0
4_1994700,noop_province_alsace,1994700,4,0,0,0,0
4_3004232,noop_eats_wonderbread_yogurt,3004232,4,0,0,0,0
4_4124722,noop_craves_sciatica_wonderbread,4124722,4,20,0,20,0
4_7140408,noop_eats_rice_cherry,7140408,4,0,0,0,0
4_1276331,noop_locale_onion_alsace,1276331,4,210,0,210,0
4_2339924,noop_harmony_achievement_earth,2339924,4,91,0,91,0
4_6820050,noop_fears_sciatica_satisfaction,6820050,4,200,0,200,0
4_2512232,noop_fears_anger_rest,2512232,4,286,0,286,0
4_694359,noop_planet_mercury,694359,4,0,0,0,0
4_2937151,noop_craves_boils-1_arugula,2937151,4,37,0,37,0
4_4631551,noop_locale_potato_bosnia,4631551,4,264,0,264,0
4_5623059,noop_fears_grief_satiety,5623059,4,263,0,263,0
4_4676598,noop_fears_loneliness_intoxication,4676598,4,164,0,164,0
4_4834959,noop_craves_rest_arugula,4834959,4,265,0,265,0
4_7566765,noop_craves_intoxication_wonderbread,7566765,4,148,0,148,0
4_1568415,noop_craves_intoxication_potato,1568415,4,155,0,155,0
4_2417187,noop_pleasure_lubricity,2417187,4,0,0,0,0
4_4809174,noop_eats_endive_wurst,4809174,4,0,0,0,0
4_2972633,noop_eats_cherry_rice,2972633,4,0,0,0,0
4_1990466,noop_eats_wonderbread_arugula,1990466,4,0,0,0,0
4_1902674,noop_attacks_alsace_surrey,1902674,4,0,0,0,0
4_170733,noop_fears_hangover_love,170733,4,283,0,283,0
4_247124,noop_locale_potato_bavaria,247124,4,39,0,39,0
4_335752,noop_craves_lubricity_ham,335752,4,274,0,274,0
3_6820050,noop_fears_sciatica_satisfaction,6820050,3,0,201,201,0
2_949448,fears_sciatica_satisfaction,949448,2,0,1,1,0
4_690997,province_alsace,690997,4,1,0,1,0
4_6239897,province_bosnia,6239897,4,1,0,1,0
3_7869200,noop_craves_excitement_haroset,7869200,3,0,365,365,0
2_1490646,craves_excitement_haroset,1490646,2,0,6,6,0
4_3519135,eats_yogurt_potato,3519135,4,1,0,1,0
3_1878900,noop_harmony_excitement_mercury,1878900,3,0,208,208,0
2_1168384,harmony_excitement_mercury,1168384,2,0,2,2,0
4_3223975,eats_haroset_marzipan,3223975,4,1,0,1,0
3_3813600,noop_craves_dread_rice,3813600,3,0,221,221,0
2_6767175,craves_dread_rice,6767175,2,0,9,9,0
3_7342250,succumb_angina_lubricity_onion_saturn_earth,7342250,3,6,288,294,0
2_6292230,harmony_lubricity_saturn,6292230,2,0,14,14,0
3_1141850,succumb_jealousy_excitement_cherry_earth_uranus,1141850,3,7,283,290,0
3_5135000,succumb_jealousy_love_rice_saturn_earth,5135000,3,6,300,306,0
2_1853352,harmony_love_saturn,1853352,2,0,29,29,0
3_6397950,succumb_hangover_excitement_cherry_earth_uranus,6397950,3,7,247,254,0
4_7058902,craves_hangover_cherry,7058902,4,1,44,45,0
3_6137150,feast_intoxication_arugula_potato_bavaria_guanabara,6137150,3,6,308,314,0
2_1014328,locale_arugula_guanabara,1014328,2,0,8,8,0
4_967615,locale_arugula_bavaria,967615,4,8,21,29,0
3_5387050,feast_rest_onion_shrimp_bavaria_guanabara,5387050,3,6,311,317,0
2_3992670,locale_onion_guanabara,3992670,2,0,24,24,0
4_4615811,locale_onion_bavaria,4615811,4,24,1,25,0
3_445850,feast_satiety_haroset_turkey_goias_bavaria,445850,3,6,296,302,0
2_7733722,locale_haroset_bavaria,7733722,2,0,14,14,0
4_2397571,locale_haroset_goias,2397571,4,14,1,15,0
3_3401200,feast_achievement_haroset_turkey_bavaria_guanabara,3401200,3,6,397,403,0
2_3695108,craves_achievement_haroset,3695108,2,0,6,6,0
4_4501831,craves_achievement_turkey,4501831,4,2,63,65,0
3_6318650,feast_excitement_marzipan_rice_guanabara_bosnia,6318650,3,6,322,328,0
2_5089410,locale_marzipan_bosnia,5089410,2,0,35,35,0
4_2021859,locale_marzipan_guanabara,2021859,4,35,1,36,0
3_1491300,feast_lubricity_rice_cherry_bavaria_guanabara,1491300,3,6,468,474,0
2_1005562,craves_lubricity_rice,1005562,2,0,16,16,0
3_7873100,feast_satiety_papaya_wurst_goias_bavaria,7873100,3,6,530,536,0
2_4968840,locale_papaya_bavaria,4968840,2,0,8,8,0
4_2075468,locale_papaya_goias,2075468,4,8,35,43,0
3_7858450,feast_love_onion_ham_bavaria_guanabara,7858450,3,7,390,397,0
3_376050,feast_love_marzipan_haroset_guanabara_bosnia,376050,3,7,368,375,0
3_4746400,feast_love_haroset_turkey_goias_bavaria,4746400,3,7,349,356,0
3_606650,feast_lubricity_onion_marzipan_bavaria_guanabara,606650,3,7,322,329,0
3_1024450,feast_excitement_rice_papaya_goias_bavaria,1024450,3,6,280,286,0
2_5580230,locale_rice_bavaria,5580230,2,0,18,18,0
4_1267029,locale_rice_goias,1267029,4,18,5,23,0
3_286650,overcome_boils_intoxication_potato_saturn_earth,286650,3,8,444,452,0
2_3711391,craves_boils_potato,3711391,2,0,6,6,0
3_6691600,overcome_loneliness-3_intoxication_wonderbread_earth_uranus,6691600,3,8,424,432,0
2_6166792,craves_loneliness-3_wonderbread,6166792,2,0,6,6,0
3_7983950,overcome_loneliness-3_satisfaction_wonderbread_mercury_saturn,7983950,3,9,447,456,0
4_4077212,fears_loneliness-3_satisfaction,4077212,4,3,48,51,0
3_593250,overcome_hangover_entertainment_wurst_earth_uranus,593250,3,8,244,252,0
2_5408021,craves_hangover_wurst,5408021,2,0,8,8,0
4_4236582,fears_hangover_entertainment,4236582,4,2,44,46,0
3_3943550,overcome_hangover_entertainment_wurst_saturn_earth,3943550,3,9,257,266,0
4_2402640,harmony_entertainment_saturn,2402640,4,4,7,11,0
3_2571000,overcome_jealousy_achievement_rice_mercury_saturn,2571000,3,9,291,300,0
3_952650,overcome_grief_love_wurst_saturn_earth,952650,3,8,490,498,0
2_5516608,craves_grief_wurst,5516608,2,0,9,9,0
3_4294451,noop_craves_abrasion-4_onion,4294451,3,0,269,269,0
2_703339,craves_abrasion-4_onion,703339,2,0,11,11,0
3_5250251,noop_fears_abrasion-4_lubricity,5250251,3,0,326,326,0
2_4539735,fears_abrasion-4_lubricity,4539735,2,0,1,1,0
3_6296301,noop_craves_loneliness_shrimp,6296301,3,0,219,219,0
2_7083984,craves_loneliness_shrimp,7083984,2,0,9,9,0
3_5182951,noop_locale_endive_bavaria,5182951,3,0,282,282,0
2_7973276,locale_endive_bavaria,7973276,2,0,8,8,0
3_4007851,noop_fears_loneliness-3_lubricity,4007851,3,0,326,326,0
2_5317415,fears_loneliness-3_lubricity,5317415,2,0,1,1,0
3_227201,succumb_jealousy_love_haroset_earth_uranus,227201,3,7,350,357,0
4_222734,craves_jealousy_haroset,222734,4,1,47,48,0
3_7805251,succumb_prostatitis_love_wurst_earth_uranus,7805251,3,6,321,327,0
2_2054340,fears_prostatitis_love,2054340,2,0,1,1,0
3_5370401,succumb_boils-1_satisfaction_potato_mercury_saturn,5370401,3,7,241,248,0
3_1889051,feast_rest_cherry_marzipan_guanabara_bosnia,1889051,3,6,436,442,0
2_4226405,craves_rest_cherry,4226405,2,0,16,16,0
3_1541501,feast_rest_rice_cherry_goias_bavaria,1541501,3,6,460,466,0
2_843559,craves_rest_rice,843559,2,0,16,16,0
3_131601,feast_lubricity_rice_papaya_guanabara_bosnia,131601,3,7,468,475,0
4_34924,craves_lubricity_papaya,34924,4,4,71,75,0
3_139751,feast_achievement_onion_marzipan_bavaria_guanabara,139751,3,6,428,434,0
2_6351782,craves_achievement_onion,6351782,2,0,13,13,0
3_1850201,feast_love_endive_cherry_goias_bavaria,1850201,3,7,540,547,0
4_1330794,locale_endive_goias,1330794,4,8,37,45,0
3_1807251,feast_excitement_papaya_rice_goias_bavaria,1807251,3,7,419,426,0
3_5376701,feast_love_shrimp_onion_bosnia_alsace,5376701,3,6,693,699,0
2_5697397,craves_love_shrimp,5697397,2,0,14,14,0
3_2431501,feast_love_shrimp_turkey_goias_bavaria,2431501,3,6,559,565,0
2_7231215,locale_shrimp_bavaria,7231215,2,0,18,18,0
4_7147533,locale_shrimp_goias,7147533,4,18,16,34,0
3_4407451,overcome_abrasion-4_love_ham_earth_uranus,4407451,3,8,407,415,0
2_2533325,craves_love_ham,2533325,2,0,8,8,0
4_4170497,fears_abrasion-4_love,4170497,4,5,48,53,0
3_7115751,overcome_abrasion-4_love_onion_saturn_earth,7115751,3,9,572,581,0
3_3765451,overcome_abrasion-4_love_onion_earth_uranus,3765451,3,9,576,585,0
3_2519751,overcome_boils-1_intoxication_arugula_mercury_saturn,2519751,3,8,183,191,0
2_3237659,harmony_intoxication_saturn,3237659,2,0,17,17,0
4_4904343,harmony_intoxication_mercury,4904343,4,8,16,24,0
3_2155151,overcome_dread_lubricity_rice_earth_uranus,2155151,3,9,600,609,0
4_4319540,fears_dread_lubricity,4319540,4,1,96,97,0
3_7965151,overcome_jealousy_excitement_cherry_earth_uranus,7965151,3,8,498,506,0
2_575897,craves_jealousy_cherry,575897,2,0,8,8,0
3_1625751,overcome_jealousy_achievement_papaya_saturn_earth,1625751,3,7,534,541,0
2_3979244,craves_achievement_papaya,3979244,2,0,11,11,0
2_4653264,craves_jealousy_papaya,4653264,2,0,6,6,0
3_7934801,overcome_laceration_love_rice_earth_uranus,7934801,3,8,514,522,0
2_5669574,craves_laceration_rice,5669574,2,0,11,11,0
3_6179401,overcome_loneliness_satiety_shrimp_mercury_saturn,6179401,3,8,535,543,0
2_4213322,craves_satiety_shrimp,4213322,2,0,14,14,0
4_3883223,fears_loneliness_satiety,3883223,4,1,80,81,0
3_5236301,overcome_grief_love_cherry_mercury_saturn,5236301,3,8,485,493,0
2_2853266,craves_grief_cherry,2853266,2,0,9,9,0
4_2564739,harmony_love_mercury,2564739,4,12,28,40,0
4_1332191,eats_turkey_haroset,1332191,4,1,0,1,0
3_5856752,noop_craves_boils_potato,5856752,3,1,286,287,0
3_2123302,noop_craves_excitement_onion,2123302,3,0,363,363,0
2_6533167,craves_excitement_onion,6533167,2,0,13,13,0
3_2556702,noop_craves_boils_onion,2556702,3,0,285,285,0
2_6580064,craves_boils_onion,6580064,2,0,9,9,0
3_1640252,noop_fears_abrasion-4_intoxication,1640252,3,0,224,224,0
2_847602,fears_abrasion-4_intoxication,847602,2,0,1,1,0
3_6878652,succumb_anxiety_love_marzipan_saturn_earth,6878652,3,7,321,328,0
3_6814502,succumb_laceration_love_marzipan_earth_uranus,6814502,3,7,348,355,0
3_4951852,succumb_boils_lubricity_yogurt_earth_uranus,4951852,3,7,294,301,0
4_7241536,craves_boils_yogurt,7241536,4,1,52,53,0
3_3967302,succumb_jealousy_satiety_cherry_mercury_saturn,3967302,3,7,303,310,0
3_7905902,succumb_loneliness-3_rest_shrimp_mercury_saturn,7905902,3,7,306,313,0
4_2256726,craves_loneliness-3_shrimp,2256726,4,1,59,60,0
3_3796852,succumb_anger_excitement_marzipan_earth_uranus,3796852,3,6,280,286,0
2_5571930,fears_anger_excitement,5571930,2,0,1,1,0
3_6439752,succumb_anger_love_rice_earth_uranus,6439752,3,7,321,328,0
4_6772622,craves_anger_rice,6772622,4,3,12,15,0
3_2053752,succumb_jealousy-2_intoxication_wonderbread_saturn_earth,2053752,3,7,189,196,0
3_3146952,succumb_hangover_love_papaya_saturn_earth,3146952,3,7,328,335,0
3_3171402,feast_lubricity_rice_marzipan_bosnia_alsace,3171402,3,7,783,790,0
3_3297402,feast_lubricity_wonderbread_arugula_bavaria_guanabara,3297402,3,5,299,304,0
2_1546140,locale_wonderbread_guanabara,1546140,2,0,12,12,0
2_4947268,craves_lubricity_wonderbread,4947268,2,0,14,14,0
4_6588915,locale_wonderbread_bavaria,6588915,4,12,2,14,0
3_6150602,feast_satiety_shrimp_onion_goias_bavaria,6150602,3,7,507,514,0
3_5861802,feast_satisfaction_marzipan_mutton_guanabara_bosnia,5861802,3,6,347,353,0
2_4615585,craves_satisfaction_marzipan,4615585,2,0,19,19,0
4_1554400,craves_satisfaction_mutton,1554400,4,5,34,39,0
3_4565902,feast_excitement_endive_wurst_bosnia_alsace,4565902,3,6,449,455,0
2_6357293,craves_excitement_endive,6357293,2,0,11,11,0
3_517752,feast_achievement_papaya_rice_goias_bavaria,517752,3,7,526,533,0
3_2592702,overcome_depression-7_rest_haroset_mercury_saturn,2592702,3,8,397,405,0
2_6639450,craves_rest_haroset,6639450,2,0,6,6,0
4_5126856,fears_depression-7_rest,5126856,4,1,77,78,0
3_4048102,overcome_dread_satiety_wurst_mercury_saturn,4048102,3,8,450,458,0
2_6688887,craves_dread_wurst,6688887,2,0,8,8,0
3_1478102,overcome_jealousy_lubricity_cherry_earth_uranus,1478102,3,8,702,710,0
2_3958534,craves_lubricity_cherry,3958534,2,0,16,16,0
4_5529098,fears_jealousy_lubricity,5529098,4,4,51,55,0
3_188553,noop_fears_laceration-8_satiety,188553,3,0,314,314,0
2_7479014,fears_laceration-8_satiety,7479014,2,0,1,1,0
3_4816253,noop_fears_hangover_satiety,4816253,3,0,333,333,0
2_7052500,fears_hangover_satiety,7052500,2,0,1,1,0
3_7746303,succumb_sciatica_intoxication_ham_earth_uranus,7746303,3,7,199,206,0
4_2806898,craves_sciatica_ham,2806898,4,2,7,9,0
3_7684553,succumb_anger_satiety_mutton_mercury_saturn,7684553,3,7,306,313,0
4_1028645,craves_anger_mutton,1028645,4,2,13,15,0
3_943303,feast_satisfaction_yogurt_wonderbread_bavaria_guanabara,943303,3,7,192,199,0
3_5273653,feast_excitement_cherry_rice_goias_bavaria,5273653,3,6,320,326,0
2_800046,locale_cherry_bavaria,800046,2,0,18,18,0
4_7926949,locale_cherry_goias,7926949,4,18,5,23,0
3_3727853,feast_rest_cherry_endive_bosnia_alsace,3727853,3,7,717,724,0
4_4252146,craves_rest_endive,4252146,4,4,75,79,0
3_2224553,feast_excitement_onion_ham_guanabara_bosnia,2224553,3,7,427,434,0
4_7290801,craves_excitement_ham,7290801,4,5,59,64,0
3_286303,feast_satisfaction_haroset_turkey_bavaria_guanabara,286303,3,6,255,261,0
2_5167173,craves_satisfaction_haroset,5167173,2,0,6,6,0
3_4620653,feast_lubricity_cherry_endive_guanabara_bosnia,4620653,3,7,468,475,0
4_3984275,craves_lubricity_endive,3984275,4,4,71,75,0
3_5368303,feast_satisfaction_marzipan_rice_alsace_surrey,5368303,3,7,587,594,0
4_3466196,craves_satisfaction_rice,3466196,4,3,43,46,0
3_5806703,feast_satiety_marzipan_haroset_guanabara_bosnia,5806703,3,7,314,321,0
3_1464503,overcome_abrasion-4_achievement_onion_saturn_earth,1464503,3,9,586,595,0
4_4066918,fears_abrasion-4_achievement,4066918,4,2,100,102,0
3_778253,overcome_laceration-8_rest_haroset_mercury_saturn,778253,3,9,397,406,0
4_3525477,fears_laceration-8_rest,3525477,4,1,78,79,0
3_1629653,overcome_loneliness-3_lubricity_mutton_earth_uranus,1629653,3,7,541,548,0
2_1136011,craves_lubricity_mutton,1136011,2,0,6,6,0
2_87106,craves_loneliness-3_mutton,87106,2,0,8,8,0
3_7251003,overcome_abrasion_lubricity_yogurt_saturn_earth,7251003,3,9,290,299,0
3_7689503,overcome_depression_love_cherry_earth_uranus,7689503,3,8,477,485,0
2_6292496,craves_depression_cherry,6292496,2,0,9,9,0
3_2766953,overcome_jealousy_satiety_marzipan_mercury_saturn,2766953,3,8,516,524,0
2_2993567,craves_jealousy_marzipan,2993567,2,0,10,10,0
3_3977403,overcome_laceration_achievement_endive_mercury_saturn,3977403,3,8,460,468,0
2_3350376,craves_laceration_endive,3350376,2,0,6,6,0
3_6538453,overcome_grief_achievement_wurst_saturn_earth,6538453,3,9,237,246,0
4_6527729,orbits_mercury_saturn,6527729,4,1,0,1,0
4_1567476,pain_anger,1567476,4,1,0,1,0
3_3637704,noop_craves_lubricity_wonderbread,3637704,3,1,261,262,0
3_1579204,noop_craves_rest_potato,1579204,3,0,266,266,0
2_5602566,craves_rest_potato,5602566,2,0,12,12,0
4_676602,eats_marzipan_haroset,676602,4,1,0,1,0
3_6675854,noop_craves_satiety_turkey,6675854,3,0,320,320,0
2_1465202,craves_satiety_turkey,1465202,2,0,3,3,0
4_4332901,eats_mutton_ham,4332901,4,1,0,1,0
4_3609901,province_surrey,3609901,4,1,0,1,0
3_1669554,succumb_loneliness_lubricity_yogurt_earth_uranus,1669554,3,7,317,324,0
3_4227704,succumb_anger_love_marzipan_saturn_earth,4227704,3,7,321,328,0
3_5623854,succumb_loneliness_intoxication_arugula_saturn_earth,5623854,3,7,218,225,0
3_2273554,succumb_loneliness_intoxication_arugula_earth_uranus,2273554,3,7,218,225,0
3_1419604,succumb_hangover_love_wurst_earth_uranus,1419604,3,7,328,335,0
3_3984154,feast_achievement_cherry_rice_goias_bavaria,3984154,3,7,287,294,0
3_5080254,feast_rest_rice_cherry_bavaria_guanabara,5080254,3,7,436,443,0
3_2394754,feast_excitement_marzipan_haroset_guanabara_bosnia,2394754,3,7,322,329,0
3_3100304,feast_rest_potato_shrimp_goias_bavaria,3100304,3,7,303,310,0
3_222054,feast_satisfaction_ham_wonderbread_goias_bavaria,222054,3,6,213,219,0
2_5388128,craves_satisfaction_ham,5388128,2,0,8,8,0
3_5415554,feast_rest_turkey_haroset_goias_bavaria,5415554,3,6,382,388,0
2_825382,craves_rest_turkey,825382,2,0,3,3,0
3_2750804,feast_rest_yogurt_wonderbread_goias_bavaria,2750804,3,6,412,418,0
2_1038288,locale_yogurt_bavaria,1038288,2,0,8,8,0
4_1707199,locale_yogurt_goias,1707199,4,8,23,31,0
3_2748104,feast_satisfaction_marzipan_mutton_bosnia_alsace,2748104,3,7,347,354,0
3_3244304,feast_love_rice_papaya_goias_bavaria,3244304,3,7,331,338,0
3_1799804,overcome_abrasion-4_intoxication_mutton_earth_uranus,1799804,3,7,442,449,0
2_4660192,craves_intoxication_mutton,4660192,2,0,6,6,0
2_7255760,craves_abrasion-4_mutton,7255760,2,0,8,8,0
3_5476004,overcome_dread_achievement_wurst_mercury_saturn,5476004,3,9,426,435,0
4_7129906,fears_dread_achievement,7129906,4,5,40,45,0
3_5722904,overcome_loneliness_intoxication_arugula_mercury_saturn,5722904,3,8,363,371,0
2_5263566,craves_loneliness_arugula,5263566,2,0,7,7,0
3_999554,overcome_loneliness_intoxication_shrimp_saturn_earth,999554,3,9,366,375,0
3_2682855,succumb_anger_achievement_marzipan_saturn_earth,2682855,3,6,281,287,0
2_4333152,fears_anger_achievement,4333152,2,0,1,1,0
3_6541355,succumb_boils_intoxication_shrimp_earth_uranus,6541355,3,6,241,247,0
2_3055707,fears_boils_intoxication,3055707,2,0,1,1,0
3_6226455,succumb_dread_excitement_papaya_mercury_saturn,6226455,3,7,232,239,0
3_6493355,succumb_laceration_satiety_papaya_mercury_saturn,6493355,3,7,288,295,0
4_7402002,craves_laceration_papaya,7402002,4,1,38,39,0
3_4581055,succumb_laceration_satiety_wurst_mercury_saturn,4581055,3,7,265,272,0
4_5737226,craves_laceration_wurst,5737226,4,1,45,46,0
3_5672905,succumb_boils-1_lubricity_arugula_earth_uranus,5672905,3,6,314,320,0
2_7258771,fears_boils-1_lubricity,7258771,2,0,1,1,0
3_6331705,succumb_depression_achievement_cherry_mercury_saturn,6331705,3,7,229,236,0
3_3392755,feast_rest_cherry_marzipan_bavaria_guanabara,3392755,3,7,436,443,0
3_1554855,feast_satiety_ham_mutton_bavaria_guanabara,1554855,3,6,567,573,0
2_384409,craves_satiety_ham,384409,2,0,8,8,0
3_2228355,feast_excitement_onion_shrimp_guanabara_bosnia,2228355,3,7,427,434,0
4_5678649,craves_excitement_shrimp,5678649,4,3,63,66,0
3_706355,feast_lubricity_wonderbread_yogurt_bavaria_guanabara,706355,3,7,299,306,0
3_1747305,feast_lubricity_wonderbread_arugula_bosnia_alsace,1747305,3,7,356,363,0
3_5855405,feast_love_ham_mutton_bavaria_guanabara,5855405,3,7,616,623,0
3_7124755,feast_satisfaction_ham_onion_bavaria_guanabara,7124755,3,7,447,454,0
3_2363455,feast_rest_marzipan_cherry_guanabara_bosnia,2363455,3,7,358,365,0
3_4238955,feast_achievement_onion_shrimp_bavaria_guanabara,4238955,3,7,428,435,0
4_7249951,craves_achievement_shrimp,7249951,4,3,35,38,0
3_2907555,feast_lubricity_cherry_rice_goias_bavaria,2907555,3,7,496,503,0
3_4027105,feast_love_papaya_rice_goias_bavaria,4027105,3,7,394,401,0
3_4814255,feast_achievement_papaya_wurst_bosnia_alsace,4814255,3,7,445,452,0
3_2875855,overcome_abrasion-4_lubricity_onion_earth_uranus,2875855,3,9,507,516,0
3_6226155,overcome_abrasion-4_lubricity_onion_saturn_earth,6226155,3,9,514,523,0
3_5050705,overcome_hangover_achievement_wurst_saturn_earth,5050705,3,9,413,422,0
4_6919532,fears_hangover_achievement,6919532,4,5,40,45,0
3_4349905,overcome_dread_love_wurst_saturn_earth,4349905,3,9,487,496,0
3_999605,overcome_dread_love_wurst_earth_uranus,999605,3,9,490,499,0
3_2848906,noop_fears_boils-1_lubricity,2848906,3,1,301,302,0
3_2541056,succumb_boils_satisfaction_turkey_mercury_saturn,2541056,3,7,273,280,0
3_1429856,succumb_grief_achievement_marzipan_saturn_earth,1429856,3,7,245,252,0
4_2423393,craves_grief_marzipan,2423393,4,2,43,45,0
3_3299556,feast_satiety_rice_marzipan_goias_bavaria,3299556,3,7,310,317,0
3_4080806,feast_lubricity_marzipan_haroset_guanabara_bosnia,4080806,3,7,357,364,0
3_2947656,feast_rest_potato_arugula_bavaria_guanabara,2947656,3,7,303,310,0
3_7338256,feast_lubricity_wonderbread_ham_bosnia_alsace,7338256,3,7,356,363,0
3_2083156,feast_intoxication_yogurt_wonderbread_goias_bavaria,2083156,3,7,308,315,0
3_2986406,feast_excitement_haroset_turkey_bavaria_guanabara,2986406,3,7,396,403,0
4_2930529,craves_excitement_turkey,2930529,4,2,63,65,0
3_7411306,feast_intoxication_wonderbread_yogurt_bavaria_guanabara,7411306,3,7,201,208,0
3_4471556,overcome_boils_lubricity_onion_earth_uranus,4471556,3,9,301,310,0
3_169006,overcome_abrasion-4_intoxication_wonderbread_mercury_saturn,169006,3,8,425,433,0
2_6651610,craves_abrasion-4_wonderbread,6651610,2,0,6,6,0
3_3178806,overcome_abrasion-4_satiety_ham_mercury_saturn,3178806,3,9,356,365,0
4_3207324,fears_abrasion-4_satiety,3207324,4,3,51,54,0
3_1506856,overcome_loneliness-3_achievement_mutton_saturn_earth,1506856,3,8,593,601,0
2_5080331,craves_achievement_mutton,5080331,2,0,6,6,0
4_3879908,fears_loneliness-3_achievement,3879908,4,2,100,102,0
3_968806,overcome_prostatitis_excitement_wurst_mercury_saturn,968806,3,9,236,245,0
3_1740456,overcome_grief_entertainment_wurst_earth_uranus,1740456,3,9,241,250,0
4_5021913,fears_grief_entertainment,5021913,4,2,43,45,0
3_5090756,overcome_grief_entertainment_wurst_saturn_earth,5090756,3,9,255,264,0
4_2252646,eats_haroset_turkey,2252646,4,1,0,1,0
4_2230292,eats_cherry_endive,2230292,4,1,0,1,0
4_3933873,province_bavaria,3933873,4,1,0,1,0
3_5174257,succumb_laceration_achievement_marzipan_saturn_earth,5174257,3,7,289,296,0
3_7498107,succumb_laceration-8_lubricity_haroset_earth_uranus,7498107,3,6,298,304,0
2_7831322,fears_laceration-8_lubricity,7831322,2,0,1,1,0
3_7984357,succumb_hangover_excitement_papaya_mercury_saturn,7984357,3,7,232,239,0
3_7493507,feast_love_cherry_rice_goias_bavaria,7493507,3,7,365,372,0
3_4187607,feast_excitement_onion_marzipan_bosnia_alsace,4187607,3,7,524,531,0
3_4648157,feast_rest_marzipan_onion_guanabara_bosnia,4648157,3,7,358,365,0
3_6181257,feast_lubricity_shrimp_turkey_goias_bavaria,6181257,3,7,387,394,0
3_6984107,feast_achievement_onion_ham_bavaria_guanabara,6984107,3,7,428,435,0
4_4078614,craves_achievement_ham,4078614,4,5,62,67,0
3_3657,feast_lubricity_cherry_endive_goias_bavaria,3657,3,7,496,503,0
3_981707,feast_love_rice_cherry_goias_bavaria,981707,3,7,331,338,0
3_3541757,feast_excitement_rice_marzipan_goias_bavaria,3541757,3,7,280,287,0
3_4832657,feast_satiety_onion_marzipan_bavaria_guanabara,4832657,3,7,337,344,0
3_4459407,overcome_boils_rest_turkey_mercury_saturn,4459407,3,8,564,572,0
2_6935184,craves_boils_turkey,6935184,2,0,6,6,0
3_120557,overcome_laceration-8_achievement_haroset_saturn_earth,120557,3,9,384,393,0
4_7171653,fears_laceration-8_achievement,7171653,4,1,65,66,0
3_6857207,overcome_depression_excitement_endive_earth_uranus,6857207,3,9,303,312,0
4_3187434,fears_depression_excitement,3187434,4,6,39,45,0
4_1432497,eats_rice_cherry,1432497,4,1,0,1,0
4_1996392,food_turkey,1996392,4,1,0,1,0
4_2574892,food_mutton,2574892,4,1,0,1,0
3_5370708,noop_craves_intoxication_mutton,5370708,3,1,205,206,0
3_4792208,noop_craves_intoxication_turkey,4792208,3,0,210,210,0
2_4081692,craves_intoxication_turkey,4081692,2,0,3,3,0
4_6406031,planet_saturn,6406031,4,1,0,1,0
3_3457908,noop_craves_achievement_mutton,3457908,3,1,366,367,0
3_6521758,noop_fears_laceration-8_lubricity,6521758,3,1,289,290,0
3_7569808,noop_fears_abrasion_intoxication,7569808,3,0,182,182,0
2_1699206,fears_abrasion_intoxication,1699206,2,0,1,1,0
4_3095552,pain_boils-1,3095552,4,1,0,1,0
3_6335058,succumb_angina_lubricity_ham_earth_uranus,6335058,3,7,310,317,0
4_6505494,craves_angina_ham,6505494,4,2,11,13,0
3_2555708,succumb_loneliness-3_intoxication_ham_earth_uranus,2555708,3,6,235,241,0
2_978904,fears_loneliness-3_intoxication,978904,2,0,1,1,0
3_7656458,succumb_anxiety_achievement_marzipan_saturn_earth,7656458,3,6,281,287,0
2_2122856,fears_anxiety_achievement,2122856,2,0,1,1,0
3_184908,succumb_anxiety_satiety_haroset_mercury_saturn,184908,3,7,306,313,0
4_6990473,craves_anxiety_haroset,6990473,4,2,13,15,0
3_6808608,succumb_grief_achievement_cherry_earth_uranus,6808608,3,7,221,228,0
4_4059168,harmony_achievement_uranus,4059168,4,10,23,33,0
3_7884658,succumb_angina_rest_marzipan_mercury_saturn,7884658,3,7,296,303,0
4_6697179,craves_angina_marzipan,6697179,4,2,11,13,0
3_848908,succumb_depression_achievement_rice_saturn_earth,848908,3,7,245,252,0
4_1602106,craves_depression_rice,1602106,4,2,43,45,0
3_2856908,succumb_boils-1_intoxication_potato_saturn_earth,2856908,3,7,192,199,0
3_7724808,feast_achievement_haroset_marzipan_bavaria_guanabara,7724808,3,7,397,404,0
3_858658,feast_intoxication_yogurt_potato_goias_bavaria,858658,3,7,308,315,0
3_975858,feast_achievement_endive_cherry_goias_bavaria,975858,3,7,387,394,0
3_4452158,overcome_abrasion-4_lubricity_ham_saturn_earth,4452158,3,9,329,338,0
3_3514708,overcome_laceration-8_satisfaction_haroset_mercury_saturn,3514708,3,9,238,247,0
4_6661347,fears_laceration-8_satisfaction,6661347,4,1,47,48,0
3_6597708,overcome_loneliness-3_love_onion_saturn_earth,6597708,3,8,572,580,0
2_2113012,craves_loneliness-3_onion,2113012,2,0,11,11,0
4_5110837,fears_loneliness-3_love,5110837,4,5,48,53,0
3_3247408,overcome_loneliness-3_love_onion_earth_uranus,3247408,3,9,576,585,0
3_3923008,overcome_hangover_love_papaya_mercury_saturn,3923008,3,9,328,337,0
3_357708,overcome_hangover_excitement_rice_earth_uranus,357708,3,8,239,247,0
2_4824435,craves_hangover_rice,4824435,2,0,9,9,0
3_585158,overcome_dread_love_rice_mercury_saturn,585158,3,9,461,470,0
3_1306558,overcome_jealousy_love_cherry_earth_uranus,1306558,3,9,337,346,0
3_5586608,overcome_jealousy_achievement_marzipan_saturn_earth,5586608,3,9,517,526,0
3_1006358,overcome_loneliness_intoxication_potato_mercury_saturn,1006358,3,9,218,227,0
3_681758,overcome_loneliness_satisfaction_shrimp_mercury_saturn,681758,3,9,233,242,0
3_3450458,overcome_grief_excitement_endive_earth_uranus,3450458,3,9,303,312,0
4_5475787,fears_grief_excitement,5475787,4,6,39,45,0
4_7908898,planet_mercury,7908898,4,1,0,1,0
3_4722509,noop_fears_depression-7_love,4722509,3,0,365,365,0
2_1131397,fears_depression-7_love,1131397,2,0,1,1,0
4_3749584,eats_wurst_endive,3749584,4,1,0,1,0
3_3848059,noop_fears_anger_lubricity,3848059,3,0,308,308,0
2_6638384,fears_anger_lubricity,6638384,2,0,1,1,0
4_3933582,pain_jealousy,3933582,4,1,0,1,0
4_4380956,eats_marzipan_mutton,4380956,4,1,0,1,0
3_4011309,succumb_abrasion_rest_yogurt_mercury_saturn,4011309,3,6,305,311,0
2_3664603,fears_abrasion_rest,3664603,2,0,1,1,0
3_1549109,succumb_anger_love_mutton_earth_uranus,1549109,3,7,352,359,0
3_1538909,feast_achievement_mutton_marzipan_bavaria_guanabara,1538909,3,7,394,401,0
3_5024259,feast_intoxication_turkey_shrimp_goias_bavaria,5024259,3,7,235,242,0
3_128109,overcome_boils_satiety_turkey_mercury_saturn,128109,3,9,589,598,0
4_6877091,fears_boils_satiety,6877091,4,3,52,55,0
3_7959559,overcome_laceration-8_excitement_haroset_earth_uranus,7959559,3,9,383,392,0
4_6926932,fears_laceration-8_excitement,6926932,4,1,66,67,0
3_3517109,overcome_anger_excitement_marzipan_saturn_earth,3517109,3,9,265,274,0
3_2612109,overcome_jealousy_excitement_rice_mercury_saturn,2612109,3,9,267,276,0
3_337259,overcome_jealousy_satiety_cherry_mercury_saturn,337259,3,9,515,524,0
4_2302744,food_yogurt,2302744,4,1,0,1,0
3_5569610,noop_craves_excitement_endive,5569610,3,1,256,257,0
4_5524126,eats_papaya_rice,5524126,4,1,0,1,0
3_7444260,noop_craves_abrasion-4_wonderbread,7444260,3,1,268,269,0
3_5207110,succumb_prostatitis_satiety_wurst_mercury_saturn,5207110,3,6,269,275,0
2_3430109,fears_prostatitis_satiety,3430109,2,0,1,1,0
3_1564660,succumb_anxiety_lubricity_marzipan_earth_uranus,1564660,3,6,330,336,0
2_2652512,fears_anxiety_lubricity,2652512,2,0,1,1,0
3_268760,succumb_loneliness-3_lubricity_ham_earth_uranus,268760,3,7,337,344,0
3_5287510,succumb_depression_satiety_wurst_mercury_saturn,5287510,3,7,285,292,0
3_5807460,succumb_jealousy-2_intoxication_ham_earth_uranus,5807460,3,7,199,206,0
4_203217,craves_jealousy-2_ham,203217,4,2,7,9,0
3_3093410,feast_satiety_turkey_haroset_goias_bavaria,3093410,3,7,343,350,0
3_2552410,feast_satiety_ham_onion_bavaria_guanabara,2552410,3,7,567,574,0
3_1466610,feast_intoxication_shrimp_potato_goias_bavaria,1466610,3,7,333,340,0
3_6825610,feast_rest_potato_arugula_goias_bavaria,6825610,3,7,303,310,0
3_5553060,feast_satiety_endive_wurst_goias_bavaria,5553060,3,7,346,353,0
3_7393960,feast_love_turkey_haroset_goias_bavaria,7393960,3,6,396,402,0
2_2949277,craves_love_turkey,2949277,2,0,3,3,0
3_2128710,feast_love_rice_marzipan_goias_bavaria,2128710,3,7,331,338,0
3_1124760,feast_rest_wonderbread_arugula_bavaria_guanabara,1124760,3,7,284,291,0
3_2621010,feast_achievement_papaya_wurst_guanabara_bosnia,2621010,3,7,291,298,0
3_6927360,overcome_boils_excitement_onion_earth_uranus,6927360,3,9,614,623,0
4_7880654,fears_boils_excitement,7880654,4,1,91,92,0
3_6105210,overcome_boils_lubricity_shrimp_mercury_saturn,6105210,3,9,267,276,0
4_2778773,harmony_lubricity_mercury,2778773,4,7,35,42,0
3_7417060,overcome_depression-7_excitement_haroset_earth_uranus,7417060,3,9,383,392,0
4_5799944,fears_depression-7_excitement,5799944,4,1,66,67,0
3_1666860,overcome_jealousy_excitement_papaya_saturn_earth,1666860,3,9,500,509,0
3_3065860,overcome_loneliness_rest_arugula_mercury_saturn,3065860,3,9,480,489,0
4_2972415,fears_loneliness_rest,2972415,4,4,61,65,0
3_4786061,noop_fears_angina_satiety,4786061,3,0,323,323,0
2_7641058,fears_angina_satiety,7641058,2,0,1,1,0
3_3474011,succumb_angina_love_onion_earth_uranus,3474011,3,6,388,394,0
2_7699444,fears_angina_love,7699444,2,0,1,1,0
3_153561,feast_rest_cherry_rice_bavaria_guanabara,153561,3,7,436,443,0
3_276061,feast_satisfaction_marzipan_cherry_bosnia_alsace,276061,3,7,347,354,0
4_4376923,craves_satisfaction_cherry,4376923,4,3,43,46,0
3_463561,overcome_abrasion-4_achievement_mutton_saturn_earth,463561,3,9,593,602,0
3_410311,overcome_sciatica_intoxication_wonderbread_mercury_saturn,410311,3,9,189,198,0
3_259961,overcome_loneliness-3_satisfaction_ham_mercury_saturn,259961,3,9,227,236,0
3_7200461,overcome_laceration_satiety_rice_mercury_saturn,7200461,3,9,288,297,0
4_601332,pleasure_achievement,601332,4,1,0,1,0
3_2726012,noop_fears_grief_love,2726012,3,0,381,381,0
2_5019078,fears_grief_love,5019078,2,0,1,1,0
4_5961424,province_guanabara,5961424,4,1,0,1,0
4_365501,orbits_earth_uranus,365501,4,1,0,1,0
4_3715801,orbits_saturn_earth,3715801,4,1,0,1,0
3_1677712,succumb_anxiety_satiety_rice_mercury_saturn,1677712,3,7,275,282,0
4_105066,craves_anxiety_rice,105066,4,3,12,15,0
3_5622962,succumb_boils-1_intoxication_wonderbread_saturn_earth,5622962,3,7,191,198,0
3_3767412,feast_rest_haroset_turkey_bavaria_guanabara,3767412,3,7,410,417,0
3_2037512,feast_rest_onion_ham_bavaria_guanabara,2037512,3,7,311,318,0
3_1345612,feast_lubricity_wonderbread_yogurt_bosnia_alsace,1345612,3,7,356,363,0
3_2886812,feast_satisfaction_shrimp_onion_goias_bavaria,2886812,3,7,277,284,0
3_29662,feast_love_ham_wonderbread_bavaria_guanabara,29662,3,7,616,623,0
4_7041704,craves_love_wonderbread,7041704,4,2,44,46,0
3_6261612,overcome_boils_intoxication_shrimp_saturn_earth,6261612,3,9,235,244,0
3_1733662,overcome_depression-7_lubricity_haroset_saturn_earth,1733662,3,9,279,288,0
3_5393162,overcome_boils-1_lubricity_arugula_saturn_earth,5393162,3,9,307,316,0
3_6114062,overcome_loneliness-3_lubricity_wonderbread_earth_uranus,6114062,3,9,514,523,0
3_7180712,overcome_depression_entertainment_wurst_earth_uranus,7180712,3,8,241,249,0
2_4592428,craves_depression_wurst,4592428,2,0,9,9,0
4_4530591,fears_depression_entertainment,4530591,4,2,43,45,0
3_5184812,overcome_hangover_excitement_wurst_earth_uranus,5184812,3,9,239,248,0
3_1486762,overcome_dread_love_papaya_mercury_saturn,1486762,3,9,328,337,0
3_5504813,noop_craves_depression_cherry,5504813,3,1,218,219,0
3_978263,noop_craves_satisfaction_ham,978263,3,1,175,176,0
3_182563,noop_craves_depression_wurst,182563,3,1,229,230,0
3_2891913,noop_fears_depression-7_lubricity,2891913,3,0,289,289,0
2_4201477,fears_depression-7_lubricity,4201477,2,0,1,1,0
3_2853163,noop_locale_marzipan_bosnia,2853163,3,1,108,109,0
4_4317552,eats_marzipan_onion,4317552,4,1,0,1,0
3_3998713,noop_harmony_love_saturn,3998713,3,1,225,226,0
3_5032463,succumb_angina_lubricity_shrimp_earth_uranus,5032463,3,7,288,295,0
4_5346076,craves_angina_shrimp,5346076,4,3,11,14,0
3_5680213,succumb_boils_lubricity_marzipan_earth_uranus,5680213,3,7,284,291,0
4_561508,craves_boils_marzipan,561508,4,1,50,51,0
3_7495213,succumb_jealousy_excitement_papaya_earth_uranus,7495213,3,7,267,274,0
3_4753463,succumb_grief_achievement_wurst_earth_uranus,4753463,3,7,221,228,0
3_2754663,succumb_anxiety_rest_marzipan_mercury_saturn,2754663,3,6,306,312,0
2_1431034,fears_anxiety_rest,1431034,2,0,1,1,0
3_1277313,succumb_dread_love_rice_saturn_earth,1277313,3,7,328,335,0
3_3441113,succumb_anger_rest_marzipan_mercury_saturn,3441113,3,6,306,312,0
2_4805298,fears_anger_rest,4805298,2,0,1,1,0
3_505963,feast_rest_onion_marzipan_bavaria_guanabara,505963,3,7,311,318,0
3_4597313,feast_excitement_mutton_ham_bavaria_guanabara,4597313,3,6,393,399,0
2_3509029,craves_excitement_mutton,3509029,2,0,6,6,0
3_6075113,feast_love_marzipan_cherry_guanabara_bosnia,6075113,3,7,368,375,0
3_3091963,feast_intoxication_onion_marzipan_bosnia_alsace,3091963,3,6,382,388,0
2_193139,craves_intoxication_onion,193139,2,0,13,13,0
4_945217,craves_intoxication_marzipan,945217,4,5,26,31,0
3_4381063,feast_intoxication_mutton_marzipan_bavaria_guanabara,4381063,3,7,237,244,0
3_7183713,feast_love_shrimp_potato_goias_bavaria,7183713,3,7,559,566,0
4_7726461,craves_love_potato,7726461,4,4,51,55,0
3_7375013,overcome_boils_love_onion_saturn_earth,7375013,3,9,589,598,0
4_1497644,fears_boils_love,1497644,4,4,49,53,0
3_4024713,overcome_boils_love_onion_earth_uranus,4024713,3,9,593,602,0
3_3864913,overcome_boils_satisfaction_onion_mercury_saturn,3864913,3,9,450,459,0
3_5406713,overcome_boils-1_satisfaction_potato_mercury_saturn,5406713,3,8,337,345,0
2_6862421,craves_boils-1_potato,6862421,2,0,6,6,0
3_2403813,overcome_loneliness-3_love_mutton_saturn_earth,2403813,3,9,580,589,0
3_6220063,overcome_hangover_love_rice_earth_uranus,6220063,3,9,466,475,0
3_5789063,overcome_laceration_excitement_marzipan_earth_uranus,5789063,3,8,472,480,0
2_2289980,craves_laceration_marzipan,2289980,2,0,12,12,0
3_6916063,overcome_loneliness_rest_shrimp_mercury_saturn,6916063,3,9,489,498,0
3_6216214,noop_craves_lubricity_rice,6216214,3,1,409,410,0
3_5809964,noop_fears_abrasion_rest,5809964,3,1,295,296,0
3_7924264,noop_fears_anger_achievement,7924264,3,1,259,260,0
3_6505114,succumb_dread_excitement_cherry_earth_uranus,6505114,3,7,247,254,0
4_6920541,craves_dread_cherry,6920541,4,1,44,45,0
3_7346914,succumb_laceration_satiety_onion_mercury_saturn,7346914,3,7,303,310,0
4_4177385,craves_laceration_onion,4177385,4,1,47,48,0
3_5879414,succumb_anger_satiety_haroset_mercury_saturn,5879414,3,7,306,313,0
4_6590502,craves_anger_haroset,6590502,4,2,6,8,0
3_1256214,feast_rest_cherry_marzipan_goias_bavaria,1256214,3,7,465,472,0
3_5600664,feast_satisfaction_onion_ham_bavaria_guanabara,5600664,3,7,272,279,0
3_6835414,feast_rest_rice_cherry_bosnia_alsace,6835414,3,7,750,757,0
3_2508814,feast_satiety_endive_wurst_bavaria_guanabara,2508814,3,7,256,263,0
3_1381564,feast_love_ham_onion_bavaria_guanabara,1381564,3,7,616,623,0
3_7725414,feast_love_shrimp_turkey_bosnia_alsace,7725414,3,7,693,700,0
3_5418814,overcome_boils_love_shrimp_earth_uranus,5418814,3,9,450,459,0
3_4754714,overcome_abrasion-4_rest_mutton_mercury_saturn,4754714,3,9,284,293,0
3_3407214,overcome_abrasion-4_satiety_mutton_mercury_saturn,3407214,3,9,534,543,0
3_5431864,overcome_abrasion-4_satisfaction_onion_mercury_saturn,5431864,3,9,458,467,0
4_3945910,fears_abrasion-4_satisfaction,3945910,4,3,48,51,0
3_2080364,overcome_boils-1_lubricity_potato_mercury_saturn,2080364,3,9,433,442,0
3_1637664,overcome_depression_love_wurst_saturn_earth,1637664,3,9,490,499,0
3_3968464,overcome_hangover_achievement_rice_mercury_saturn,3968464,3,9,425,434,0
3_6036864,overcome_dread_excitement_rice_earth_uranus,6036864,3,9,239,248,0
3_7012364,overcome_jealousy_rest_rice_mercury_saturn,7012364,3,9,446,455,0
4_479162,fears_jealousy_rest,479162,4,3,65,68,0
3_46414,overcome_jealousy_lubricity_marzipan_saturn_earth,46414,3,9,564,573,0
3_741464,overcome_laceration_excitement_rice_saturn_earth,741464,3,9,463,472,0
3_3065364,overcome_grief_excitement_wurst_earth_uranus,3065364,3,9,409,418,0
3_6415664,overcome_grief_excitement_wurst_saturn_earth,6415664,3,9,422,431,0
3_2178515,noop_locale_papaya_bavaria,2178515,3,1,317,318,0
4_5711881,pain_prostatitis,5711881,4,1,0,1,0
4_7775927,eats_potato_yogurt,7775927,4,1,0,1,0
4_6773576,food_potato,6773576,4,1,0,1,0
4_6432009,food_arugula,6432009,4,1,0,1,0
3_5490115,succumb_loneliness_satisfaction_onion_mercury_saturn,5490115,3,7,232,239,0
4_7320002,craves_loneliness_onion,7320002,4,1,39,40,0
3_3303115,feast_rest_rice_marzipan_guanabara_bosnia,3303115,3,7,436,443,0
3_5460315,feast_satiety_ham_wonderbread_bavaria_guanabara,5460315,3,7,567,574,0
4_4901882,craves_satiety_wonderbread,4901882,4,2,43,45,0
3_7611715,feast_satiety_ham_wonderbread_goias_bavaria,7611715,3,7,337,344,0
3_3952265,feast_lubricity_rice_papaya_bosnia_alsace,3952265,3,7,783,790,0
3_7041815,feast_satiety_endive_cherry_bavaria_guanabara,7041815,3,7,256,263,0
3_173715,feast_satisfaction_shrimp_turkey_goias_bavaria,173715,3,7,277,284,0
3_3580365,feast_satiety_shrimp_onion_guanabara_bosnia,3580365,3,7,399,406,0
3_2307865,feast_rest_marzipan_haroset_guanabara_bosnia,2307865,3,7,358,365,0
3_1325215,feast_satisfaction_marzipan_onion_bosnia_alsace,1325215,3,7,347,354,0
3_5811665,feast_achievement_papaya_rice_bosnia_alsace,5811665,3,7,445,452,0
3_4971815,feast_achievement_papaya_rice_bavaria_guanabara,4971815,3,7,291,298,0
3_2270265,feast_achievement_papaya_rice_guanabara_bosnia,2270265,3,7,291,298,0
3_50365,overcome_boils_love_turkey_earth_uranus,50365,3,9,641,650,0
3_3023215,overcome_hangover_achievement_papaya_saturn_earth,3023215,3,9,304,313,0
3_3273365,overcome_jealousy_achievement_cherry_saturn_earth,3273365,3,9,495,504,0
3_1493315,overcome_laceration_love_marzipan_saturn_earth,1493315,3,9,522,531,0
4_2778149,eats_wonderbread_arugula,2778149,4,1,0,1,0
4_7806391,eats_onion_shrimp,7806391,4,1,0,1,0
4_4444941,attacks_goias_bavaria,4444941,4,1,0,1,0
4_4864341,pleasure_satisfaction,4864341,4,1,0,1,0
4_1243086,pleasure_entertainment,1243086,4,1,0,1,0
4_7395882,eats_potato_arugula,7395882,4,1,0,1,0
4_6951528,eats_marzipan_rice,6951528,4,1,0,1,0
3_5636866,noop_locale_potato_goias,5636866,3,0,65,65,0
2_3491505,locale_potato_goias,3491505,2,0,0,0,0
4_1833554,eats_yogurt_wonderbread,1833554,4,1,0,1,0
3_5878466,feast_lubricity_rice_marzipan_goias_bavaria,5878466,3,7,491,498,0
3_152866,feast_achievement_onion_ham_guanabara_bosnia,152866,3,7,428,435,0
3_7272966,feast_excitement_endive_wurst_goias_bavaria,7272966,3,7,489,496,0
3_854666,overcome_boils-1_lubricity_potato_saturn_earth,854666,3,9,433,442,0
3_4254416,overcome_anxiety_love_marzipan_mercury_saturn,4254416,3,9,320,329,0
3_450716,overcome_loneliness-3_excitement_mutton_earth_uranus,450716,3,9,592,601,0
4_3444900,fears_loneliness-3_excitement,3444900,4,2,2,4,0
3_5114316,overcome_hangover_love_wurst_saturn_earth,5114316,3,9,487,496,0
3_1764016,overcome_hangover_love_wurst_earth_uranus,1764016,3,9,490,499,0
3_6135216,overcome_loneliness_lubricity_shrimp_earth_uranus,6135216,3,9,442,451,0
4_2380884,food_haroset,2380884,4,1,0,1,0
3_2417017,noop_craves_jealousy_papaya,2417017,3,1,325,326,0
3_2214767,succumb_boils_lubricity_shrimp_saturn_earth,2214767,3,7,267,274,0
3_1377167,succumb_laceration_achievement_endive_saturn_earth,1377167,3,7,273,280,0
3_6434917,feast_rest_cherry_endive_goias_bavaria,6434917,3,7,465,472,0
3_1540267,feast_lubricity_rice_papaya_bavaria_guanabara,1540267,3,7,468,475,0
3_4569317,feast_achievement_marzipan_haroset_guanabara_bosnia,4569317,3,7,323,330,0
3_4462517,feast_lubricity_arugula_wonderbread_bavaria_guanabara,4462517,3,7,412,419,0
3_5744267,feast_lubricity_wonderbread_ham_guanabara_bosnia,5744267,3,7,299,306,0
3_6442467,feast_excitement_haroset_turkey_goias_bavaria,6442467,3,7,388,395,0
3_1254367,feast_achievement_rice_marzipan_goias_bavaria,1254367,3,7,317,324,0
3_4124217,overcome_anxiety_excitement_marzipan_saturn_earth,4124217,3,9,265,274,0
3_4803167,overcome_laceration_satisfaction_marzipan_mercury_saturn,4803167,3,9,501,510,0
4_2849830,fears_laceration_satisfaction,2849830,4,1,77,78,0
3_5726617,overcome_loneliness_intoxication_arugula_earth_uranus,5726617,3,9,366,375,0
4_4228691,attacks_bavaria_guanabara,4228691,4,1,0,1,0
3_1079568,noop_craves_boils_turkey,1079568,3,1,295,296,0
4_7991065,eats_mutton_marzipan,7991065,4,1,0,1,0
3_1772368,succumb_abrasion-4_lubricity_ham_earth_uranus,1772368,3,7,337,344,0
3_4378518,succumb_hangover_excitement_rice_saturn_earth,4378518,3,7,231,238,0
3_719918,feast_intoxication_arugula_wonderbread_bavaria_guanabara,719918,3,7,308,315,0
3_1689668,feast_lubricity_rice_cherry_bosnia_alsace,1689668,3,7,783,790,0
3_6597868,feast_lubricity_cherry_endive_bavaria_guanabara,6597868,3,7,468,475,0
3_4384468,feast_intoxication_onion_ham_guanabara_bosnia,4384468,3,7,246,253,0
3_1805768,feast_intoxication_onion_shrimp_bosnia_alsace,1805768,3,7,382,389,0
3_1537568,feast_intoxication_wonderbread_ham_bavaria_guanabara,1537568,3,7,201,208,0
3_5913418,overcome_hangover_achievement_rice_saturn_earth,5913418,3,9,427,436,0
3_7109218,overcome_dread_satiety_rice_mercury_saturn,7109218,3,9,431,440,0
3_4745869,noop_fears_angina_love,4745869,3,1,372,373,0
3_1986619,noop_fears_boils-1_rest,1986619,3,0,312,312,0
2_6009981,fears_boils-1_rest,6009981,2,0,1,1,0
4_1414816,eats_ham_mutton,1414816,4,1,0,1,0
3_1551669,succumb_depression-7_satiety_haroset_mercury_saturn,1551669,3,6,322,328,0
2_166176,fears_depression-7_satiety,166176,2,0,1,1,0
3_1344119,succumb_depression_achievement_wurst_earth_uranus,1344119,3,7,221,228,0
3_2850519,succumb_jealousy_love_papaya_saturn_earth,2850519,3,7,319,326,0
3_3118069,succumb_anger_satiety_rice_mercury_saturn,3118069,3,7,275,282,0
3_7044919,feast_satisfaction_ham_onion_goias_bavaria,7044919,3,7,213,220,0
3_3501669,feast_intoxication_mutton_ham_bavaria_guanabara,3501669,3,7,237,244,0
3_7521319,feast_achievement_papaya_wurst_goias_bavaria,7521319,3,7,526,533,0
3_1028319,feast_satiety_onion_ham_bavaria_guanabara,1028319,3,7,337,344,0
3_5129769,overcome_boils_intoxication_potato_mercury_saturn,5129769,3,9,444,453,0
3_2597569,overcome_angina_excitement_onion_earth_uranus,2597569,3,9,398,407,0
4_2141606,fears_angina_excitement,2141606,4,1,71,72,0
3_6560869,overcome_dread_love_rice_earth_uranus,6560869,3,9,466,475,0
3_6570969,overcome_laceration_achievement_rice_saturn_earth,6570969,3,9,458,467,0
3_6094769,overcome_laceration_lubricity_marzipan_earth_uranus,6094769,3,9,520,529,0
4_5233736,fears_laceration_lubricity,5233736,4,4,51,55,0
3_7819070,noop_fears_prostatitis_love,7819070,3,1,313,314,0
4_3163114,planet_earth,3163114,4,1,0,1,0
3_6551470,noop_craves_rest_rice,6551470,3,1,377,378,0
3_2542770,noop_locale_mutton_goias,2542770,3,0,271,271,0
2_397409,locale_mutton_goias,397409,2,0,0,0,0
3_5746620,noop_fears_loneliness-3_intoxication,5746620,3,1,224,225,0
3_2862470,succumb_grief_achievement_rice_saturn_earth,2862470,3,7,245,252,0
4_2980884,craves_grief_rice,2980884,4,2,43,45,0
3_5481570,succumb_boils-1_intoxication_shrimp_earth_uranus,5481570,3,7,202,209,0
4_4833357,craves_boils-1_shrimp,4833357,4,1,27,28,0
3_1270520,feast_excitement_onion_ham_bavaria_guanabara,1270520,3,7,427,434,0
3_892670,feast_excitement_mutton_ham_goias_bavaria,892670,3,7,393,400,0
3_5297570,feast_lubricity_cherry_endive_bosnia_alsace,5297570,3,7,747,754,0
3_2760620,feast_rest_wonderbread_yogurt_bavaria_guanabara,2760620,3,7,284,291,0
3_2080970,overcome_boils_rest_onion_mercury_saturn,2080970,3,9,515,524,0
3_1915570,overcome_abrasion-4_excitement_mutton_earth_uranus,1915570,3,9,592,601,0
4_4383245,fears_abrasion-4_excitement,4383245,4,2,100,102,0
3_944720,overcome_boils-1_rest_wonderbread_mercury_saturn,944720,3,8,426,434,0
2_108360,craves_boils-1_wonderbread,108360,2,0,4,4,0
3_6149320,overcome_boils-1_intoxication_wonderbread_earth_uranus,6149320,3,9,200,209,0
3_7184170,overcome_anxiety_achievement_marzipan_mercury_saturn,7184170,3,9,266,275,0
3_5942320,overcome_loneliness-3_intoxication_ham_saturn_earth,5942320,3,9,227,236,0
3_2356821,noop_craves_achievement_papaya,2356821,3,1,257,258,0
3_3306021,noop_craves_satisfaction_marzipan,3306021,3,1,247,248,0
4_5021833,eats_onion_ham,5021833,4,1,0,1,0
4_1830183,province_goias,1830183,4,1,0,1,0
4_1473805,food_papaya,1473805,4,1,0,1,0
3_6726571,succumb_dread_excitement_marzipan_earth_uranus,6726571,3,7,247,254,0
4_2809038,craves_dread_marzipan,2809038,4,1,44,45,0
3_686471,succumb_sciatica_intoxication_arugula_saturn_earth,686471,3,7,189,196,0
4_4633263,craves_sciatica_arugula,4633263,4,3,7,10,0
3_5129221,feast_rest_rice_papaya_bavaria_guanabara,5129221,3,7,436,443,0
4_302795,craves_rest_papaya,302795,4,4,75,79,0
3_1442621,feast_lubricity_marzipan_mutton_guanabara_bosnia,1442621,3,7,357,364,0
3_4217621,feast_love_onion_marzipan_bavaria_guanabara,4217621,3,7,390,397,0
3_6601071,feast_satisfaction_shrimp_turkey_bavaria_guanabara,6601071,3,7,232,239,0
3_5198871,feast_satisfaction_wonderbread_arugula_bavaria_guanabara,5198871,3,7,220,227,0
3_1998471,feast_intoxication_mutton_marzipan_goias_bavaria,1998471,3,7,237,244,0
3_1757921,overcome_hangover_lubricity_rice_earth_uranus,1757921,3,9,600,609,0
4_3222479,fears_hangover_lubricity,3222479,4,1,96,97,0
3_7659921,overcome_jealousy_love_papaya_earth_uranus,7659921,3,9,337,346,0
3_179771,overcome_laceration_excitement_rice_mercury_saturn,179771,3,9,463,472,0
3_6830921,overcome_loneliness_satisfaction_yogurt_mercury_saturn,6830921,3,8,233,241,0
2_4642216,craves_loneliness_yogurt,4642216,2,0,6,6,0
3_1487421,overcome_grief_achievement_cherry_saturn_earth,1487421,3,9,237,246,0
4_6280238,pleasure_satiety,6280238,4,1,0,1,0
4_7298434,eats_shrimp_turkey,7298434,4,1,0,1,0
4_7920783,craves_entertainment_wurst,7920783,4,1,0,1,0
4_4439469,eats_ham_wonderbread,4439469,4,1,0,1,0
4_5423156,food_endive,5423156,4,1,0,1,0
3_797622,noop_craves_loneliness-3_mutton,797622,3,1,276,277,0
4_7894655,eats_arugula_wonderbread,7894655,4,1,0,1,0
3_7209022,succumb_anxiety_satiety_cherry_mercury_saturn,7209022,3,7,275,282,0
4_4259030,craves_anxiety_cherry,4259030,4,3,12,15,0
3_757472,succumb_dread_excitement_rice_saturn_earth,757472,3,7,231,238,0
3_2449822,succumb_jealousy_love_wurst_earth_uranus,2449822,3,7,312,319,0
4_2788630,craves_jealousy_wurst,2788630,4,1,45,46,0
3_5383672,succumb_anger_love_cherry_earth_uranus,5383672,3,7,321,328,0
4_3851168,craves_anger_cherry,3851168,4,3,12,15,0
3_6626722,succumb_sciatica_satisfaction_wonderbread_mercury_saturn,6626722,3,7,214,221,0
3_7080972,feast_satiety_rice_papaya_goias_bavaria,7080972,3,7,310,317,0
3_7270672,feast_satisfaction_yogurt_wonderbread_goias_bavaria,7270672,3,7,222,229,0
3_3280522,feast_rest_cherry_endive_guanabara_bosnia,3280522,3,7,436,443,0
3_2801022,feast_lubricity_marzipan_rice_guanabara_bosnia,2801022,3,7,357,364,0
3_975722,feast_achievement_marzipan_mutton_guanabara_bosnia,975722,3,7,323,330,0
3_2444222,feast_love_marzipan_rice_guanabara_bosnia,2444222,3,7,368,375,0
3_2363172,feast_achievement_mutton_marzipan_goias_bavaria,2363172,3,7,394,401,0
3_2159872,feast_love_shrimp_turkey_bavaria_guanabara,2159872,3,7,452,459,0
3_1026372,overcome_abrasion-4_satisfaction_wonderbread_mercury_saturn,1026372,3,9,447,456,0
3_997422,overcome_abrasion-4_lubricity_onion_mercury_saturn,997422,3,9,514,523,0
3_6979322,overcome_boils-1_rest_potato_mercury_saturn,6979322,3,9,435,444,0
3_2339572,overcome_jealousy-2_lubricity_wonderbread_earth_uranus,2339572,3,9,289,298,0
4_4050538,fears_jealousy-2_lubricity,4050538,4,1,50,51,0
3_2537672,overcome_loneliness-3_satiety_onion_mercury_saturn,2537672,3,9,527,536,0
4_4057049,fears_loneliness-3_satiety,4057049,4,3,51,54,0
3_2672372,overcome_depression_excitement_wurst_earth_uranus,2672372,3,9,409,418,0
3_6022672,overcome_depression_excitement_wurst_saturn_earth,6022672,3,9,422,431,0
3_1508672,overcome_depression_achievement_cherry_saturn_earth,1508672,3,9,237,246,0
3_5860172,overcome_anger_lubricity_marzipan_saturn_earth,5860172,3,9,300,309,0
3_439172,overcome_grief_love_endive_saturn_earth,439172,3,9,349,358,0
3_6708022,overcome_grief_excitement_cherry_earth_uranus,6708022,3,9,423,432,0
4_6276535,eats_rice_marzipan,6276535,4,1,0,1,0
3_3204723,noop_fears_jealousy-2_satisfaction,3204723,3,0,201,201,0
2_2412073,fears_jealousy-2_satisfaction,2412073,2,0,1,1,0
3_1756423,noop_locale_onion_guanabara,1756423,3,1,75,76,0
3_4727123,noop_craves_lubricity_mutton,4727123,3,1,291,292,0
3_5858173,succumb_anxiety_love_cherry_saturn_earth,5858173,3,7,321,328,0
3_2507873,succumb_anxiety_love_cherry_earth_uranus,2507873,3,7,321,328,0
3_4190873,succumb_boils_lubricity_ham_earth_uranus,4190873,3,7,306,313,0
4_7185198,craves_boils_ham,7185198,4,1,52,53,0
3_7011323,succumb_abrasion_intoxication_yogurt_earth_uranus,7011323,3,7,193,200,0
3_2141173,succumb_sciatica_intoxication_yogurt_earth_uranus,2141173,3,7,189,196,0
4_4108439,craves_sciatica_yogurt,4108439,4,2,7,9,0
3_5971223,succumb_angina_rest_shrimp_mercury_saturn,5971223,3,7,318,325,0
3_5796473,succumb_grief_love_endive_earth_uranus,5796473,3,7,395,402,0
3_2865473,succumb_depression_achievement_endive_earth_uranus,2865473,3,7,223,230,0
3_7863773,feast_satiety_papaya_rice_goias_bavaria,7863773,3,7,530,537,0
3_6987273,feast_rest_potato_shrimp_bavaria_guanabara,6987273,3,7,303,310,0
3_7365323,feast_excitement_mutton_marzipan_bavaria_guanabara,7365323,3,7,393,400,0
3_2961173,feast_lubricity_cherry_marzipan_bosnia_alsace,2961173,3,7,747,754,0
3_754823,feast_rest_yogurt_potato_goias_bavaria,754823,3,7,412,419,0
3_6883323,feast_satisfaction_marzipan_cherry_guanabara_bosnia,6883323,3,7,347,354,0
3_6887223,feast_intoxication_onion_shrimp_bavaria_guanabara,6887223,3,7,246,253,0
3_7486223,feast_love_endive_wurst_goias_bavaria,7486223,3,7,540,547,0
3_4646573,feast_excitement_endive_cherry_bavaria_guanabara,4646573,3,7,290,297,0
3_2040923,overcome_loneliness-3_intoxication_wonderbread_saturn_earth,2040923,3,9,425,434,0
3_6369923,overcome_hangover_satiety_wurst_mercury_saturn,6369923,3,9,450,459,0
3_2655423,overcome_laceration_rest_rice_mercury_saturn,2655423,3,9,624,633,0
4_7241912,fears_laceration_rest,7241912,4,3,65,68,0
4_4692999,attacks_alsace_surrey,4692999,4,1,0,1,0
4_7762749,eats_endive_wurst,7762749,4,1,0,1,0
3_6243624,noop_fears_anxiety_lubricity,6243624,3,1,308,309,0
3_4362024,noop_craves_satiety_ham,4362024,3,1,305,306,0
3_4405624,noop_craves_achievement_haroset,4405624,3,1,366,367,0
3_2268024,noop_fears_boils_intoxication,2268024,3,1,224,225,0
3_2958824,succumb_boils_satisfaction_potato_mercury_saturn,2958824,3,7,257,264,0
3_6222824,succumb_anxiety_excitement_marzipan_earth_uranus,6222824,3,6,280,286,0
2_1312777,fears_anxiety_excitement,1312777,2,0,1,1,0
3_1730674,succumb_loneliness_intoxication_potato_saturn_earth,1730674,3,7,218,225,0
3_52324,feast_rest_cherry_rice_goias_bavaria,52324,3,7,465,472,0
3_5349174,feast_rest_rice_marzipan_bavaria_guanabara,5349174,3,7,436,443,0
3_445874,feast_lubricity_mutton_ham_goias_bavaria,445874,3,7,323,330,0
3_5562674,feast_excitement_onion_marzipan_guanabara_bosnia,5562674,3,7,427,434,0
3_1962574,feast_love_ham_mutton_goias_bavaria,1962574,3,7,390,397,0
3_5425724,feast_satiety_cherry_endive_goias_bavaria,5425724,3,7,279,286,0
3_4920424,feast_rest_turkey_shrimp_goias_bavaria,4920424,3,7,382,389,0
3_4015224,feast_satiety_marzipan_rice_guanabara_bosnia,4015224,3,7,314,321,0
3_6001224,overcome_abrasion-4_intoxication_wonderbread_earth_uranus,6001224,3,9,424,433,0
3_4086074,overcome_prostatitis_love_wurst_saturn_earth,4086074,3,9,311,320,0
3_3314474,overcome_jealousy_excitement_cherry_saturn_earth,3314474,3,9,497,506,0
3_3284124,overcome_laceration_love_rice_saturn_earth,3284124,3,9,509,518,0
3_4221624,overcome_loneliness_lubricity_yogurt_earth_uranus,4221624,3,9,460,469,0
3_7571924,overcome_loneliness_lubricity_yogurt_saturn_earth,7571924,3,9,458,467,0
3_5102674,overcome_loneliness_lubricity_potato_mercury_saturn,5102674,3,9,307,316,0
3_2665525,noop_craves_dread_wurst,2665525,3,1,232,233,0
3_5497475,noop_locale_haroset_bavaria,5497475,3,1,30,31,0
4_4452600,pain_depression-7,4452600,4,1,0,1,0
3_6106075,succumb_angina_lubricity_marzipan_earth_uranus,6106075,3,7,288,295,0
3_2506925,succumb_jealousy-2_rest_arugula_mercury_saturn,2506925,3,7,297,304,0
4_7911918,craves_jealousy-2_arugula,7911918,4,3,7,10,0
3_2163825,succumb_laceration_love_marzipan_saturn_earth,2163825,3,7,348,355,0
3_1789075,succumb_anger_love_rice_saturn_earth,1789075,3,7,321,328,0
3_4818375,feast_satiety_rice_cherry_goias_bavaria,4818375,3,7,310,317,0
3_4317975,feast_satisfaction_yogurt_potato_goias_bavaria,4317975,3,7,222,229,0
3_5667925,feast_excitement_cherry_endive_goias_bavaria,5667925,3,7,320,327,0
3_1362775,feast_rest_shrimp_potato_goias_bavaria,1362775,3,7,451,458,0
3_5721025,feast_achievement_cherry_marzipan_goias_bavaria,5721025,3,7,287,294,0
3_1688875,feast_rest_cherry_rice_guanabara_bosnia,1688875,3,7,436,443,0
3_4715375,feast_intoxication_shrimp_turkey_goias_bavaria,4715375,3,7,333,340,0
3_6860625,feast_satiety_cherry_marzipan_goias_bavaria,6860625,3,7,279,286,0
3_5334275,feast_love_haroset_marzipan_goias_bavaria,5334275,3,7,349,356,0
3_5691075,feast_lubricity_haroset_marzipan_goias_bavaria,5691075,3,7,291,298,0
3_2289875,feast_rest_arugula_wonderbread_bavaria_guanabara,2289875,3,7,429,436,0
3_4877175,overcome_boils_rest_potato_mercury_saturn,4877175,3,9,533,542,0
3_4142325,overcome_laceration-8_lubricity_haroset_saturn_earth,4142325,3,9,279,288,0
3_2207425,overcome_loneliness-3_intoxication_onion_earth_uranus,2207425,3,9,428,437,0
3_1944225,overcome_depression_achievement_wurst_saturn_earth,1944225,3,9,237,246,0
3_7798075,overcome_angina_lubricity_onion_mercury_saturn,7798075,3,9,288,297,0
3_270525,overcome_jealousy_rest_cherry_mercury_saturn,270525,3,9,669,678,0
3_2652325,overcome_laceration_rest_cherry_mercury_saturn,2652325,3,9,449,458,0
3_236576,noop_locale_wonderbread_guanabara,236576,3,1,39,40,0
3_818876,noop_craves_boils-1_wonderbread,818876,3,1,183,184,0
4_6843000,pain_abrasion-4,6843000,4,1,0,1,0
3_2280476,succumb_jealousy-2_rest_yogurt_mercury_saturn,2280476,3,7,297,304,0
4_3652439,craves_jealousy-2_yogurt,3652439,4,2,7,9,0
3_7776076,succumb_laceration_love_rice_earth_uranus,7776076,3,7,348,355,0
3_1546376,succumb_laceration_satiety_haroset_mercury_saturn,1546376,3,7,303,310,0
4_7814663,craves_laceration_haroset,7814663,4,1,47,48,0
3_168876,succumb_depression_satiety_cherry_mercury_saturn,168876,3,7,285,292,0
3_6333876,feast_rest_rice_papaya_guanabara_bosnia,6333876,3,7,436,443,0
3_7731776,feast_rest_potato_arugula_guanabara_bosnia,7731776,3,7,511,518,0
3_2524776,feast_satisfaction_marzipan_haroset_alsace_surrey,2524776,3,7,587,594,0
3_5703226,feast_satisfaction_marzipan_mutton_alsace_surrey,5703226,3,7,587,594,0
3_3164776,feast_intoxication_onion_ham_bosnia_alsace,3164776,3,7,382,389,0
3_1207726,feast_excitement_haroset_marzipan_goias_bavaria,1207726,3,7,388,395,0
3_5093126,overcome_boils_satisfaction_turkey_mercury_saturn,5093126,3,9,460,469,0
3_8000626,overcome_loneliness-3_achievement_onion_saturn_earth,8000626,3,9,586,595,0
3_3038826,overcome_depression_love_cherry_saturn_earth,3038826,3,9,480,489,0
3_4250926,overcome_hangover_love_rice_mercury_saturn,4250926,3,9,461,470,0
3_4894876,overcome_anger_achievement_marzipan_mercury_saturn,4894876,3,9,266,275,0
3_5956476,overcome_dread_entertainment_wurst_earth_uranus,5956476,3,9,244,253,0
4_5623675,fears_dread_entertainment,5623675,4,2,44,46,0
3_531226,overcome_laceration_achievement_marzipan_mercury_saturn,531226,3,9,453,462,0
3_6340627,noop_craves_jealousy_cherry,6340627,3,1,318,319,0
3_3433327,noop_craves_laceration_rice,3433327,3,1,269,270,0
3_5865527,noop_locale_ham_goias,5865527,3,0,39,39,0
2_157616,locale_ham_goias,157616,2,0,0,0,0
3_4998627,noop_craves_grief_cherry,4998627,3,1,218,219,0
3_6468077,noop_craves_abrasion-4_mutton,6468077,3,1,276,277,0
3_2776677,succumb_jealousy_excitement_marzipan_earth_uranus,2776677,3,7,283,290,0
3_4890027,succumb_grief_achievement_wurst_mercury_saturn,4890027,3,7,229,236,0
3_5882477,succumb_anger_love_onion_earth_uranus,5882477,3,7,352,359,0
4_6523478,craves_anger_onion,6523478,4,2,13,15,0
3_4206177,succumb_depression-7_love_haroset_earth_uranus,4206177,3,7,374,381,0
3_6905277,feast_satiety_haroset_marzipan_goias_bavaria,6905277,3,7,296,303,0
3_6550127,feast_rest_cherry_marzipan_bosnia_alsace,6550127,3,7,717,724,0
3_4925927,feast_satisfaction_shrimp_potato_goias_bavaria,4925927,3,7,277,284,0
3_6707327,feast_satisfaction_shrimp_potato_bavaria_guanabara,6707327,3,7,232,239,0
3_3487577,feast_lubricity_cherry_rice_guanabara_bosnia,3487577,3,7,468,475,0
3_4937327,overcome_boils_intoxication_potato_earth_uranus,4937327,3,9,442,451,0
3_1460727,overcome_boils-1_satisfaction_wonderbread_mercury_saturn,1460727,3,9,355,364,0
3_5603327,overcome_grief_love_wurst_earth_uranus,5603327,3,9,494,503,0
4_5370277,food_wurst,5370277,4,1,0,1,0
3_3837028,noop_craves_love_ham,3837028,3,1,358,359,0
4_4744512,food_shrimp,4744512,4,1,0,1,0
4_918250,pain_boils,918250,4,1,0,1,0
3_3567978,succumb_boils-1_intoxication_yogurt_earth_uranus,3567978,3,7,190,197,0
4_2391589,craves_boils-1_yogurt,2391589,4,1,28,29,0
3_6942928,succumb_jealousy-2_intoxication_arugula_saturn_earth,6942928,3,7,189,196,0
3_3592628,succumb_jealousy-2_intoxication_arugula_earth_uranus,3592628,3,7,189,196,0
3_4164178,succumb_hangover_excitement_wurst_saturn_earth,4164178,3,7,231,238,0
3_6918728,succumb_anger_satiety_cherry_mercury_saturn,6918728,3,7,275,282,0
3_4254878,feast_love_cherry_endive_goias_bavaria,4254878,3,7,365,372,0
3_560928,feast_excitement_marzipan_mutton_guanabara_bosnia,560928,3,7,322,329,0
3_431728,feast_satisfaction_arugula_wonderbread_guanabara_bosnia,431728,3,7,198,205,0
3_2823528,feast_satisfaction_haroset_turkey_goias_bavaria,2823528,3,7,251,258,0
3_903528,feast_rest_mutton_ham_goias_bavaria,903528,3,7,279,286,0
3_4790828,feast_satisfaction_marzipan_onion_guanabara_bosnia,4790828,3,7,347,354,0
3_5668628,feast_satiety_marzipan_mutton_guanabara_bosnia,5668628,3,7,314,321,0
3_7735928,feast_achievement_rice_papaya_goias_bavaria,7735928,3,7,317,324,0
3_2266128,feast_love_shrimp_potato_bavaria_guanabara,2266128,3,7,452,459,0
3_2058678,overcome_boils-1_intoxication_potato_earth_uranus,2058678,3,9,200,209,0
3_112778,overcome_hangover_achievement_wurst_mercury_saturn,112778,3,9,426,435,0
3_405478,overcome_laceration_rest_marzipan_mercury_saturn,405478,3,9,521,530,0
3_3968678,overcome_laceration_achievement_rice_mercury_saturn,3968678,3,9,457,466,0
4_4074641,eats_shrimp_potato,4074641,4,1,0,1,0
4_1737877,attacks_bosnia_alsace,1737877,4,1,0,1,0
4_778475,pain_hangover,778475,4,1,0,1,0
4_1840068,food_wonderbread,1840068,4,1,0,1,0
3_2152429,succumb_loneliness_satisfaction_wonderbread_mercury_saturn,2152429,3,7,218,225,0
4_1850383,craves_loneliness_wonderbread,1850383,4,1,43,44,0
3_2425929,succumb_grief_achievement_cherry_mercury_saturn,2425929,3,7,229,236,0
3_6136629,feast_satiety_ham_onion_goias_bavaria,6136629,3,7,337,344,0
3_6659329,feast_lubricity_rice_papaya_goias_bavaria,6659329,3,7,491,498,0
3_349629,feast_love_marzipan_onion_guanabara_bosnia,349629,3,7,368,375,0
3_3607229,feast_lubricity_onion_ham_bavaria_guanabara,3607229,3,7,322,329,0
3_1592029,feast_excitement_papaya_wurst_goias_bavaria,1592029,3,7,419,426,0
3_7489029,feast_excitement_endive_wurst_guanabara_bosnia,7489029,3,7,290,297,0
3_5201279,feast_achievement_endive_wurst_goias_bavaria,5201279,3,7,387,394,0
3_2745379,feast_love_shrimp_onion_bavaria_guanabara,2745379,3,7,452,459,0
3_7841129,overcome_boils_satiety_shrimp_mercury_saturn,7841129,3,9,398,407,0
3_5911679,overcome_abrasion-4_lubricity_wonderbread_earth_uranus,5911679,3,9,514,523,0
3_7611429,overcome_abrasion_intoxication_yogurt_saturn_earth,7611429,3,9,189,198,0
3_264179,overcome_angina_achievement_onion_saturn_earth,264179,3,9,399,408,0
4_6277678,fears_angina_achievement,6277678,4,1,71,72,0
3_3643029,overcome_dread_rest_rice_mercury_saturn,3643029,3,9,568,577,0
4_4799851,fears_dread_rest,4799851,4,1,97,98,0
3_7598529,overcome_laceration_love_rice_mercury_saturn,7598529,3,9,514,523,0
3_1413479,overcome_laceration_achievement_endive_saturn_earth,1413479,3,9,460,469,0
3_3121130,noop_fears_laceration-8_love,3121130,3,0,365,365,0
2_7530995,fears_laceration-8_love,7530995,2,0,1,1,0
4_2200903,pleasure_love,2200903,4,1,0,1,0
3_208680,noop_fears_angina_satisfaction,208680,3,0,224,224,0
2_1831103,fears_angina_satisfaction,1831103,2,0,1,1,0
3_4355430,succumb_anxiety_love_haroset_earth_uranus,4355430,3,7,352,359,0
3_761530,succumb_laceration_love_endive_earth_uranus,761530,3,7,364,371,0
3_282030,succumb_laceration_excitement_cherry_earth_uranus,282030,3,6,306,312,0
2_6026007,fears_laceration_excitement,6026007,2,0,1,1,0
3_6170330,succumb_laceration_achievement_cherry_mercury_saturn,6170330,3,7,273,280,0
3_433380,succumb_loneliness-3_rest_arugula_mercury_saturn,433380,3,7,294,301,0
4_1635976,craves_loneliness-3_arugula,1635976,4,1,59,60,0
3_7646830,feast_excitement_onion_shrimp_bosnia_alsace,7646830,3,7,524,531,0
3_6207880,feast_lubricity_wonderbread_ham_bavaria_guanabara,6207880,3,7,299,306,0
3_7201930,feast_satisfaction_arugula_potato_guanabara_bosnia,7201930,3,7,198,205,0
3_4906330,feast_achievement_onion_ham_bosnia_alsace,4906330,3,7,525,532,0
3_492580,feast_satisfaction_marzipan_rice_guanabara_bosnia,492580,3,7,347,354,0
3_6762830,feast_excitement_rice_cherry_goias_bavaria,6762830,3,7,280,287,0
3_7555780,feast_intoxication_wonderbread_arugula_bavaria_guanabara,7555780,3,7,201,208,0
3_1164130,overcome_abrasion-4_intoxication_onion_earth_uranus,1164130,3,9,428,437,0
3_3748730,overcome_anxiety_satisfaction_marzipan_mercury_saturn,3748730,3,9,291,300,0
4_2326612,fears_anxiety_satisfaction,2326612,4,1,53,54,0
3_5043330,overcome_laceration_love_endive_saturn_earth,5043330,3,9,536,545,0
3_1693030,overcome_laceration_love_endive_earth_uranus,1693030,3,9,539,548,0
3_7031780,overcome_laceration_lubricity_cherry_earth_uranus,7031780,3,9,480,489,0
3_7279180,overcome_loneliness_satisfaction_arugula_mercury_saturn,7279180,3,9,233,242,0
3_2933531,noop_craves_loneliness-3_wonderbread,2933531,3,1,268,269,0
4_5397415,food_cherry,5397415,4,1,0,1,0
4_3412554,food_marzipan,3412554,4,1,0,1,0
3_5683581,succumb_boils-1_rest_arugula_mercury_saturn,5683581,3,7,324,331,0
3_3911231,feast_satiety_turkey_shrimp_goias_bavaria,3911231,3,7,343,350,0
3_5025831,feast_satisfaction_onion_marzipan_bavaria_guanabara,5025831,3,7,272,279,0
3_6370381,feast_love_onion_shrimp_bavaria_guanabara,6370381,3,7,390,397,0
3_4316381,feast_satiety_shrimp_onion_bavaria_guanabara,4316381,3,7,399,406,0
3_7570631,feast_satisfaction_marzipan_haroset_bosnia_alsace,7570631,3,7,347,354,0
3_2413181,feast_satisfaction_marzipan_rice_bosnia_alsace,2413181,3,7,347,354,0
3_6727181,feast_lubricity_onion_shrimp_bavaria_guanabara,6727181,3,7,322,329,0
3_5473331,feast_achievement_rice_cherry_goias_bavaria,5473331,3,7,317,324,0
3_6477731,overcome_abrasion-4_excitement_onion_earth_uranus,6477731,3,9,585,594,0
3_882181,overcome_loneliness-3_lubricity_onion_earth_uranus,882181,3,9,507,516,0
3_4232481,overcome_loneliness-3_lubricity_onion_saturn_earth,4232481,3,9,514,523,0
3_5874531,overcome_depression_rest_cherry_mercury_saturn,5874531,3,9,565,574,0
4_3174444,fears_depression_rest,3174444,4,1,99,100,0
3_6582681,overcome_jealousy_achievement_cherry_mercury_saturn,6582681,3,9,508,517,0
3_4164631,overcome_laceration_satiety_marzipan_mercury_saturn,4164631,3,9,288,297,0
3_5650231,overcome_loneliness_intoxication_shrimp_earth_uranus,5650231,3,9,368,377,0
3_4254781,overcome_grief_lubricity_cherry_earth_uranus,4254781,3,9,597,606,0
4_1606144,fears_grief_lubricity,1606144,4,1,95,96,0
3_2512232,noop_fears_anger_rest,2512232,3,1,287,288,0
4_7414097,eats_wonderbread_yogurt,7414097,4,1,0,1,0
4_7203479,eats_marzipan_cherry,7203479,4,1,0,1,0
3_3895632,noop_fears_laceration_excitement,3895632,3,1,287,288,0
3_2950032,succumb_sciatica_rest_yogurt_mercury_saturn,2950032,3,7,297,304,0
3_4240782,succumb_boils_lubricity_potato_saturn_earth,4240782,3,7,284,291,0
3_3960332,succumb_laceration-8_satiety_haroset_mercury_saturn,3960332,3,7,322,329,0
3_641732,succumb_jealousy-2_satisfaction_wonderbread_mercury_saturn,641732,3,7,214,221,0
3_5335632,succumb_depression_achievement_marzipan_saturn_earth,5335632,3,7,245,252,0
4_277606,craves_depression_marzipan,277606,4,2,40,42,0
3_1985332,succumb_depression_achievement_marzipan_earth_uranus,1985332,3,7,246,253,0
3_1310132,succumb_abrasion-4_rest_arugula_mercury_saturn,1310132,3,7,294,301,0
4_4587667,craves_abrasion-4_arugula,4587667,4,1,59,60,0
3_3180382,succumb_anger_lubricity_marzipan_earth_uranus,3180382,3,7,330,337,0
3_2482532,succumb_grief_satiety_wurst_mercury_saturn,2482532,3,7,285,292,0
3_102332,feast_satiety_ham_mutton_goias_bavaria,102332,3,7,337,344,0
3_3679682,feast_lubricity_marzipan_onion_guanabara_bosnia,3679682,3,7,357,364,0
3_4396732,feast_lubricity_rice_cherry_goias_bavaria,4396732,3,7,491,498,0
3_2243832,feast_excitement_onion_shrimp_bavaria_guanabara,2243832,3,7,427,434,0
3_353582,feast_satiety_shrimp_potato_goias_bavaria,353582,3,7,507,514,0
4_6242386,craves_satiety_potato,6242386,4,4,49,53,0
3_1379482,feast_satisfaction_wonderbread_ham_bavaria_guanabara,1379482,3,7,220,227,0
3_1821982,overcome_boils_lubricity_potato_earth_uranus,1821982,3,9,301,310,0
3_1168032,overcome_loneliness-3_satiety_ham_mercury_saturn,1168032,3,9,356,365,0
4_5265699,eats_cherry_rice,5265699,4,1,0,1,0
4_7865332,pain_dread,7865332,4,1,0,1,0
3_3335683,noop_fears_anger_excitement,3335683,3,1,258,259,0
4_1795018,eats_endive_cherry,1795018,4,1,0,1,0
4_2216718,eats_potato_shrimp,2216718,4,1,0,1,0
3_3854533,noop_craves_loneliness_yogurt,3854533,3,1,224,225,0
3_500433,noop_fears_anxiety_achievement,500433,3,1,259,260,0
3_7207933,succumb_boils_lubricity_haroset_earth_uranus,7207933,3,7,285,292,0
4_2557270,craves_boils_haroset,2557270,4,1,52,53,0
3_214883,succumb_jealousy_satiety_marzipan_mercury_saturn,214883,3,7,303,310,0
3_6891133,succumb_prostatitis_excitement_wurst_saturn_earth,6891133,3,7,236,243,0
3_7525083,succumb_loneliness-3_rest_marzipan_mercury_saturn,7525083,3,7,283,290,0
4_7778564,craves_loneliness-3_marzipan,7778564,4,1,58,59,0
3_6080533,succumb_grief_achievement_marzipan_earth_uranus,6080533,3,7,246,253,0
3_1408533,succumb_abrasion-4_rest_shrimp_mercury_saturn,1408533,3,7,306,313,0
4_1424403,craves_abrasion-4_shrimp,1424403,4,1,58,59,0
3_4498133,succumb_jealousy_love_cherry_saturn_earth,4498133,3,7,318,325,0
3_346533,succumb_dread_love_papaya_saturn_earth,346533,3,7,328,335,0
3_895283,feast_satiety_shrimp_turkey_bosnia_alsace,895283,3,7,641,648,0
3_3382633,feast_satisfaction_haroset_marzipan_goias_bavaria,3382633,3,7,251,258,0
3_307483,feast_satisfaction_wonderbread_yogurt_bavaria_guanabara,307483,3,7,220,227,0
3_3932533,feast_satisfaction_ham_mutton_bavaria_guanabara,3932533,3,7,447,454,0
3_3231183,feast_satisfaction_marzipan_cherry_alsace_surrey,3231183,3,7,587,594,0
3_7994383,feast_intoxication_turkey_haroset_goias_bavaria,7994383,3,7,235,242,0
4_152225,craves_intoxication_haroset,152225,4,1,31,32,0
3_7941383,feast_satiety_onion_shrimp_bavaria_guanabara,7941383,3,7,337,344,0
3_451983,overcome_boils_intoxication_onion_earth_uranus,451983,3,9,444,453,0
3_6584833,overcome_loneliness-3_love_ham_earth_uranus,6584833,3,9,407,416,0
3_7430733,overcome_loneliness-3_rest_wonderbread_mercury_saturn,7430733,3,9,284,293,0
3_4851083,overcome_loneliness-3_intoxication_mutton_earth_uranus,4851083,3,9,442,451,0
3_26483,overcome_jealousy_excitement_marzipan_earth_uranus,26483,3,9,495,504,0
3_3376783,overcome_jealousy_excitement_marzipan_saturn_earth,3376783,3,9,493,502,0
3_4763733,overcome_jealousy_achievement_marzipan_mercury_saturn,4763733,3,9,514,523,0
4_5428931,eats_cherry_marzipan,5428931,4,1,0,1,0
3_2205884,noop_craves_jealousy_marzipan,2205884,3,1,315,316,0
3_1107284,noop_harmony_intoxication_saturn,1107284,3,1,138,139,0
3_783834,noop_craves_rest_haroset,783834,3,1,379,380,0
3_5094034,succumb_loneliness_satisfaction_turkey_mercury_saturn,5094034,3,7,232,239,0
4_4335864,craves_loneliness_turkey,4335864,4,1,45,46,0
3_5289734,succumb_dread_excitement_wurst_saturn_earth,5289734,3,7,231,238,0
3_958484,succumb_loneliness_lubricity_potato_saturn_earth,958484,3,7,307,314,0
3_4647334,succumb_jealousy_achievement_rice_saturn_earth,4647334,3,6,305,311,0
2_3042878,fears_jealousy_achievement,3042878,2,0,1,1,0
3_1097034,feast_rest_rice_papaya_bosnia_alsace,1097034,3,7,750,757,0
3_3052034,feast_rest_rice_cherry_guanabara_bosnia,3052034,3,7,436,443,0
3_2310384,feast_lubricity_mutton_marzipan_goias_bavaria,2310384,3,7,323,330,0
3_7725934,feast_excitement_onion_marzipan_bavaria_guanabara,7725934,3,7,427,434,0
3_4287534,feast_satiety_shrimp_turkey_bavaria_guanabara,4287534,3,7,399,406,0
3_1341934,feast_rest_marzipan_mutton_guanabara_bosnia,1341934,3,7,358,365,0
3_4251634,feast_achievement_onion_marzipan_guanabara_bosnia,4251634,3,7,428,435,0
3_4565584,feast_lubricity_cherry_rice_bavaria_guanabara,4565584,3,7,468,475,0
3_556184,feast_excitement_endive_cherry_bosnia_alsace,556184,3,7,449,456,0
3_3926434,overcome_depression-7_love_haroset_saturn_earth,3926434,3,9,337,346,0
3_3737284,overcome_anxiety_lubricity_marzipan_saturn_earth,3737284,3,9,300,309,0
3_7126584,overcome_loneliness-3_intoxication_wonderbread_mercury_saturn,7126584,3,9,425,434,0
3_2441384,overcome_loneliness-3_lubricity_ham_saturn_earth,2441384,3,9,329,338,0
3_4109834,overcome_depression_satiety_wurst_mercury_saturn,4109834,3,9,445,454,0
3_2870934,overcome_dread_excitement_wurst_earth_uranus,2870934,3,9,239,248,0
3_1674035,noop_craves_love_shrimp,1674035,3,1,395,396,0
4_1766033,pleasure_intoxication,1766033,4,1,0,1,0
4_7801210,eats_wurst_papaya,7801210,4,1,0,1,0
4_7763559,pain_jealousy-2,7763559,4,1,0,1,0
3_5499585,succumb_depression_achievement_rice_earth_uranus,5499585,3,7,246,253,0
3_3380535,feast_achievement_cherry_endive_goias_bavaria,3380535,3,7,287,294,0
3_1601685,feast_rest_rice_marzipan_bosnia_alsace,1601685,3,7,750,757,0
3_6905485,feast_lubricity_arugula_potato_bavaria_guanabara,6905485,3,7,412,419,0
3_3170085,feast_lubricity_wonderbread_arugula_guanabara_bosnia,3170085,3,7,299,306,0
3_2740385,feast_love_turkey_shrimp_goias_bavaria,2740385,3,7,396,403,0
3_7253385,feast_satisfaction_marzipan_haroset_guanabara_bosnia,7253385,3,7,347,354,0
3_4448435,feast_intoxication_mutton_ham_goias_bavaria,4448435,3,7,237,244,0
3_5978485,feast_love_shrimp_turkey_guanabara_bosnia,5978485,3,7,452,459,0
3_2530035,overcome_depression_entertainment_wurst_saturn_earth,2530035,3,9,255,264,0
3_4770235,overcome_dread_achievement_wurst_saturn_earth,4770235,3,9,413,422,0
4_323738,food_rice,323738,4,1,0,1,0
4_4985459,pain_sciatica,4985459,4,1,0,1,0
3_1807686,noop_fears_prostatitis_satiety,1807686,3,1,265,266,0
3_381786,succumb_angina_lubricity_shrimp_saturn_earth,381786,3,7,288,295,0
3_2844536,succumb_jealousy_excitement_papaya_saturn_earth,2844536,3,7,267,274,0
3_872036,succumb_abrasion_satisfaction_potato_mercury_saturn,872036,3,7,222,229,0
4_1521550,craves_abrasion_potato,1521550,4,1,0,1,0
3_5904586,succumb_boils-1_intoxication_arugula_saturn_earth,5904586,3,7,183,190,0
3_5713536,succumb_boils-1_intoxication_ham_earth_uranus,5713536,3,7,201,208,0
4_7111845,craves_boils-1_ham,7111845,4,1,30,31,0
3_4355336,succumb_loneliness_intoxication_shrimp_earth_uranus,4355336,3,7,228,235,0
3_6443636,succumb_hangover_love_rice_saturn_earth,6443636,3,7,328,335,0
3_3093336,succumb_hangover_love_rice_earth_uranus,3093336,3,7,328,335,0
3_4850736,feast_lubricity_rice_cherry_guanabara_bosnia,4850736,3,7,468,475,0
3_6771986,feast_achievement_marzipan_onion_guanabara_bosnia,6771986,3,7,323,330,0
3_215386,feast_rest_potato_shrimp_guanabara_bosnia,215386,3,7,511,518,0
3_6363986,feast_satisfaction_arugula_wonderbread_bavaria_guanabara,6363986,3,7,239,246,0
3_1777686,feast_intoxication_onion_shrimp_guanabara_bosnia,1777686,3,7,246,253,0
3_1805286,feast_love_papaya_wurst_goias_bavaria,1805286,3,7,394,401,0
3_5161686,overcome_abrasion-4_rest_onion_mercury_saturn,5161686,3,9,284,293,0
3_4260336,overcome_abrasion-4_intoxication_ham_saturn_earth,4260336,3,9,227,236,0
3_1569386,overcome_hangover_love_rice_saturn_earth,1569386,3,9,461,470,0
3_1138386,overcome_laceration_excitement_marzipan_saturn_earth,1138386,3,9,469,478,0
3_882136,overcome_laceration_excitement_cherry_saturn_earth,882136,3,9,292,301,0
3_3696736,overcome_grief_love_cherry_saturn_earth,3696736,3,9,480,489,0
3_346436,overcome_grief_love_cherry_earth_uranus,346436,3,9,477,486,0
4_6440549,pleasure_lubricity,6440549,4,1,0,1,0
4_3810436,food_onion,3810436,4,1,0,1,0
3_4389637,noop_fears_depression_love,4389637,3,0,381,381,0
2_7179962,fears_depression_love,7179962,2,0,1,1,0
3_3200037,noop_fears_boils_rest,3200037,3,0,375,375,0
2_5493103,fears_boils_rest,5493103,2,0,1,1,0
3_6674287,succumb_anxiety_love_mutton_earth_uranus,6674287,3,7,352,359,0
4_1436507,craves_anxiety_mutton,1436507,4,2,13,15,0
3_7929137,succumb_sciatica_rest_ham_mercury_saturn,7929137,3,7,287,294,0
3_6123037,succumb_depression_achievement_cherry_earth_uranus,6123037,3,7,221,228,0
3_5346237,feast_rest_cherry_rice_bosnia_alsace,5346237,3,7,717,724,0
3_793737,feast_satisfaction_shrimp_onion_bavaria_guanabara,793737,3,7,232,239,0
3_7549487,feast_satiety_shrimp_turkey_guanabara_bosnia,7549487,3,7,399,406,0
3_2142387,feast_achievement_onion_shrimp_guanabara_bosnia,2142387,3,7,428,435,0
3_5668237,feast_lubricity_cherry_marzipan_goias_bavaria,5668237,3,7,496,503,0
3_4280337,feast_satisfaction_marzipan_onion_alsace_surrey,4280337,3,7,587,594,0
3_882237,feast_love_papaya_wurst_bavaria_guanabara,882237,3,7,308,315,0
3_6117687,overcome_angina_love_onion_saturn_earth,6117687,3,9,352,361,0
3_1760787,overcome_anger_satisfaction_marzipan_mercury_saturn,1760787,3,9,291,300,0
4_93021,fears_anger_satisfaction,93021,4,1,53,54,0
3_4176937,overcome_dread_achievement_rice_mercury_saturn,4176937,3,9,425,434,0
3_6317537,overcome_jealousy_excitement_papaya_earth_uranus,6317537,3,9,500,509,0
3_192087,overcome_jealousy_satisfaction_marzipan_mercury_saturn,192087,3,9,550,559,0
4_5823911,fears_jealousy_satisfaction,5823911,4,1,79,80,0
3_1969438,noop_craves_hangover_rice,1969438,3,1,221,222,0
4_3474113,pain_laceration-8,3474113,4,1,0,1,0
3_3827038,succumb_boils_rest_shrimp_mercury_saturn,3827038,3,7,391,398,0
3_3626488,succumb_abrasion_satisfaction_wonderbread_mercury_saturn,3626488,3,7,222,229,0
4_7207743,craves_abrasion_wonderbread,7207743,4,1,42,43,0
3_6054088,succumb_loneliness-3_rest_yogurt_mercury_saturn,6054088,3,7,294,301,0
4_7815935,craves_loneliness-3_yogurt,7815935,4,1,59,60,0
3_6168538,succumb_angina_rest_ham_mercury_saturn,6168538,3,7,296,303,0
3_6334738,succumb_jealousy_love_onion_earth_uranus,6334738,3,7,350,357,0
4_1228789,craves_jealousy_onion,1228789,4,1,47,48,0
3_2182438,succumb_grief_satiety_cherry_mercury_saturn,2182438,3,7,285,292,0
3_6965088,feast_satisfaction_yogurt_potato_bavaria_guanabara,6965088,3,7,192,199,0
3_3443538,feast_satiety_shrimp_onion_bosnia_alsace,3443538,3,7,641,648,0
3_2687088,feast_achievement_onion_marzipan_bosnia_alsace,2687088,3,7,525,532,0
3_5899338,feast_rest_mutton_marzipan_goias_bavaria,5899338,3,7,279,286,0
3_1989738,feast_lubricity_cherry_marzipan_guanabara_bosnia,1989738,3,7,468,475,0
3_5081838,feast_excitement_endive_cherry_guanabara_bosnia,5081838,3,7,290,297,0
3_6751788,feast_achievement_papaya_wurst_bavaria_guanabara,6751788,3,7,291,298,0
3_82788,feast_love_shrimp_onion_goias_bavaria,82788,3,7,559,566,0
3_6387438,overcome_abrasion-4_rest_wonderbread_mercury_saturn,6387438,3,9,284,293,0
3_297638,overcome_jealousy-2_intoxication_wonderbread_mercury_saturn,297638,3,9,189,198,0
3_158738,overcome_loneliness-3_excitement_onion_earth_uranus,158738,3,9,585,594,0
3_6711988,overcome_hangover_satiety_rice_mercury_saturn,6711988,3,9,431,440,0
3_3231688,overcome_dread_achievement_papaya_saturn_earth,3231688,3,9,304,313,0
3_2489388,overcome_laceration_love_cherry_mercury_saturn,2489388,3,9,346,355,0
3_7621788,overcome_loneliness_rest_potato_mercury_saturn,7621788,3,9,324,333,0
3_5399238,overcome_grief_rest_cherry_mercury_saturn,5399238,3,9,565,574,0
4_1013560,fears_grief_rest,1013560,4,1,99,100,0
3_3113938,overcome_grief_satiety_cherry_mercury_saturn,3113938,3,9,421,430,0
4_1486223,pain_angina,1486223,4,1,0,1,0
4_7998514,pain_loneliness-3,7998514,4,1,0,1,0
4_6196362,pleasure_rest,6196362,4,1,0,1,0
3_490589,noop_craves_loneliness-3_onion,490589,3,1,269,270,0
4_197009,eats_wonderbread_ham,197009,4,1,0,1,0
4_6188452,food_ham,6188452,4,1,0,1,0
4_7897051,eats_turkey_shrimp,7897051,4,1,0,1,0
3_3500439,succumb_depression_love_endive_earth_uranus,3500439,3,7,395,402,0
3_5042589,succumb_boils_satisfaction_onion_mercury_saturn,5042589,3,7,273,280,0
3_4617339,succumb_loneliness_lubricity_arugula_earth_uranus,4617339,3,7,317,324,0
3_7946239,succumb_abrasion-4_rest_marzipan_mercury_saturn,7946239,3,7,283,290,0
4_3318645,craves_abrasion-4_marzipan,3318645,4,1,58,59,0
3_2384389,succumb_jealousy-2_intoxication_yogurt_earth_uranus,2384389,3,7,189,196,0
3_4418739,feast_satisfaction_onion_shrimp_bavaria_guanabara,4418739,3,7,272,279,0
3_306789,feast_excitement_onion_ham_bosnia_alsace,306789,3,7,524,531,0
3_3323689,feast_satisfaction_arugula_potato_bavaria_guanabara,3323689,3,7,239,246,0
3_4417689,feast_love_ham_wonderbread_goias_bavaria,4417689,3,7,390,397,0
3_596239,feast_satisfaction_ham_mutton_goias_bavaria,596239,3,7,213,220,0
3_2917389,feast_love_papaya_rice_bavaria_guanabara,2917389,3,7,308,315,0
3_4434939,feast_rest_wonderbread_ham_bavaria_guanabara,4434939,3,7,284,291,0
3_386339,feast_love_shrimp_onion_guanabara_bosnia,386339,3,7,452,459,0
3_5478839,feast_love_shrimp_potato_guanabara_bosnia,5478839,3,7,452,459,0
3_7007189,overcome_abrasion-4_love_mutton_saturn_earth,7007189,3,9,580,589,0
3_3656889,overcome_abrasion-4_love_mutton_earth_uranus,3656889,3,9,583,592,0
3_7782239,overcome_depression_love_endive_saturn_earth,7782239,3,9,349,358,0
3_3861789,overcome_depression_lubricity_cherry_earth_uranus,3861789,3,9,597,606,0
4_2128520,fears_depression_lubricity,2128520,4,1,95,96,0
3_5919289,overcome_angina_intoxication_onion_earth_uranus,5919289,3,9,209,218,0
4_6733772,fears_angina_intoxication,6733772,4,1,36,37,0
3_3736639,overcome_loneliness_intoxication_yogurt_earth_uranus,3736639,3,9,373,382,0
3_7086939,overcome_loneliness_intoxication_yogurt_saturn_earth,7086939,3,9,369,378,0
3_1484539,overcome_loneliness_lubricity_shrimp_saturn_earth,1484539,3,9,440,449,0
3_6248940,noop_locale_yogurt_bavaria,6248940,3,1,155,156,0
3_4440890,noop_locale_shrimp_bavaria,4440890,3,1,189,190,0
3_4016940,succumb_hangover_satiety_papaya_mercury_saturn,4016940,3,7,345,352,0
3_6380290,succumb_anxiety_love_rice_saturn_earth,6380290,3,7,321,328,0
3_3029990,succumb_anxiety_love_rice_earth_uranus,3029990,3,7,321,328,0
3_524340,succumb_laceration_achievement_endive_mercury_saturn,524340,3,7,273,280,0
3_7121790,succumb_jealousy_satiety_papaya_mercury_saturn,7121790,3,7,319,326,0
3_4470090,succumb_anger_love_haroset_earth_uranus,4470090,3,7,352,359,0
3_5927990,succumb_dread_love_rice_earth_uranus,5927990,3,7,328,335,0
3_4863440,feast_rest_haroset_marzipan_bavaria_guanabara,4863440,3,7,410,417,0
3_4611540,feast_rest_shrimp_turkey_goias_bavaria,4611540,3,7,451,458,0
3_2324540,feast_lubricity_yogurt_potato_goias_bavaria,2324540,3,7,397,404,0
3_7879290,feast_lubricity_wonderbread_yogurt_guanabara_bosnia,7879290,3,7,299,306,0
3_4393790,feast_satiety_shrimp_potato_bavaria_guanabara,4393790,3,7,399,406,0
3_2449140,feast_excitement_mutton_marzipan_goias_bavaria,2449140,3,7,393,400,0
3_4812240,feast_excitement_endive_wurst_bavaria_guanabara,4812240,3,7,290,297,0
3_5543840,overcome_boils_intoxication_turkey_earth_uranus,5543840,3,9,464,473,0
3_2793540,overcome_depression-7_satisfaction_haroset_mercury_saturn,2793540,3,9,238,247,0
4_5394466,fears_depression-7_satisfaction,5394466,4,1,47,48,0
3_7054490,overcome_loneliness-3_love_mutton_earth_uranus,7054490,3,9,583,592,0
3_2743940,overcome_loneliness-3_rest_mutton_mercury_saturn,2743940,3,9,284,293,0
3_3599540,overcome_dread_achievement_rice_saturn_earth,3599540,3,9,427,436,0
3_1075940,overcome_loneliness_intoxication_arugula_saturn_earth,1075940,3,9,363,372,0
3_7725591,noop_locale_rice_bavaria,7725591,3,1,103,104,0
3_7193141,succumb_boils_lubricity_onion_saturn_earth,7193141,3,7,284,291,0
3_5647441,succumb_angina_satiety_onion_mercury_saturn,5647441,3,7,336,343,0
3_4827441,succumb_laceration-8_love_haroset_earth_uranus,4827441,3,7,374,381,0
3_2851491,feast_lubricity_yogurt_wonderbread_goias_bavaria,2851491,3,7,397,404,0
3_7049841,feast_satiety_shrimp_potato_guanabara_bosnia,7049841,3,7,399,406,0
3_1460891,feast_rest_marzipan_rice_guanabara_bosnia,1460891,3,7,358,365,0
3_200491,feast_lubricity_cherry_rice_bosnia_alsace,200491,3,7,747,754,0
3_2477291,feast_satiety_marzipan_onion_guanabara_bosnia,2477291,3,7,314,321,0
3_6288341,overcome_depression_love_wurst_earth_uranus,6288341,3,9,494,503,0
3_7134891,overcome_anger_love_marzipan_mercury_saturn,7134891,3,9,320,329,0
3_4697091,overcome_jealousy_lubricity_marzipan_earth_uranus,4697091,3,9,568,577,0
3_3470541,overcome_laceration_love_marzipan_mercury_saturn,3470541,3,9,527,536,0
3_5392141,overcome_laceration_excitement_rice_earth_uranus,5392141,3,9,446,455,0
4_1180739,pain_laceration,1180739,4,1,0,1,0
3_6926892,noop_craves_love_turkey,6926892,3,1,373,374,0
3_876692,noop_fears_depression-7_satiety,876692,3,1,314,315,0
3_4783042,succumb_boils_lubricity_arugula_earth_uranus,4783042,3,7,294,301,0
4_6608395,craves_boils_arugula,6608395,4,1,52,53,0
3_4104692,succumb_laceration_satiety_mutton_mercury_saturn,4104692,3,7,303,310,0
4_502112,craves_laceration_mutton,502112,4,1,47,48,0
3_6180992,succumb_jealousy_love_marzipan_saturn_earth,6180992,3,7,318,325,0
3_2464142,feast_lubricity_marzipan_cherry_guanabara_bosnia,2464142,3,7,357,364,0
3_2721542,feast_lubricity_mutton_ham_bavaria_guanabara,2721542,3,7,323,330,0
3_5053592,feast_love_marzipan_mutton_guanabara_bosnia,5053592,3,7,368,375,0
3_2932492,feast_lubricity_shrimp_potato_goias_bavaria,2932492,3,7,387,394,0
3_7839292,feast_intoxication_onion_marzipan_bavaria_guanabara,7839292,3,7,246,253,0
3_4716892,overcome_boils-1_lubricity_wonderbread_earth_uranus,4716892,3,9,432,441,0
3_2463542,overcome_loneliness-3_satisfaction_onion_mercury_saturn,2463542,3,9,458,467,0
3_1910192,overcome_dread_love_rice_saturn_earth,1910192,3,9,461,470,0
3_3762192,overcome_jealousy_love_marzipan_earth_uranus,3762192,3,9,337,346,0
3_6143992,overcome_laceration_love_marzipan_earth_uranus,6143992,3,9,515,524,0
3_1444092,overcome_laceration_lubricity_marzipan_saturn_earth,1444092,3,9,516,525,0
3_3142942,overcome_grief_excitement_wurst_mercury_saturn,3142942,3,9,422,431,0
3_6571693,noop_craves_intoxication_onion,6571693,3,1,173,174,0
4_2932032,pleasure_excitement,2932032,4,1,0,1,0
3_2562693,noop_craves_laceration_endive,2562693,3,1,276,277,0
3_3641143,noop_craves_loneliness_arugula,3641143,3,1,222,223,0
4_1370260,pain_anxiety,1370260,4,1,0,1,0
3_203043,noop_craves_rest_cherry,203043,3,1,377,378,0
3_6358943,succumb_abrasion-4_intoxication_ham_earth_uranus,6358943,3,7,235,242,0
3_4351243,succumb_sciatica_intoxication_wonderbread_saturn_earth,4351243,3,7,189,196,0
3_5806993,feast_excitement_cherry_marzipan_goias_bavaria,5806993,3,7,320,327,0
3_7373443,feast_rest_shrimp_onion_goias_bavaria,7373443,3,7,451,458,0
3_7566343,feast_rest_cherry_endive_bavaria_guanabara,7566343,3,7,436,443,0
3_1997243,feast_achievement_marzipan_cherry_guanabara_bosnia,1997243,3,7,323,330,0
3_5575143,feast_achievement_onion_shrimp_bosnia_alsace,5575143,3,7,525,532,0
3_3104093,feast_excitement_haroset_marzipan_bavaria_guanabara,3104093,3,7,396,403,0
3_7217643,overcome_abrasion-4_satisfaction_ham_mercury_saturn,7217643,3,9,227,236,0
3_5505343,overcome_boils-1_lubricity_potato_earth_uranus,5505343,3,9,431,440,0
3_3164193,overcome_depression_excitement_wurst_mercury_saturn,3164193,3,9,422,431,0
3_3954493,overcome_jealousy_love_rice_mercury_saturn,3954493,3,9,300,309,0
3_626343,overcome_laceration_achievement_marzipan_saturn_earth,626343,3,9,455,464,0
4_3456443,pain_grief,3456443,4,1,0,1,0
4_5631791,pain_loneliness,5631791,4,1,0,1,0
3_3753394,noop_fears_jealousy_achievement,3753394,3,1,286,287,0
4_6892927,attacks_guanabara_bosnia,6892927,4,1,0,1,0
3_525094,noop_fears_anxiety_excitement,525094,3,1,258,259,0
4_2180706,eats_ham_onion,2180706,4,1,0,1,0
3_7369394,succumb_laceration_love_cherry_saturn_earth,7369394,3,7,348,355,0
3_5892744,succumb_sciatica_rest_arugula_mercury_saturn,5892744,3,7,297,304,0
3_6828444,succumb_jealousy_excitement_rice_saturn_earth,6828444,3,7,267,274,0
3_3551044,succumb_grief_achievement_endive_earth_uranus,3551044,3,7,223,230,0
3_5089444,succumb_depression-7_lubricity_haroset_earth_uranus,5089444,3,7,298,305,0
3_2441744,succumb_loneliness_intoxication_yogurt_earth_uranus,2441744,3,7,218,225,0
3_4350944,feast_rest_haroset_marzipan_goias_bavaria,4350944,3,7,402,409,0
3_2767994,feast_rest_haroset_turkey_goias_bavaria,2767994,3,7,402,409,0
3_6762194,feast_satisfaction_haroset_marzipan_bavaria_guanabara,6762194,3,7,255,262,0
3_3096794,feast_achievement_mutton_ham_bavaria_guanabara,3096794,3,7,394,401,0
3_5510894,overcome_boils_satisfaction_potato_mercury_saturn,5510894,3,9,434,443,0
3_6301194,overcome_sciatica_lubricity_wonderbread_earth_uranus,6301194,3,9,289,298,0
4_4553354,fears_sciatica_lubricity,4553354,4,1,45,46,0
3_5711594,overcome_depression_love_cherry_mercury_saturn,5711594,3,9,485,494,0
3_2113794,overcome_depression_excitement_cherry_earth_uranus,2113794,3,9,423,432,0
3_5464094,overcome_depression_excitement_cherry_saturn_earth,5464094,3,9,421,430,0
3_7527344,overcome_jealousy_excitement_papaya_mercury_saturn,7527344,3,9,500,509,0
3_2246394,overcome_laceration_lubricity_rice_earth_uranus,2246394,3,9,654,663,0
3_226645,noop_locale_arugula_guanabara,226645,3,1,176,177,0
4_4018670,eats_shrimp_onion,4018670,4,1,0,1,0
3_6926845,succumb_angina_satisfaction_onion_mercury_saturn,6926845,3,7,237,244,0
3_5405345,succumb_depression_achievement_wurst_mercury_saturn,5405345,3,7,229,236,0
3_732995,succumb_anger_love_cherry_saturn_earth,732995,3,7,321,328,0
3_1296495,succumb_prostatitis_achievement_wurst_mercury_saturn,1296495,3,7,238,245,0
3_6553195,feast_rest_potato_yogurt_guanabara_bosnia,6553195,3,7,511,518,0
3_5647495,feast_satiety_shrimp_potato_bosnia_alsace,5647495,3,7,641,648,0
3_2222695,feast_lubricity_shrimp_onion_goias_bavaria,2222695,3,7,387,394,0
3_2428495,overcome_boils_lubricity_turkey_earth_uranus,2428495,3,9,301,310,0
3_7533545,overcome_loneliness-3_lubricity_onion_mercury_saturn,7533545,3,9,514,523,0
3_1867145,overcome_loneliness_lubricity_arugula_earth_uranus,1867145,3,9,458,467,0
3_5217445,overcome_loneliness_lubricity_arugula_saturn_earth,5217445,3,9,456,465,0
3_2057345,overcome_grief_excitement_cherry_saturn_earth,2057345,3,9,421,430,0
3_7549646,noop_craves_lubricity_cherry,7549646,3,1,409,410,0
4_492931,locale_wurst_goias,492931,4,1,0,1,0
3_3000496,noop_craves_laceration_marzipan,3000496,3,1,266,267,0
3_2721346,noop_craves_excitement_mutton,2721346,3,1,365,366,0
3_2617696,noop_craves_hangover_wurst,2617696,3,1,232,233,0
3_4072096,noop_craves_boils-1_potato,4072096,3,1,185,186,0
3_1493246,noop_craves_grief_wurst,1493246,3,1,229,230,0
3_517446,succumb_anxiety_satiety_onion_mercury_saturn,517446,3,7,306,313,0
4_3837243,craves_anxiety_onion,3837243,4,2,13,15,0
3_6933446,succumb_loneliness_lubricity_shrimp_saturn_earth,6933446,3,7,307,314,0
3_3583146,succumb_loneliness_lubricity_shrimp_earth_uranus,3583146,3,7,307,314,0
3_7557696,succumb_abrasion-4_rest_yogurt_mercury_saturn,7557696,3,7,294,301,0
4_6983612,craves_abrasion-4_yogurt,6983612,4,1,59,60,0
3_7530746,succumb_abrasion_lubricity_yogurt_earth_uranus,7530746,3,6,297,303,0
2_1790580,fears_abrasion_lubricity,1790580,2,0,1,1,0
3_5891246,succumb_jealousy_love_endive_earth_uranus,5891246,3,7,336,343,0
4_601638,craves_jealousy_endive,601638,4,1,48,49,0
3_5142496,succumb_dread_satiety_papaya_mercury_saturn,5142496,3,6,345,351,0
2_4573088,fears_dread_satiety,4573088,2,0,1,1,0
3_483496,succumb_hangover_excitement_marzipan_earth_uranus,483496,3,7,247,254,0
4_5328593,craves_hangover_marzipan,5328593,4,1,44,45,0
3_1203896,succumb_anger_satiety_onion_mercury_saturn,1203896,3,7,306,313,0
3_4643246,feast_lubricity_rice_marzipan_guanabara_bosnia,4643246,3,7,468,475,0
3_2029446,feast_intoxication_shrimp_onion_goias_bavaria,2029446,3,7,333,340,0
3_312796,feast_achievement_marzipan_rice_guanabara_bosnia,312796,3,7,323,330,0
3_5268046,feast_rest_potato_yogurt_bavaria_guanabara,5268046,3,7,303,310,0
3_5165696,feast_lubricity_cherry_marzipan_bavaria_guanabara,5165696,3,7,468,475,0
3_4566696,feast_lubricity_haroset_turkey_goias_bavaria,4566696,3,7,291,298,0
3_4531346,overcome_abrasion-4_satiety_onion_mercury_saturn,4531346,3,9,527,536,0
3_7948646,overcome_abrasion-4_lubricity_mutton_earth_uranus,7948646,3,9,541,550,0
3_2720946,overcome_depression_satiety_cherry_mercury_saturn,2720946,3,9,421,430,0
3_579846,overcome_jealousy_lubricity_rice_earth_uranus,579846,3,9,477,486,0
3_4802997,noop_craves_rest_turkey,4802997,3,1,357,358,0
3_5504547,noop_harmony_lubricity_saturn,5504547,3,1,215,216,0
3_1002897,noop_fears_abrasion_lubricity,1002897,3,1,286,287,0
3_1422997,noop_craves_satiety_shrimp,1422997,3,1,342,343,0
4_7813070,pain_abrasion,7813070,4,1,0,1,0
3_7974847,succumb_anxiety_satiety_mutton_mercury_saturn,7974847,3,7,306,313,0
3_7513147,succumb_grief_achievement_rice_earth_uranus,7513147,3,7,246,253,0
3_5314247,succumb_jealousy_love_mutton_earth_uranus,5314247,3,7,350,357,0
4_5754351,craves_jealousy_mutton,5754351,4,1,32,33,0
3_3825697,succumb_boils-1_satisfaction_wonderbread_mercury_saturn,3825697,3,7,241,248,0
3_3021047,feast_satiety_endive_cherry_goias_bavaria,3021047,3,7,346,353,0
3_3602347,feast_satiety_shrimp_turkey_goias_bavaria,3602347,3,7,507,514,0
3_6906997,feast_satisfaction_ham_wonderbread_bavaria_guanabara,6906997,3,7,447,454,0
3_2231547,feast_achievement_mutton_ham_goias_bavaria,2231547,3,7,394,401,0
3_2141347,feast_intoxication_onion_ham_bavaria_guanabara,2141347,3,7,246,253,0
3_2125197,feast_intoxication_onion_marzipan_guanabara_bosnia,2125197,3,7,246,253,0
3_6127047,overcome_boils_satiety_onion_mercury_saturn,6127047,3,9,541,550,0
3_1350547,overcome_abrasion-4_intoxication_wonderbread_saturn_earth,1350547,3,9,425,434,0
3_7308797,overcome_hangover_rest_rice_mercury_saturn,7308797,3,9,568,577,0
4_2020831,fears_hangover_rest,2020831,4,1,100,101,0
3_3491747,overcome_jealousy_satiety_papaya_mercury_saturn,3491747,3,9,540,549,0
3_244947,overcome_laceration_satiety_endive_mercury_saturn,244947,3,9,288,297,0
3_3111247,overcome_grief_satiety_wurst_mercury_saturn,3111247,3,9,445,454,0
4_506446,eats_papaya_wurst,506446,4,1,0,1,0
3_6010698,noop_locale_cherry_bavaria,6010698,3,1,108,109,0
4_346337,eats_arugula_potato,346337,4,1,0,1,0
3_3036798,noop_craves_satisfaction_haroset,3036798,3,1,220,221,0
4_5509864,eats_rice_papaya,5509864,4,1,0,1,0
3_5089898,succumb_anxiety_love_onion_earth_uranus,5089898,3,7,352,359,0
3_5337148,succumb_sciatica_intoxication_arugula_earth_uranus,5337148,3,7,189,196,0
3_7003098,succumb_dread_love_wurst_earth_uranus,7003098,3,7,328,335,0
3_4941948,feast_achievement_haroset_turkey_goias_bavaria,4941948,3,7,389,396,0
3_3804098,feast_rest_rice_papaya_goias_bavaria,3804098,3,7,460,467,0
3_1050398,feast_lubricity_mutton_marzipan_bavaria_guanabara,1050398,3,7,323,330,0
3_3329198,feast_satiety_cherry_rice_goias_bavaria,3329198,3,7,279,286,0
3_3263248,feast_excitement_endive_cherry_goias_bavaria,3263248,3,7,489,496,0
3_6804798,feast_rest_arugula_potato_bavaria_guanabara,6804798,3,7,429,436,0
3_4547698,overcome_laceration-8_love_haroset_saturn_earth,4547698,3,9,337,346,0
3_5089198,overcome_loneliness-3_satiety_mutton_mercury_saturn,5089198,3,9,534,543,0
3_5821948,overcome_jealousy_rest_marzipan_mercury_saturn,5821948,3,9,566,575,0
4_2211538,eats_onion_marzipan,2211538,4,1,0,1,0
3_6718449,noop_fears_dread_satiety,6718449,3,1,333,334,0
3_5408649,noop_fears_anxiety_rest,5408649,3,1,287,288,0
3_5564099,noop_craves_achievement_onion,5564099,3,1,364,365,0
4_7159023,pain_depression,7159023,4,1,0,1,0
4_7480922,planet_uranus,7480922,4,1,0,1,0
3_4380999,succumb_jealousy-2_rest_ham_mercury_saturn,4380999,3,7,287,294,0
3_3125399,succumb_laceration_love_rice_saturn_earth,3125399,3,7,348,355,0
3_4018899,succumb_laceration_achievement_rice_saturn_earth,4018899,3,7,289,296,0
3_3666599,feast_love_cherry_marzipan_goias_bavaria,3666599,3,7,365,372,0
3_3202849,feast_achievement_haroset_marzipan_goias_bavaria,3202849,3,7,389,396,0
3_4308749,feast_rest_rice_marzipan_goias_bavaria,4308749,3,7,460,467,0
3_82049,feast_excitement_marzipan_onion_guanabara_bosnia,82049,3,7,322,329,0
3_1582449,feast_excitement_marzipan_cherry_guanabara_bosnia,1582449,3,7,322,329,0
3_4380699,feast_lubricity_rice_marzipan_bavaria_guanabara,4380699,3,7,468,475,0
3_1280349,feast_rest_potato_yogurt_goias_bavaria,1280349,3,7,303,310,0
3_6581449,feast_love_ham_onion_goias_bavaria,6581449,3,7,390,397,0
3_6690149,feast_satiety_marzipan_cherry_guanabara_bosnia,6690149,3,7,314,321,0
3_4476649,feast_love_shrimp_potato_bosnia_alsace,4476649,3,7,693,700,0
3_4555849,overcome_boils_achievement_onion_saturn_earth,4555849,3,9,615,624,0
4_3294198,fears_boils_achievement,3294198,4,1,100,101,0
3_5258399,overcome_depression-7_achievement_haroset_saturn_earth,5258399,3,9,384,393,0
4_6697897,fears_depression-7_achievement,6697897,4,1,66,67,0
3_2841049,overcome_loneliness-3_rest_onion_mercury_saturn,2841049,3,9,284,293,0
3_1305799,overcome_dread_entertainment_wurst_saturn_earth,1305799,3,9,257,266,0
3_2275249,overcome_laceration_excitement_endive_earth_uranus,2275249,3,9,489,498,0
3_2197149,overcome_loneliness_love_shrimp_earth_uranus,2197149,3,9,588,597,0
4_6977933,fears_loneliness_love,6977933,4,1,82,83,0
3_5064249,overcome_loneliness_rest_yogurt_mercury_saturn,5064249,3,9,482,491,0
3_4396949,overcome_loneliness_lubricity_shrimp_mercury_saturn,4396949,3,9,440,449,0
5_1707199,locale_yogurt_goias,1707199,5,22,0,22,0
5_949448,fears_sciatica_satisfaction,949448,5,39,0,39,0
5_7486548,locale_potato_bosnia,7486548,5,42,0,42,0
5_6661347,fears_laceration-8_satisfaction,6661347,5,46,0,46,0
5_3466196,craves_satisfaction_rice,3466196,5,42,0,42,0
5_5051695,craves_abrasion_yogurt,5051695,5,5,0,5,0
5_7207743,craves_abrasion_wonderbread,7207743,5,41,0,41,0
5_7829991,fears_boils-1_satisfaction,7829991,5,37,0,37,0
5_4615585,craves_satisfaction_marzipan,4615585,5,30,0,30,0
5_6977933,fears_loneliness_love,6977933,5,81,0,81,0
5_7147533,locale_shrimp_goias,7147533,5,15,0,15,0
5_1850383,craves_loneliness_wonderbread,1850383,5,42,0,42,0
5_1790580,fears_abrasion_lubricity,1790580,5,44,0,44,0
5_2849830,fears_laceration_satisfaction,2849830,5,76,0,76,0
5_5388128,craves_satisfaction_ham,5388128,5,25,0,25,0
5_171277,craves_satisfaction_wonderbread,171277,5,25,0,25,0
5_5167173,craves_satisfaction_haroset,5167173,5,33,0,33,0
5_2412073,fears_jealousy-2_satisfaction,2412073,5,39,0,39,0
5_3883223,fears_loneliness_satiety,3883223,5,79,0,79,0
5_4376923,craves_satisfaction_cherry,4376923,5,42,0,42,0
5_1217321,craves_satisfaction_arugula,1217321,5,28,0,28,0
5_93021,fears_anger_satisfaction,93021,5,52,0,52,0
5_3724020,craves_satisfaction_shrimp,3724020,5,27,0,27,0
5_5394466,fears_depression-7_satisfaction,5394466,5,46,0,46,0
5_6154015,fears_boils_satisfaction,6154015,5,39,0,39,0
5_967615,locale_arugula_bavaria,967615,5,23,0,23,0
5_1918314,harmony_satisfaction_mercury,1918314,5,8,0,8,0
5_4797514,fears_abrasion_satisfaction,4797514,5,33,0,33,0
5_4335864,craves_loneliness_turkey,4335864,5,44,0,44,0
5_4077212,fears_loneliness-3_satisfaction,4077212,5,47,0,47,0
5_2326612,fears_anxiety_satisfaction,2326612,5,52,0,52,0
5_5823911,fears_jealousy_satisfaction,5823911,5,78,0,78,0
5_3945910,fears_abrasion-4_satisfaction,3945910,5,47,0,47,0
5_181007,craves_satisfaction_onion,181007,5,26,0,26,0
5_1699206,fears_abrasion_intoxication,1699206,5,23,0,23,0
5_6982256,fears_loneliness_satisfaction,6982256,5,31,0,31,0
5_3664603,fears_abrasion_rest,3664603,5,56,0,56,0
5_1831103,fears_angina_satisfaction,1831103,5,45,0,45,0
5_1282252,craves_satisfaction_yogurt,1282252,5,28,0,28,0
5_7320002,craves_loneliness_onion,7320002,5,44,0,44,0
5_975900,craves_satisfaction_turkey,975900,5,30,0,30,0
5_1554400,craves_satisfaction_mutton,1554400,5,35,0,35,0
5_5753084,craves_satisfaction_potato,5753084,5,26,0,26,0
5_1521550,craves_abrasion_potato,1521550,5,41,0,41,0
5_4057049,fears_loneliness-3_satiety,4057049,5,50,0,50,0
5_5678649,craves_excitement_shrimp,5678649,5,62,0,62,0
5_4805298,fears_anger_rest,4805298,5,58,0,58,0
5_2689598,craves_rest_arugula,2689598,5,41,0,41,0
5_3294198,fears_boils_achievement,3294198,5,99,0,99,0
5_6697897,fears_depression-7_achievement,6697897,5,65,0,65,0
5_1490646,craves_excitement_haroset,1490646,5,33,0,33,0
5_4252146,craves_rest_endive,4252146,5,74,0,74,0
5_4383245,fears_abrasion-4_excitement,4383245,5,99,0,99,0
5_302795,craves_rest_papaya,302795,5,74,0,74,0
5_3318645,craves_abrasion-4_marzipan,3318645,5,57,0,57,0
5_1606144,fears_grief_lubricity,1606144,5,94,0,94,0
5_3174444,fears_depression_rest,3174444,5,98,0,98,0
5_5799944,fears_depression-7_excitement,5799944,5,65,0,65,0
5_6357293,craves_excitement_endive,6357293,5,34,0,34,0
5_3206743,fears_hangover_excitement,3206743,5,19,0,19,0
5_5328593,craves_hangover_marzipan,5328593,5,43,0,43,0
5_6166792,craves_loneliness-3_wonderbread,6166792,5,50,0,50,0
5_2407942,craves_excitement_papaya,2407942,5,28,0,28,0
5_6920541,craves_dread_cherry,6920541,5,43,0,43,0
5_1149340,craves_rest_wonderbread,1149340,5,42,0,42,0
5_4319540,fears_dread_lubricity,4319540,5,95,0,95,0
5_703339,craves_abrasion-4_onion,703339,5,51,0,51,0
5_2809038,craves_dread_marzipan,2809038,5,43,0,43,0
5_2490887,craves_excitement_rice,2490887,5,26,0,26,0
5_5475787,fears_grief_excitement,5475787,5,38,0,38,0
5_5110837,fears_loneliness-3_love,5110837,5,47,0,47,0
5_7815935,craves_loneliness-3_yogurt,7815935,5,58,0,58,0
5_1431034,fears_anxiety_rest,1431034,5,58,0,58,0
5_1168384,harmony_excitement_mercury,1168384,5,29,0,29,0
5_1131734,craves_rest_yogurt,1131734,5,41,0,41,0
5_3187434,fears_depression_excitement,3187434,5,38,0,38,0
5_825382,craves_rest_turkey,825382,5,47,0,47,0
5_4236582,fears_hangover_entertainment,4236582,5,43,0,43,0
5_6926932,fears_laceration-8_excitement,6926932,5,65,0,65,0
5_6009981,fears_boils-1_rest,6009981,5,56,0,56,0
5_92031,craves_excitement_wurst,92031,5,28,0,28,0
5_2020831,fears_hangover_rest,2020831,5,99,0,99,0
5_4501831,craves_achievement_turkey,4501831,5,62,0,62,0
5_5571930,fears_anger_excitement,5571930,5,40,0,40,0
5_164979,fears_abrasion-4_rest,164979,5,44,0,44,0
5_3222479,fears_hangover_lubricity,3222479,5,95,0,95,0
5_2930529,craves_excitement_turkey,2930529,5,62,0,62,0
5_6277678,fears_angina_achievement,6277678,5,70,0,70,0
5_1312777,fears_anxiety_excitement,1312777,5,40,0,40,0
5_4737077,craves_loneliness-3_ham,4737077,5,14,0,14,0
5_3525477,fears_laceration-8_rest,3525477,5,77,0,77,0
5_1635976,craves_loneliness-3_arugula,1635976,5,58,0,58,0
5_2256726,craves_loneliness-3_shrimp,2256726,5,58,0,58,0
5_5623675,fears_dread_entertainment,5623675,5,43,0,43,0
5_3984275,craves_lubricity_endive,3984275,5,70,0,70,0
5_34924,craves_lubricity_papaya,34924,5,70,0,70,0
5_2441720,harmony_excitement_saturn,2441720,5,25,0,25,0
5_2128520,fears_depression_lubricity,2128520,5,94,0,94,0
5_1105319,fears_loneliness-3_rest,1105319,5,44,0,44,0
5_7477118,locale_papaya_alsace,7477118,5,36,0,36,0
5_4066918,fears_abrasion-4_achievement,4066918,5,99,0,99,0
5_2075468,locale_papaya_goias,2075468,5,37,0,37,0
5_4587667,craves_abrasion-4_arugula,4587667,5,58,0,58,0
5_5602566,craves_rest_potato,5602566,5,42,0,42,0
5_4037416,fears_prostatitis_excitement,4037416,5,35,0,35,0
5_5317415,fears_loneliness-3_lubricity,5317415,5,47,0,47,0
5_2972415,fears_loneliness_rest,2972415,5,60,0,60,0
5_4020164,fears_dread_excitement,4020164,5,19,0,19,0
5_2459414,locale_marzipan_surrey,2459414,5,88,0,88,0
5_4078614,craves_achievement_ham,4078614,5,61,0,61,0
5_7778564,craves_loneliness-3_marzipan,7778564,5,57,0,57,0
5_2113012,craves_loneliness-3_onion,2113012,5,51,0,51,0
5_7241912,fears_laceration_rest,7241912,5,64,0,64,0
5_479162,fears_jealousy_rest,479162,5,64,0,64,0
5_6983612,craves_abrasion-4_yogurt,6983612,5,58,0,58,0
5_3516611,harmony_excitement_uranus,3516611,5,13,0,13,0
5_7255760,craves_abrasion-4_mutton,7255760,5,55,0,55,0
5_6651610,craves_abrasion-4_wonderbread,6651610,5,50,0,50,0
5_1013560,fears_grief_rest,1013560,5,98,0,98,0
5_843559,craves_rest_rice,843559,5,43,0,43,0
5_1126409,locale_ham_guanabara,1126409,5,53,0,53,0
5_541159,locale_rice_alsace,541159,5,61,0,61,0
5_1628909,fears_jealousy_excitement,1628909,5,26,0,26,0
5_7539959,craves_excitement_marzipan,7539959,5,26,0,26,0
5_3879908,fears_loneliness-3_achievement,3879908,5,99,0,99,0
5_6026007,fears_laceration_excitement,6026007,5,37,0,37,0
5_87106,craves_loneliness-3_mutton,87106,5,55,0,55,0
5_2141606,fears_angina_excitement,2141606,5,70,0,70,0
5_5126856,fears_depression-7_rest,5126856,5,77,0,77,0
5_4226405,craves_rest_cherry,4226405,5,43,0,43,0
5_978904,fears_loneliness-3_intoxication,978904,5,30,0,30,0
5_7880654,fears_boils_excitement,7880654,5,99,0,99,0
5_3948803,fears_sciatica_rest,3948803,5,50,0,50,0
5_7171653,fears_laceration-8_achievement,7171653,5,65,0,65,0
5_1424403,craves_abrasion-4_shrimp,1424403,5,58,0,58,0
5_6331552,craves_excitement_cherry,6331552,5,24,0,24,0
5_7058902,craves_hangover_cherry,7058902,5,43,0,43,0
5_4799851,fears_dread_rest,4799851,5,99,0,99,0
5_7249951,craves_achievement_shrimp,7249951,5,62,0,62,0
5_7290801,craves_excitement_ham,7290801,5,61,0,61,0
5_6639450,craves_rest_haroset,6639450,5,44,0,44,0
5_5863500,fears_jealousy-2_rest,5863500,5,50,0,50,0
5_482599,feast_satisfaction_turkey_shrimp_goias_bavaria,482599,5,1,0,1,0
5_5471088,feast_satisfaction_turkey_haroset_goias_bavaria,5471088,5,1,0,1,0
5_1766507,locale_shrimp_alsace,1766507,5,61,0,61,0
5_7879290,feast_lubricity_wonderbread_yogurt_guanabara_bosnia,7879290,5,1,0,1,0
5_4627335,feast_satisfaction_wonderbread_yogurt_guanabara_bosnia,4627335,5,1,0,1,0
5_3170085,feast_lubricity_wonderbread_arugula_guanabara_bosnia,3170085,5,1,0,1,0
5_4975932,feast_intoxication_wonderbread_ham_guanabara_bosnia,4975932,5,1,0,1,0
5_5643580,feast_rest_wonderbread_ham_guanabara_bosnia,5643580,5,1,0,1,0
5_2162471,feast_satisfaction_wonderbread_ham_guanabara_bosnia,2162471,5,1,0,1,0
5_5744267,feast_lubricity_wonderbread_ham_guanabara_bosnia,5744267,5,1,0,1,0
5_3686216,feast_intoxication_wonderbread_yogurt_guanabara_bosnia,3686216,5,1,0,1,0
5_2771213,feast_satisfaction_wonderbread_arugula_guanabara_bosnia,2771213,5,1,0,1,0
5_1874059,feast_intoxication_wonderbread_arugula_guanabara_bosnia,1874059,5,1,0,1,0
5_6605908,feast_rest_wonderbread_yogurt_guanabara_bosnia,6605908,5,1,0,1,0
5_5224350,feast_rest_wonderbread_arugula_guanabara_bosnia,5224350,5,1,0,1,0
5_6588915,locale_wonderbread_bavaria,6588915,5,2,0,2,0
5_3639227,locale_wonderbread_alsace,3639227,5,9,0,9,0
5_1546140,locale_wonderbread_guanabara,1546140,5,2,0,2,0
5_4380999,succumb_jealousy-2_rest_ham_mercury_saturn,4380999,5,1,0,1,0
5_4774347,succumb_jealousy-2_rest_wonderbread_mercury_saturn,4774347,5,1,0,1,0
5_2280476,succumb_jealousy-2_rest_yogurt_mercury_saturn,2280476,5,1,0,1,0
5_2506925,succumb_jealousy-2_rest_arugula_mercury_saturn,2506925,5,1,0,1,0
5_3652439,craves_jealousy-2_yogurt,3652439,5,6,0,6,0
5_4050538,fears_jealousy-2_lubricity,4050538,5,49,0,49,0
5_7911918,craves_jealousy-2_arugula,7911918,5,6,0,6,0
5_203217,craves_jealousy-2_ham,203217,5,6,0,6,0
5_7730434,harmony_rest_saturn,7730434,5,19,0,19,0
5_5472578,craves_rest_marzipan,5472578,5,34,0,34,0
5_3693926,fears_angina_rest,3693926,5,46,0,46,0
5_6551857,craves_jealousy-2_wonderbread,6551857,5,6,0,6,0
5_3573502,craves_rest_shrimp,3573502,5,38,0,38,0
5_5493103,fears_boils_rest,5493103,5,58,0,58,0
5_7314742,fears_jealousy-2_intoxication,7314742,5,14,0,14,0
5_3444900,fears_loneliness-3_excitement,3444900,5,99,0,99,0
5_381786,succumb_angina_lubricity_shrimp_saturn_earth,381786,5,1,0,1,0
5_6106075,succumb_angina_lubricity_marzipan_earth_uranus,6106075,5,1,0,1,0
5_5032463,succumb_angina_lubricity_shrimp_earth_uranus,5032463,5,1,0,1,0
5_6335058,succumb_angina_lubricity_ham_earth_uranus,6335058,5,1,0,1,0
5_3991950,succumb_angina_lubricity_onion_earth_uranus,3991950,5,1,0,1,0
5_7342250,succumb_angina_lubricity_onion_saturn_earth,7342250,5,1,0,1,0
5_6608395,craves_boils_arugula,6608395,5,51,0,51,0
5_6505494,craves_angina_ham,6505494,5,10,0,10,0
5_7241536,craves_boils_yogurt,7241536,5,51,0,51,0
5_6697179,craves_angina_marzipan,6697179,5,10,0,10,0
5_5346076,craves_angina_shrimp,5346076,5,10,0,10,0
5_6733772,fears_angina_intoxication,6733772,5,35,0,35,0
5_2557270,craves_boils_haroset,2557270,5,51,0,51,0
5_4553354,fears_sciatica_lubricity,4553354,5,49,0,49,0
5_2937679,craves_angina_onion,2937679,5,10,0,10,0
5_6123415,craves_lubricity_arugula,6123415,5,37,0,37,0
5_863863,craves_lubricity_yogurt,863863,5,37,0,37,0
5_7641058,fears_angina_satiety,7641058,5,45,0,45,0
5_7258771,fears_boils-1_lubricity,7258771,5,45,0,45,0
5_7831322,fears_laceration-8_lubricity,7831322,5,44,0,44,0
5_4201477,fears_depression-7_lubricity,4201477,5,44,0,44,0
5_7699444,fears_angina_love,7699444,5,40,0,40,0
5_7676246,overcome_loneliness_intoxication_potato_earth_uranus,7676246,5,1,0,1,0
5_1304243,overcome_sciatica_intoxication_wonderbread_earth_uranus,1304243,5,1,0,1,0
5_5543840,overcome_boils_intoxication_turkey_earth_uranus,5543840,5,1,0,1,0
5_3736639,overcome_loneliness_intoxication_yogurt_earth_uranus,3736639,5,1,0,1,0
5_5919289,overcome_angina_intoxication_onion_earth_uranus,5919289,5,1,0,1,0
5_910036,overcome_abrasion-4_intoxication_ham_earth_uranus,910036,5,1,0,1,0
5_1345384,overcome_jealousy-2_intoxication_wonderbread_earth_uranus,1345384,5,1,0,1,0
5_4851083,overcome_loneliness-3_intoxication_mutton_earth_uranus,4851083,5,1,0,1,0
5_451983,overcome_boils_intoxication_onion_earth_uranus,451983,5,1,0,1,0
5_5650231,overcome_loneliness_intoxication_shrimp_earth_uranus,5650231,5,1,0,1,0
5_1164130,overcome_abrasion-4_intoxication_onion_earth_uranus,1164130,5,1,0,1,0
5_4261129,overcome_abrasion_intoxication_yogurt_earth_uranus,4261129,5,1,0,1,0
5_2058678,overcome_boils-1_intoxication_potato_earth_uranus,2058678,5,1,0,1,0
5_4937327,overcome_boils_intoxication_potato_earth_uranus,4937327,5,1,0,1,0
5_2207425,overcome_loneliness-3_intoxication_onion_earth_uranus,2207425,5,1,0,1,0
5_6001224,overcome_abrasion-4_intoxication_wonderbread_earth_uranus,6001224,5,1,0,1,0
5_2592020,overcome_loneliness-3_intoxication_ham_earth_uranus,2592020,5,1,0,1,0
5_6149320,overcome_boils-1_intoxication_wonderbread_earth_uranus,6149320,5,1,0,1,0
5_7805069,overcome_boils-1_intoxication_arugula_earth_uranus,7805069,5,1,0,1,0
5_5726617,overcome_loneliness_intoxication_arugula_earth_uranus,5726617,5,1,0,1,0
5_2911312,overcome_boils_intoxication_shrimp_earth_uranus,2911312,5,1,0,1,0
5_1799804,overcome_abrasion-4_intoxication_mutton_earth_uranus,1799804,5,1,0,1,0
5_6691600,overcome_loneliness-3_intoxication_wonderbread_earth_uranus,6691600,5,1,0,1,0
5_4904343,harmony_intoxication_mercury,4904343,5,15,0,15,0
5_4775936,harmony_intoxication_earth,4775936,5,7,0,7,0
5_847602,fears_abrasion-4_intoxication,847602,5,30,0,30,0
5_3055707,fears_boils_intoxication,3055707,5,33,0,33,0
5_3237659,harmony_intoxication_saturn,3237659,5,11,0,11,0
5_7519785,feast_intoxication_arugula_potato_alsace_surrey,7519785,5,1,0,1,0
5_636882,feast_intoxication_arugula_wonderbread_bosnia_alsace,636882,5,1,0,1,0
5_719918,feast_intoxication_arugula_wonderbread_bavaria_guanabara,719918,5,1,0,1,0
5_4564663,feast_intoxication_arugula_potato_bosnia_alsace,4564663,5,1,0,1,0
5_3592004,feast_intoxication_arugula_wonderbread_alsace_surrey,3592004,5,1,0,1,0
5_7056651,feast_intoxication_arugula_potato_guanabara_bosnia,7056651,5,1,0,1,0
5_7535551,feast_intoxication_arugula_wonderbread_guanabara_bosnia,7535551,5,1,0,1,0
5_6137150,feast_intoxication_arugula_potato_bavaria_guanabara,6137150,5,1,0,1,0
5_7111845,craves_boils-1_ham,7111845,5,29,0,29,0
5_2391589,craves_boils-1_yogurt,2391589,5,27,0,27,0
5_152225,craves_intoxication_haroset,152225,5,30,0,30,0
5_945217,craves_intoxication_marzipan,945217,5,25,0,25,0
5_4833357,craves_boils-1_shrimp,4833357,5,30,0,30,0
5_7446485,craves_intoxication_ham,7446485,5,17,0,17,0
5_6829812,craves_intoxication_shrimp,6829812,5,19,0,19,0
5_193139,craves_intoxication_onion,193139,5,16,0,16,0
5_4081692,craves_intoxication_turkey,4081692,5,23,0,23,0
5_4660192,craves_intoxication_mutton,4660192,5,21,0,21,0
5_4388044,craves_intoxication_yogurt,4388044,5,17,0,17,0
5_2799049,craves_intoxication_wonderbread,2799049,5,15,0,15,0
5_857899,craves_intoxication_potato,857899,5,16,0,16,0
5_3666599,feast_love_cherry_marzipan_goias_bavaria,3666599,5,1,0,1,0
5_2563946,feast_love_cherry_rice_bavaria_guanabara,2563946,5,1,0,1,0
5_4786443,feast_love_cherry_rice_bosnia_alsace,4786443,5,1,0,1,0
5_1460940,feast_love_cherry_marzipan_bavaria_guanabara,1460940,5,1,0,1,0
5_959535,feast_love_cherry_marzipan_bosnia_alsace,959535,5,1,0,1,0
5_3667281,feast_love_cherry_rice_guanabara_bosnia,3667281,5,1,0,1,0
5_4254878,feast_love_cherry_endive_goias_bavaria,4254878,5,1,0,1,0
5_3267815,feast_love_cherry_endive_bavaria_guanabara,3267815,5,1,0,1,0
5_1547814,feast_love_cherry_endive_bosnia_alsace,1547814,5,1,0,1,0
5_5600709,feast_love_cherry_marzipan_guanabara_bosnia,5600709,5,1,0,1,0
5_7493507,feast_love_cherry_rice_goias_bavaria,7493507,5,1,0,1,0
5_4263853,feast_love_cherry_endive_guanabara_bosnia,4263853,5,1,0,1,0
5_4170497,fears_abrasion-4_love,4170497,5,47,0,47,0
5_1497644,fears_boils_love,1497644,5,48,0,48,0
5_1228789,craves_jealousy_onion,1228789,5,46,0,46,0
5_601638,craves_jealousy_endive,601638,5,47,0,47,0
5_222734,craves_jealousy_haroset,222734,5,46,0,46,0
5_2788630,craves_jealousy_wurst,2788630,5,44,0,44,0
5_7726461,craves_love_potato,7726461,5,50,0,50,0
5_7041704,craves_love_wonderbread,7041704,5,44,0,44,0
5_5754351,craves_jealousy_mutton,5754351,5,46,0,46,0
5_725535,craves_love_rice,725535,5,27,0,27,0
5_6290134,craves_love_haroset,6290134,5,29,0,29,0
5_4058429,craves_love_marzipan,4058429,5,25,0,25,0
5_3527777,craves_love_mutton,3527777,5,29,0,29,0
5_2657767,craves_love_onion,2657767,5,27,0,27,0
5_4217608,craves_love_wurst,4217608,5,28,0,28,0
5_2533325,craves_love_ham,2533325,5,33,0,33,0
5_2949277,craves_love_turkey,2949277,5,33,0,33,0
5_2054340,fears_prostatitis_love,2054340,5,37,0,37,0
5_2426690,craves_love_papaya,2426690,5,29,0,29,0
5_6376041,craves_love_endive,6376041,5,30,0,30,0
5_7530995,fears_laceration-8_love,7530995,5,39,0,39,0
5_5697397,craves_love_shrimp,5697397,5,33,0,33,0
5_1131397,fears_depression-7_love,1131397,5,39,0,39,0
5_4016940,succumb_hangover_satiety_papaya_mercury_saturn,4016940,5,1,0,1,0
5_6877091,fears_boils_satiety,6877091,5,51,0,51,0
5_6242386,craves_satiety_potato,6242386,5,48,0,48,0
5_4177385,craves_laceration_onion,4177385,5,46,0,46,0
5_6919532,fears_hangover_achievement,6919532,5,39,0,39,0
5_4901882,craves_satiety_wonderbread,4901882,5,42,0,42,0
5_5737226,craves_laceration_wurst,5737226,5,44,0,44,0
5_3207324,fears_abrasion-4_satiety,3207324,5,50,0,50,0
5_7814663,craves_laceration_haroset,7814663,5,46,0,46,0
5_502112,craves_laceration_mutton,502112,5,46,0,46,0
5_7402002,craves_laceration_papaya,7402002,5,46,0,46,0
5_1465202,craves_satiety_turkey,1465202,5,31,0,31,0
5_2043702,craves_satiety_mutton,2043702,5,28,0,28,0
5_2412853,craves_satiety_haroset,2412853,5,28,0,28,0
5_384409,craves_satiety_ham,384409,5,31,0,31,0
5_3430109,fears_prostatitis_satiety,3430109,5,41,0,41,0
5_3605459,fears_jealousy_satiety,3605459,5,40,0,40,0
5_7685259,fears_anxiety_satiety,7685259,5,36,0,36,0
5_7479014,fears_laceration-8_satiety,7479014,5,42,0,42,0
5_4531615,harmony_satiety_saturn,4531615,5,16,0,16,0
5_4891966,craves_satiety_endive,4891966,5,29,0,29,0
5_2484468,fears_laceration_satiety,2484468,5,32,0,32,0
5_2164069,fears_depression_satiety,2164069,5,41,0,41,0
5_5408021,craves_hangover_wurst,5408021,5,10,0,10,0
5_4213322,craves_satiety_shrimp,4213322,5,31,0,31,0
5_4866225,craves_satiety_cherry,4866225,5,27,0,27,0
5_166176,fears_depression-7_satiety,166176,5,42,0,42,0
5_1272578,locale_cherry_alsace,1272578,5,61,0,61,0
5_4824435,craves_hangover_rice,4824435,5,10,0,10,0
5_4573088,fears_dread_satiety,4573088,5,44,0,44,0
5_3595641,craves_satiety_marzipan,3595641,5,25,0,25,0
5_3135292,craves_hangover_papaya,3135292,5,10,0,10,0
5_4495945,craves_satiety_onion,4495945,5,26,0,26,0
5_2909346,fears_anger_satiety,2909346,5,36,0,36,0
5_3477698,fears_grief_satiety,3477698,5,41,0,41,0
5_6026349,fears_hangover_love,6026349,5,31,0,31,0
5_2767994,feast_rest_haroset_turkey_goias_bavaria,2767994,5,1,0,1,0
5_4350944,feast_rest_haroset_marzipan_goias_bavaria,4350944,5,1,0,1,0
5_4863440,feast_rest_haroset_marzipan_bavaria_guanabara,4863440,5,1,0,1,0
5_3767412,feast_rest_haroset_turkey_bavaria_guanabara,3767412,5,1,0,1,0
5_868003,craves_rest_onion,868003,5,37,0,37,0
5_1403882,craves_rest_mutton,1403882,5,38,0,38,0
5_6284244,craves_rest_ham,6284244,5,35,0,35,0
5_5529098,fears_jealousy_lubricity,5529098,5,50,0,50,0
5_575897,craves_jealousy_cherry,575897,5,14,0,14,0
5_804392,fears_dread_love,804392,5,31,0,31,0
5_4864290,harmony_love_earth,4864290,5,9,0,9,0
5_2564739,harmony_love_mercury,2564739,5,27,0,27,0
5_4484680,fears_jealousy_love,4484680,5,17,0,17,0
5_3042878,fears_jealousy_achievement,3042878,5,38,0,38,0
5_5019078,fears_grief_love,5019078,5,36,0,36,0
5_2993567,craves_jealousy_marzipan,2993567,5,14,0,14,0
5_3282766,craves_jealousy_rice,3282766,5,14,0,14,0
5_4653264,craves_jealousy_papaya,4653264,5,14,0,14,0
5_7179962,fears_depression_love,7179962,5,36,0,36,0
5_3246453,fears_laceration_love,3246453,5,31,0,31,0
5_1853352,harmony_love_saturn,1853352,5,14,0,14,0
5_6350300,craves_love_cherry,6350300,5,26,0,26,0
5_2366283,harmony_excitement_earth,2366283,5,9,0,9,0
5_3509029,craves_excitement_mutton,3509029,5,33,0,33,0
5_6533167,craves_excitement_onion,6533167,5,31,0,31,0
5_7131947,locale_onion_alsace,7131947,5,23,0,23,0
5_4271646,craves_achievement_rice,4271646,5,23,0,23,0
5_863045,locale_endive_alsace,863045,5,36,0,36,0
5_7928595,craves_achievement_endive,7928595,5,28,0,28,0
5_3979244,craves_achievement_papaya,3979244,5,34,0,34,0
5_1330794,locale_endive_goias,1330794,5,36,0,36,0
5_2423393,craves_grief_marzipan,2423393,5,42,0,42,0
5_3545441,fears_prostatitis_achievement,3545441,5,36,0,36,0
5_4530591,fears_depression_entertainment,4530591,5,42,0,42,0
5_2980884,craves_grief_rice,2980884,5,42,0,42,0
5_6351782,craves_achievement_onion,6351782,5,31,0,31,0
5_5080331,craves_achievement_mutton,5080331,5,33,0,33,0
5_1976428,fears_depression_achievement,1976428,5,19,0,19,0
5_2984277,harmony_achievement_saturn,2984277,5,9,0,9,0
5_3723475,fears_grief_achievement,3723475,5,19,0,19,0
5_7911623,craves_achievement_wurst,7911623,5,28,0,28,0
5_4059168,harmony_achievement_uranus,4059168,5,22,0,22,0
5_4046367,harmony_achievement_mercury,4046367,5,25,0,25,0
5_3812864,craves_achievement_marzipan,3812864,5,25,0,25,0
5_5021913,fears_grief_entertainment,5021913,5,42,0,42,0
5_562209,fears_laceration_achievement,562209,5,27,0,27,0
5_3695108,craves_achievement_haroset,3695108,5,33,0,33,0
5_2122856,fears_anxiety_achievement,2122856,5,40,0,40,0
5_7129906,fears_dread_achievement,7129906,5,39,0,39,0
5_1602106,craves_depression_rice,1602106,5,42,0,42,0
5_277606,craves_depression_marzipan,277606,5,42,0,42,0
5_7902854,craves_achievement_cherry,7902854,5,26,0,26,0
5_4333152,fears_anger_achievement,4333152,5,40,0,40,0
5_6688887,craves_dread_wurst,6688887,5,10,0,10,0
5_2996931,craves_dread_papaya,2996931,5,10,0,10,0
5_6767175,craves_dread_rice,6767175,5,10,0,10,0
5_5254895,feast_satisfaction_yogurt_wonderbread_guanabara_bosnia,5254895,5,1,0,1,0
5_2996889,feast_satisfaction_yogurt_potato_guanabara_bosnia,2996889,5,1,0,1,0
5_5305331,feast_lubricity_yogurt_potato_guanabara_bosnia,5305331,5,1,0,1,0
5_4313776,feast_intoxication_yogurt_wonderbread_guanabara_bosnia,4313776,5,1,0,1,0
5_5465373,feast_intoxication_yogurt_potato_guanabara_bosnia,5465373,5,1,0,1,0
5_505873,feast_lubricity_yogurt_wonderbread_guanabara_bosnia,505873,5,1,0,1,0
5_7233468,feast_rest_yogurt_wonderbread_guanabara_bosnia,7233468,5,1,0,1,0
5_3965200,feast_rest_yogurt_potato_guanabara_bosnia,3965200,5,1,0,1,0
5_74373,locale_yogurt_guanabara,74373,5,2,0,2,0
5_1038288,locale_yogurt_bavaria,1038288,5,2,0,2,0
5_3883948,fears_loneliness_intoxication,3883948,5,19,0,19,0
5_7083984,craves_loneliness_shrimp,7083984,5,11,0,11,0
5_6847927,fears_loneliness_lubricity,6847927,5,38,0,38,0
5_1112071,craves_loneliness_potato,1112071,5,11,0,11,0
5_4642216,craves_loneliness_yogurt,4642216,5,11,0,11,0
5_5263566,craves_loneliness_arugula,5263566,5,11,0,11,0
5_116045,harmony_satiety_mercury,116045,5,7,0,7,0
5_6055786,craves_satiety_wurst,6055786,5,27,0,27,0
5_5233736,fears_laceration_lubricity,5233736,5,50,0,50,0
5_3324635,craves_laceration_cherry,3324635,5,14,0,14,0
5_2289980,craves_laceration_marzipan,2289980,5,14,0,14,0
5_3350376,craves_laceration_endive,3350376,5,14,0,14,0
5_5669574,craves_laceration_rice,5669574,5,14,0,14,0
5_2670452,craves_satiety_rice,2670452,5,26,0,26,0
5_7052500,fears_hangover_satiety,7052500,5,44,0,44,0
5_1028645,craves_anger_mutton,1028645,5,12,0,12,0
5_809839,fears_anger_love,809839,5,19,0,19,0
5_6638384,fears_anger_lubricity,6638384,5,43,0,43,0
5_6523478,craves_anger_onion,6523478,5,12,0,12,0
5_6772622,craves_anger_rice,6772622,5,11,0,11,0
5_3851168,craves_anger_cherry,3851168,5,11,0,11,0
5_942867,craves_anger_marzipan,942867,5,11,0,11,0
5_1762048,feast_rest_shrimp_onion_bavaria_guanabara,1762048,5,1,0,1,0
5_7373443,feast_rest_shrimp_onion_goias_bavaria,7373443,5,1,0,1,0
5_4611540,feast_rest_shrimp_turkey_goias_bavaria,4611540,5,1,0,1,0
5_6656688,feast_rest_shrimp_potato_bosnia_alsace,6656688,5,1,0,1,0
5_5976931,feast_rest_shrimp_onion_guanabara_bosnia,5976931,5,1,0,1,0
5_4666379,feast_rest_shrimp_onion_bosnia_alsace,4666379,5,1,0,1,0
5_1904476,feast_rest_shrimp_turkey_bosnia_alsace,1904476,5,1,0,1,0
5_1362775,feast_rest_shrimp_potato_goias_bavaria,1362775,5,1,0,1,0
5_4495508,feast_rest_shrimp_potato_guanabara_bosnia,4495508,5,1,0,1,0
5_6564656,feast_rest_shrimp_potato_bavaria_guanabara,6564656,5,1,0,1,0
5_4995154,feast_rest_shrimp_turkey_guanabara_bosnia,4995154,5,1,0,1,0
5_6458400,feast_rest_shrimp_turkey_bavaria_guanabara,6458400,5,1,0,1,0
5_5363348,feast_excitement_cherry_rice_guanabara_bosnia,5363348,5,1,0,1,0
5_1108045,feast_excitement_cherry_marzipan_guanabara_bosnia,1108045,5,1,0,1,0
5_3479644,feast_excitement_cherry_marzipan_bavaria_guanabara,3479644,5,1,0,1,0
5_5806993,feast_excitement_cherry_marzipan_goias_bavaria,5806993,5,1,0,1,0
5_4704340,feast_excitement_cherry_rice_bavaria_guanabara,4704340,5,1,0,1,0
5_2566589,feast_excitement_cherry_rice_bosnia_alsace,2566589,5,1,0,1,0
5_3000235,feast_excitement_cherry_endive_bavaria_guanabara,3000235,5,1,0,1,0
5_3099929,feast_excitement_cherry_marzipan_bosnia_alsace,3099929,5,1,0,1,0
5_5667925,feast_excitement_cherry_endive_goias_bavaria,5667925,5,1,0,1,0
5_2960861,feast_excitement_cherry_endive_bosnia_alsace,2960861,5,1,0,1,0
5_137304,feast_excitement_cherry_endive_guanabara_bosnia,137304,5,1,0,1,0
5_5273653,feast_excitement_cherry_rice_goias_bavaria,5273653,5,1,0,1,0
5_2776295,feast_satiety_mutton_marzipan_bavaria_guanabara,2776295,5,1,0,1,0
5_7604645,feast_satiety_mutton_ham_goias_bavaria,7604645,5,1,0,1,0
5_6601673,feast_satiety_mutton_ham_bavaria_guanabara,6601673,5,1,0,1,0
5_3502772,feast_satiety_mutton_marzipan_goias_bavaria,3502772,5,1,0,1,0
5_942615,craves_satiety_papaya,942615,5,29,0,29,0
5_5089898,succumb_anxiety_love_onion_earth_uranus,5089898,5,1,0,1,0
5_3029990,succumb_anxiety_love_rice_earth_uranus,3029990,5,1,0,1,0
5_6380290,succumb_anxiety_love_rice_saturn_earth,6380290,5,1,0,1,0
5_6674287,succumb_anxiety_love_mutton_earth_uranus,6674287,5,1,0,1,0
5_4355430,succumb_anxiety_love_haroset_earth_uranus,4355430,5,1,0,1,0
5_2507873,succumb_anxiety_love_cherry_earth_uranus,2507873,5,1,0,1,0
5_5858173,succumb_anxiety_love_cherry_saturn_earth,5858173,5,1,0,1,0
5_3528352,succumb_anxiety_love_marzipan_earth_uranus,3528352,5,1,0,1,0
5_6878652,succumb_anxiety_love_marzipan_saturn_earth,6878652,5,1,0,1,0
5_3837243,craves_anxiety_onion,3837243,5,12,0,12,0
5_4259030,craves_anxiety_cherry,4259030,5,11,0,11,0
5_6990473,craves_anxiety_haroset,6990473,5,12,0,12,0
5_105066,craves_anxiety_rice,105066,5,11,0,11,0
5_1436507,craves_anxiety_mutton,1436507,5,12,0,12,0
5_7323719,craves_anxiety_marzipan,7323719,5,11,0,11,0
5_2652512,fears_anxiety_lubricity,2652512,5,43,0,43,0
5_6965088,feast_satisfaction_yogurt_potato_bavaria_guanabara,6965088,5,1,0,1,0
5_4317975,feast_satisfaction_yogurt_potato_goias_bavaria,4317975,5,1,0,1,0
5_7270672,feast_satisfaction_yogurt_wonderbread_goias_bavaria,7270672,5,1,0,1,0
5_943303,feast_satisfaction_yogurt_wonderbread_bavaria_guanabara,943303,5,1,0,1,0
5_5857448,feast_satiety_rice_marzipan_guanabara_bosnia,5857448,5,1,0,1,0
5_592492,feast_satiety_rice_marzipan_bosnia_alsace,592492,5,1,0,1,0
5_729890,feast_satiety_rice_cherry_guanabara_bosnia,729890,5,1,0,1,0
5_2683688,feast_satiety_rice_cherry_bavaria_guanabara,2683688,5,1,0,1,0
5_4011732,feast_satiety_rice_papaya_guanabara_bosnia,4011732,5,1,0,1,0
5_4818375,feast_satiety_rice_cherry_goias_bavaria,4818375,5,1,0,1,0
5_7080972,feast_satiety_rice_papaya_goias_bavaria,7080972,5,1,0,1,0
5_2111311,feast_satiety_rice_cherry_bosnia_alsace,2111311,5,1,0,1,0
5_3178308,feast_satiety_rice_marzipan_bavaria_guanabara,3178308,5,1,0,1,0
5_4373908,feast_satiety_rice_papaya_bosnia_alsace,4373908,5,1,0,1,0
5_3299556,feast_satiety_rice_marzipan_goias_bavaria,3299556,5,1,0,1,0
5_2732655,feast_satiety_rice_papaya_bavaria_guanabara,2732655,5,1,0,1,0
5_3125399,succumb_laceration_love_rice_saturn_earth,3125399,5,1,0,1,0
5_732995,succumb_anger_love_cherry_saturn_earth,732995,5,1,0,1,0
5_5711594,overcome_depression_love_cherry_mercury_saturn,5711594,5,1,0,1,0
5_7369394,succumb_laceration_love_cherry_saturn_earth,7369394,5,1,0,1,0
5_3954493,overcome_jealousy_love_rice_mercury_saturn,3954493,5,1,0,1,0
5_6180992,succumb_jealousy_love_marzipan_saturn_earth,6180992,5,1,0,1,0
5_3470541,overcome_laceration_love_marzipan_mercury_saturn,3470541,5,1,0,1,0
5_7134891,overcome_anger_love_marzipan_mercury_saturn,7134891,5,1,0,1,0
5_2489388,overcome_laceration_love_cherry_mercury_saturn,2489388,5,1,0,1,0
5_6443636,succumb_hangover_love_rice_saturn_earth,6443636,5,1,0,1,0
5_346533,succumb_dread_love_papaya_saturn_earth,346533,5,1,0,1,0
5_4498133,succumb_jealousy_love_cherry_saturn_earth,4498133,5,1,0,1,0
5_7598529,overcome_laceration_love_rice_mercury_saturn,7598529,5,1,0,1,0
5_4250926,overcome_hangover_love_rice_mercury_saturn,4250926,5,1,0,1,0
5_1789075,succumb_anger_love_rice_saturn_earth,1789075,5,1,0,1,0
5_2163825,succumb_laceration_love_marzipan_saturn_earth,2163825,5,1,0,1,0
5_2850519,succumb_jealousy_love_papaya_saturn_earth,2850519,5,1,0,1,0
5_4254416,overcome_anxiety_love_marzipan_mercury_saturn,4254416,5,1,0,1,0
5_1277313,succumb_dread_love_rice_saturn_earth,1277313,5,1,0,1,0
5_1486762,overcome_dread_love_papaya_mercury_saturn,1486762,5,1,0,1,0
5_585158,overcome_dread_love_rice_mercury_saturn,585158,5,1,0,1,0
5_3923008,overcome_hangover_love_papaya_mercury_saturn,3923008,5,1,0,1,0
5_4227704,succumb_anger_love_marzipan_saturn_earth,4227704,5,1,0,1,0
5_3146952,succumb_hangover_love_papaya_saturn_earth,3146952,5,1,0,1,0
5_5236301,overcome_grief_love_cherry_mercury_saturn,5236301,5,1,0,1,0
5_5135000,succumb_jealousy_love_rice_saturn_earth,5135000,5,1,0,1,0
5_2928243,harmony_love_uranus,2928243,5,12,0,12,0
5_2682855,succumb_anger_achievement_marzipan_saturn_earth,2682855,5,1,0,1,0
5_3962347,harmony_achievement_earth,3962347,5,13,0,13,0
5_6590502,craves_anger_haroset,6590502,5,12,0,12,0
5_6358943,succumb_abrasion-4_intoxication_ham_earth_uranus,6358943,5,1,0,1,0
5_6161127,locale_arugula_surrey,6161127,5,23,0,23,0
5_4462730,craves_abrasion-4_ham,4462730,5,14,0,14,0
5_4539735,fears_abrasion-4_lubricity,4539735,5,47,0,47,0
5_4203350,craves_intoxication_arugula,4203350,5,17,0,17,0
5_4312550,harmony_intoxication_uranus,4312550,5,7,0,7,0
5_3911231,feast_satiety_turkey_shrimp_goias_bavaria,3911231,5,1,0,1,0
5_3093410,feast_satiety_turkey_haroset_goias_bavaria,3093410,5,1,0,1,0
5_2914055,harmony_rest_mercury,2914055,5,12,0,12,0
5_1006816,craves_laceration-8_haroset,1006816,5,6,0,6,0
5_4456544,feast_satiety_haroset_marzipan_bavaria_guanabara,4456544,5,1,0,1,0
5_93129,feast_satiety_haroset_turkey_bavaria_guanabara,93129,5,1,0,1,0
5_6905277,feast_satiety_haroset_marzipan_goias_bavaria,6905277,5,1,0,1,0
5_445850,feast_satiety_haroset_turkey_goias_bavaria,445850,5,1,0,1,0
5_5892744,succumb_sciatica_rest_arugula_mercury_saturn,5892744,5,1,0,1,0
5_7929137,succumb_sciatica_rest_ham_mercury_saturn,7929137,5,1,0,1,0
5_2950032,succumb_sciatica_rest_yogurt_mercury_saturn,2950032,5,1,0,1,0
5_5273458,succumb_sciatica_rest_wonderbread_mercury_saturn,5273458,5,1,0,1,0
5_2806898,craves_sciatica_ham,2806898,5,6,0,6,0
5_4108439,craves_sciatica_yogurt,4108439,5,6,0,6,0
5_4633263,craves_sciatica_arugula,4633263,5,6,0,6,0
5_5852117,fears_sciatica_intoxication,5852117,5,14,0,14,0
5_6255097,craves_sciatica_wonderbread,6255097,5,6,0,6,0
5_4019094,succumb_laceration_love_cherry_earth_uranus,4019094,5,1,0,1,0
5_761530,succumb_laceration_love_endive_earth_uranus,761530,5,1,0,1,0
5_7776076,succumb_laceration_love_rice_earth_uranus,7776076,5,1,0,1,0
5_6814502,succumb_laceration_love_marzipan_earth_uranus,6814502,5,1,0,1,0
5_1727488,feast_rest_onion_ham_guanabara_bosnia,1727488,5,1,0,1,0
5_513134,feast_rest_onion_marzipan_bosnia_alsace,513134,5,1,0,1,0
5_5995026,feast_rest_onion_ham_bosnia_alsace,5995026,5,1,0,1,0
5_7149765,feast_rest_onion_shrimp_bosnia_alsace,7149765,5,1,0,1,0
5_505963,feast_rest_onion_marzipan_bavaria_guanabara,505963,5,1,0,1,0
5_2037512,feast_rest_onion_ham_bavaria_guanabara,2037512,5,1,0,1,0
5_2127805,feast_rest_onion_marzipan_guanabara_bosnia,2127805,5,1,0,1,0
5_5678553,feast_rest_onion_shrimp_guanabara_bosnia,5678553,5,1,0,1,0
5_5387050,feast_rest_onion_shrimp_bavaria_guanabara,5387050,5,1,0,1,0
5_6926845,succumb_angina_satisfaction_onion_mercury_saturn,6926845,5,1,0,1,0
5_131867,harmony_satisfaction_saturn,131867,5,15,0,15,0
5_2249450,fears_angina_lubricity,2249450,5,28,0,28,0
5_4011309,succumb_abrasion_rest_yogurt_mercury_saturn,4011309,5,1,0,1,0
5_3827038,succumb_boils_rest_shrimp_mercury_saturn,3827038,5,1,0,1,0
5_7185198,craves_boils_ham,7185198,5,51,0,51,0
5_561508,craves_boils_marzipan,561508,5,50,0,50,0
5_5022204,fears_boils_lubricity,5022204,5,23,0,23,0
5_6580064,craves_boils_onion,6580064,5,16,0,16,0
5_1682327,craves_boils_shrimp,1682327,5,15,0,15,0
5_6935184,craves_boils_turkey,6935184,5,16,0,16,0
5_3711391,craves_boils_potato,3711391,5,15,0,15,0
5_5436552,fears_anxiety_love,5436552,5,19,0,19,0
5_5334695,craves_lubricity_potato,5334695,5,35,0,35,0
5_2072290,craves_lubricity_haroset,2072290,5,34,0,34,0
5_3958534,craves_lubricity_cherry,3958534,5,35,0,35,0
5_6292230,harmony_lubricity_saturn,6292230,5,21,0,21,0
5_2778773,harmony_lubricity_mercury,2778773,5,34,0,34,0
5_4947268,craves_lubricity_wonderbread,4947268,5,33,0,33,0
5_1005562,craves_lubricity_rice,1005562,5,35,0,35,0
5_1136011,craves_lubricity_mutton,1136011,5,36,0,36,0
5_557511,craves_lubricity_turkey,557511,5,36,0,36,0
5_3190749,craves_lubricity_ham,3190749,5,34,0,34,0
5_2335886,craves_lubricity_onion,2335886,5,31,0,31,0
5_3305631,craves_lubricity_shrimp,3305631,5,34,0,34,0
5_7367121,harmony_lubricity_uranus,7367121,5,18,0,18,0
5_4422260,craves_lubricity_marzipan,4422260,5,30,0,30,0
5_4380699,feast_lubricity_rice_marzipan_bavaria_guanabara,4380699,5,1,0,1,0
5_1050646,feast_love_rice_marzipan_bavaria_guanabara,1050646,5,1,0,1,0
5_7490639,feast_love_rice_cherry_bavaria_guanabara,7490639,5,1,0,1,0
5_1544088,feast_achievement_rice_cherry_bavaria_guanabara,1544088,5,1,0,1,0
5_5349174,feast_rest_rice_marzipan_bavaria_guanabara,5349174,5,1,0,1,0
5_1679023,feast_excitement_rice_papaya_bavaria_guanabara,1679023,5,1,0,1,0
5_5129221,feast_rest_rice_papaya_bavaria_guanabara,5129221,5,1,0,1,0
5_1540267,feast_lubricity_rice_papaya_bavaria_guanabara,1540267,5,1,0,1,0
5_783066,feast_excitement_rice_marzipan_bavaria_guanabara,783066,5,1,0,1,0
5_1630056,feast_excitement_rice_cherry_bavaria_guanabara,1630056,5,1,0,1,0
5_7539606,feast_love_rice_papaya_bavaria_guanabara,7539606,5,1,0,1,0
5_1593055,feast_achievement_rice_papaya_bavaria_guanabara,1593055,5,1,0,1,0
5_5080254,feast_rest_rice_cherry_bavaria_guanabara,5080254,5,1,0,1,0
5_7473003,feast_achievement_rice_marzipan_bavaria_guanabara,7473003,5,1,0,1,0
5_1491300,feast_lubricity_rice_cherry_bavaria_guanabara,1491300,5,1,0,1,0
5_1267029,locale_rice_goias,1267029,5,4,0,4,0
5_6090059,locale_rice_bosnia,6090059,5,3,0,3,0
5_5580230,locale_rice_bavaria,5580230,5,3,0,3,0
5_1496995,succumb_boils_lubricity_turkey_earth_uranus,1496995,5,1,0,1,0
5_6865444,succumb_boils_lubricity_shrimp_earth_uranus,6865444,5,1,0,1,0
5_4783042,succumb_boils_lubricity_arugula_earth_uranus,4783042,5,1,0,1,0
5_3842841,succumb_boils_lubricity_onion_earth_uranus,3842841,5,1,0,1,0
5_7193141,succumb_boils_lubricity_onion_saturn_earth,7193141,5,1,0,1,0
5_7207933,succumb_boils_lubricity_haroset_earth_uranus,7207933,5,1,0,1,0
5_890482,succumb_boils_lubricity_potato_earth_uranus,890482,5,1,0,1,0
5_4240782,succumb_boils_lubricity_potato_saturn_earth,4240782,5,1,0,1,0
5_4190873,succumb_boils_lubricity_ham_earth_uranus,4190873,5,1,0,1,0
5_2214767,succumb_boils_lubricity_shrimp_saturn_earth,2214767,5,1,0,1,0
5_5680213,succumb_boils_lubricity_marzipan_earth_uranus,5680213,5,1,0,1,0
5_4951852,succumb_boils_lubricity_yogurt_earth_uranus,4951852,5,1,0,1,0
5_1689195,feast_achievement_cherry_endive_bavaria_guanabara,1689195,5,1,0,1,0
5_1277090,feast_achievement_cherry_rice_bosnia_alsace,1277090,5,1,0,1,0
5_1522839,feast_achievement_cherry_marzipan_guanabara_bosnia,1522839,5,1,0,1,0
5_3380535,feast_achievement_cherry_endive_goias_bavaria,3380535,5,1,0,1,0
5_3862829,feast_achievement_cherry_rice_guanabara_bosnia,3862829,5,1,0,1,0
5_2132427,feast_achievement_cherry_endive_guanabara_bosnia,2132427,5,1,0,1,0
5_5721025,feast_achievement_cherry_marzipan_goias_bavaria,5721025,5,1,0,1,0
5_4618372,feast_achievement_cherry_rice_bavaria_guanabara,4618372,5,1,0,1,0
5_673471,feast_achievement_cherry_endive_bosnia_alsace,673471,5,1,0,1,0
5_3013961,feast_achievement_cherry_marzipan_bosnia_alsace,3013961,5,1,0,1,0
5_5654207,feast_achievement_cherry_marzipan_bavaria_guanabara,5654207,5,1,0,1,0
5_3984154,feast_achievement_cherry_rice_goias_bavaria,3984154,5,1,0,1,0
5_2555708,succumb_loneliness-3_intoxication_ham_earth_uranus,2555708,5,1,0,1,0
5_5258399,overcome_depression-7_achievement_haroset_saturn_earth,5258399,5,1,0,1,0
5_2793540,overcome_depression-7_satisfaction_haroset_mercury_saturn,2793540,5,1,0,1,0
5_6384339,overcome_depression-7_lubricity_haroset_earth_uranus,6384339,5,1,0,1,0
5_576134,overcome_depression-7_love_haroset_earth_uranus,576134,5,1,0,1,0
5_3926434,overcome_depression-7_love_haroset_saturn_earth,3926434,5,1,0,1,0
5_2846564,overcome_depression-7_satiety_haroset_mercury_saturn,2846564,5,1,0,1,0
5_1733662,overcome_depression-7_lubricity_haroset_saturn_earth,1733662,5,1,0,1,0
5_7417060,overcome_depression-7_excitement_haroset_earth_uranus,7417060,5,1,0,1,0
5_2592702,overcome_depression-7_rest_haroset_mercury_saturn,2592702,5,1,0,1,0
5_1050398,feast_lubricity_mutton_marzipan_bavaria_guanabara,1050398,5,1,0,1,0
5_2901246,feast_love_mutton_ham_bavaria_guanabara,2901246,5,1,0,1,0
5_3096794,feast_achievement_mutton_ham_bavaria_guanabara,3096794,5,1,0,1,0
5_2721542,feast_lubricity_mutton_ham_bavaria_guanabara,2721542,5,1,0,1,0
5_922840,feast_rest_mutton_ham_bavaria_guanabara,922840,5,1,0,1,0
5_7278434,feast_rest_mutton_marzipan_bavaria_guanabara,7278434,5,1,0,1,0
5_7365323,feast_excitement_mutton_marzipan_bavaria_guanabara,7365323,5,1,0,1,0
5_3501669,feast_intoxication_mutton_ham_bavaria_guanabara,3501669,5,1,0,1,0
5_5346619,feast_love_mutton_marzipan_bavaria_guanabara,5346619,5,1,0,1,0
5_4381063,feast_intoxication_mutton_marzipan_bavaria_guanabara,4381063,5,1,0,1,0
5_4597313,feast_excitement_mutton_ham_bavaria_guanabara,4597313,5,1,0,1,0
5_1538909,feast_achievement_mutton_marzipan_bavaria_guanabara,1538909,5,1,0,1,0
5_5123081,locale_mutton_bavaria,5123081,5,1,0,1,0
5_397409,locale_mutton_goias,397409,5,1,0,1,0
5_1776967,succumb_prostatitis_entertainment_wurst_earth_uranus,1776967,5,1,0,1,0
5_3477531,harmony_entertainment_uranus,3477531,5,6,0,6,0
5_4565062,craves_prostatitis_wurst,4565062,5,5,0,5,0
5_7557696,succumb_abrasion-4_rest_yogurt_mercury_saturn,7557696,5,1,0,1,0
5_6726996,succumb_abrasion-4_rest_onion_mercury_saturn,6726996,5,1,0,1,0
5_3681945,succumb_angina_rest_onion_mercury_saturn,3681945,5,1,0,1,0
5_7507245,succumb_loneliness-3_rest_ham_mercury_saturn,7507245,5,1,0,1,0
5_6471092,succumb_loneliness-3_rest_onion_mercury_saturn,6471092,5,1,0,1,0
5_7946239,succumb_abrasion-4_rest_marzipan_mercury_saturn,7946239,5,1,0,1,0
5_6168538,succumb_angina_rest_ham_mercury_saturn,6168538,5,1,0,1,0
5_6054088,succumb_loneliness-3_rest_yogurt_mercury_saturn,6054088,5,1,0,1,0
5_1408533,succumb_abrasion-4_rest_shrimp_mercury_saturn,1408533,5,1,0,1,0
5_7525083,succumb_loneliness-3_rest_marzipan_mercury_saturn,7525083,5,1,0,1,0
5_1310132,succumb_abrasion-4_rest_arugula_mercury_saturn,1310132,5,1,0,1,0
5_5683581,succumb_boils-1_rest_arugula_mercury_saturn,5683581,5,1,0,1,0
5_433380,succumb_loneliness-3_rest_arugula_mercury_saturn,433380,5,1,0,1,0
5_6351126,succumb_abrasion-4_rest_wonderbread_mercury_saturn,6351126,5,1,0,1,0
5_5425224,succumb_abrasion-4_rest_mutton_mercury_saturn,5425224,5,1,0,1,0
5_5971223,succumb_angina_rest_shrimp_mercury_saturn,5971223,5,1,0,1,0
5_3977670,succumb_loneliness-3_rest_wonderbread_mercury_saturn,3977670,5,1,0,1,0
5_3921616,succumb_loneliness-3_rest_mutton_mercury_saturn,3921616,5,1,0,1,0
5_3441113,succumb_anger_rest_marzipan_mercury_saturn,3441113,5,1,0,1,0
5_2754663,succumb_anxiety_rest_marzipan_mercury_saturn,2754663,5,1,0,1,0
5_5831263,succumb_abrasion-4_rest_ham_mercury_saturn,5831263,5,1,0,1,0
5_7884658,succumb_angina_rest_marzipan_mercury_saturn,7884658,5,1,0,1,0
5_7905902,succumb_loneliness-3_rest_shrimp_mercury_saturn,7905902,5,1,0,1,0
5_1091294,locale_potato_guanabara,1091294,5,2,0,2,0
5_3037449,locale_potato_bavaria,3037449,5,2,0,2,0
5_7566343,feast_rest_cherry_endive_bavaria_guanabara,7566343,5,1,0,1,0
5_5346237,feast_rest_cherry_rice_bosnia_alsace,5346237,5,1,0,1,0
5_6550127,feast_rest_cherry_marzipan_bosnia_alsace,6550127,5,1,0,1,0
5_1688875,feast_rest_cherry_rice_guanabara_bosnia,1688875,5,1,0,1,0
5_52324,feast_rest_cherry_rice_goias_bavaria,52324,5,1,0,1,0
5_3280522,feast_rest_cherry_endive_guanabara_bosnia,3280522,5,1,0,1,0
5_6434917,feast_rest_cherry_endive_goias_bavaria,6434917,5,1,0,1,0
5_1256214,feast_rest_cherry_marzipan_goias_bavaria,1256214,5,1,0,1,0
5_153561,feast_rest_cherry_rice_bavaria_guanabara,153561,5,1,0,1,0
5_3392755,feast_rest_cherry_marzipan_bavaria_guanabara,3392755,5,1,0,1,0
5_3727853,feast_rest_cherry_endive_bosnia_alsace,3727853,5,1,0,1,0
5_1889051,feast_rest_cherry_marzipan_guanabara_bosnia,1889051,5,1,0,1,0
5_6292496,craves_depression_cherry,6292496,5,10,0,10,0
5_6318237,craves_depression_endive,6318237,5,10,0,10,0
5_4592428,craves_depression_wurst,4592428,5,10,0,10,0
5_1694955,craves_depression-7_haroset,1694955,5,6,0,6,0
5_5094034,succumb_loneliness_satisfaction_turkey_mercury_saturn,5094034,5,1,0,1,0
5_6975880,succumb_loneliness_satisfaction_arugula_mercury_saturn,6975880,5,1,0,1,0
5_2152429,succumb_loneliness_satisfaction_wonderbread_mercury_saturn,2152429,5,1,0,1,0
5_4806077,succumb_loneliness_satisfaction_shrimp_mercury_saturn,4806077,5,1,0,1,0
5_5490115,succumb_loneliness_satisfaction_onion_mercury_saturn,5490115,5,1,0,1,0
5_2954263,succumb_loneliness_satisfaction_yogurt_mercury_saturn,2954263,5,1,0,1,0
5_5511802,succumb_loneliness_satisfaction_potato_mercury_saturn,5511802,5,1,0,1,0
5_7011323,succumb_abrasion_intoxication_yogurt_earth_uranus,7011323,5,1,0,1,0
5_7656458,succumb_anxiety_achievement_marzipan_saturn_earth,7656458,5,1,0,1,0
5_5089198,overcome_loneliness-3_satiety_mutton_mercury_saturn,5089198,5,1,0,1,0
5_2743940,overcome_loneliness-3_rest_mutton_mercury_saturn,2743940,5,1,0,1,0
5_7054490,overcome_loneliness-3_love_mutton_earth_uranus,7054490,5,1,0,1,0
5_450716,overcome_loneliness-3_excitement_mutton_earth_uranus,450716,5,1,0,1,0
5_2403813,overcome_loneliness-3_love_mutton_saturn_earth,2403813,5,1,0,1,0
5_1506856,overcome_loneliness-3_achievement_mutton_saturn_earth,1506856,5,1,0,1,0
5_1629653,overcome_loneliness-3_lubricity_mutton_earth_uranus,1629653,5,1,0,1,0
5_5173398,craves_boils-1_arugula,5173398,5,8,0,8,0
5_4731683,fears_boils-1_intoxication,4731683,5,11,0,11,0
5_6862421,craves_boils-1_potato,6862421,5,8,0,8,0
5_108360,craves_boils-1_wonderbread,108360,5,8,0,8,0
5_4418739,feast_satisfaction_onion_shrimp_bavaria_guanabara,4418739,5,1,0,1,0
5_2663134,feast_satisfaction_onion_shrimp_bosnia_alsace,2663134,5,1,0,1,0
5_5241834,feast_satisfaction_onion_ham_guanabara_bosnia,5241834,5,1,0,1,0
5_1522582,feast_satisfaction_onion_ham_bosnia_alsace,1522582,5,1,0,1,0
5_5025831,feast_satisfaction_onion_marzipan_bavaria_guanabara,5025831,5,1,0,1,0
5_2270476,feast_satisfaction_onion_marzipan_guanabara_bosnia,2270476,5,1,0,1,0
5_568668,feast_satisfaction_onion_marzipan_bosnia_alsace,568668,5,1,0,1,0
5_5600664,feast_satisfaction_onion_ham_bavaria_guanabara,5600664,5,1,0,1,0
5_3893303,feast_satisfaction_onion_shrimp_guanabara_bosnia,3893303,5,1,0,1,0
5_297638,overcome_jealousy-2_intoxication_wonderbread_mercury_saturn,297638,5,1,0,1,0
5_4695684,overcome_jealousy-2_intoxication_wonderbread_saturn_earth,4695684,5,1,0,1,0
5_2339572,overcome_jealousy-2_lubricity_wonderbread_earth_uranus,2339572,5,1,0,1,0
5_4810659,overcome_jealousy-2_rest_wonderbread_mercury_saturn,4810659,5,1,0,1,0
5_1155004,overcome_jealousy-2_satisfaction_wonderbread_mercury_saturn,1155004,5,1,0,1,0
5_5089849,overcome_grief_love_endive_earth_uranus,5089849,5,1,0,1,0
5_3603240,overcome_grief_achievement_endive_mercury_saturn,3603240,5,1,0,1,0
5_6230834,overcome_grief_achievement_endive_saturn_earth,6230834,5,1,0,1,0
5_5468925,overcome_grief_satiety_endive_mercury_saturn,5468925,5,1,0,1,0
5_439172,overcome_grief_love_endive_saturn_earth,439172,5,1,0,1,0
5_3450458,overcome_grief_excitement_endive_earth_uranus,3450458,5,1,0,1,0
5_5516608,craves_grief_wurst,5516608,5,10,0,10,0
5_2853266,craves_grief_cherry,2853266,5,10,0,10,0
5_4476649,feast_love_shrimp_potato_bosnia_alsace,4476649,5,1,0,1,0
5_179748,feast_satisfaction_shrimp_onion_bosnia_alsace,179748,5,1,0,1,0
5_5647495,feast_satiety_shrimp_potato_bosnia_alsace,5647495,5,1,0,1,0
5_3474193,feast_lubricity_shrimp_turkey_bosnia_alsace,3474193,5,1,0,1,0
5_3443538,feast_satiety_shrimp_onion_bosnia_alsace,3443538,5,1,0,1,0
5_895283,feast_satiety_shrimp_turkey_bosnia_alsace,895283,5,1,0,1,0
5_225428,feast_lubricity_shrimp_potato_bosnia_alsace,225428,5,1,0,1,0
5_5467628,feast_satisfaction_shrimp_turkey_bosnia_alsace,5467628,5,1,0,1,0
5_6760523,feast_intoxication_shrimp_potato_bosnia_alsace,6760523,5,1,0,1,0
5_7725414,feast_love_shrimp_turkey_bosnia_alsace,7725414,5,1,0,1,0
5_2218863,feast_satisfaction_shrimp_potato_bosnia_alsace,2218863,5,1,0,1,0
5_2008311,feast_intoxication_shrimp_turkey_bosnia_alsace,2008311,5,1,0,1,0
5_7323359,feast_intoxication_shrimp_onion_bosnia_alsace,7323359,5,1,0,1,0
5_7516608,feast_lubricity_shrimp_onion_bosnia_alsace,7516608,5,1,0,1,0
5_5376701,feast_love_shrimp_onion_bosnia_alsace,5376701,5,1,0,1,0
5_7315407,locale_shrimp_bosnia,7315407,5,3,0,3,0
5_7231215,locale_shrimp_bavaria,7231215,5,3,0,3,0
5_2178943,locale_shrimp_guanabara,2178943,5,3,0,3,0
5_3527197,feast_satisfaction_shrimp_potato_guanabara_bosnia,3527197,5,1,0,1,0
5_4026843,feast_satisfaction_shrimp_turkey_guanabara_bosnia,4026843,5,1,0,1,0
5_7049841,feast_satiety_shrimp_potato_guanabara_bosnia,7049841,5,1,0,1,0
5_5478839,feast_love_shrimp_potato_guanabara_bosnia,5478839,5,1,0,1,0
5_386339,feast_love_shrimp_onion_guanabara_bosnia,386339,5,1,0,1,0
5_5835639,feast_lubricity_shrimp_potato_guanabara_bosnia,5835639,5,1,0,1,0
5_7549487,feast_satiety_shrimp_turkey_guanabara_bosnia,7549487,5,1,0,1,0
5_5978485,feast_love_shrimp_turkey_guanabara_bosnia,5978485,5,1,0,1,0
5_6335285,feast_lubricity_shrimp_turkey_guanabara_bosnia,6335285,5,1,0,1,0
5_4191681,feast_satisfaction_shrimp_onion_guanabara_bosnia,4191681,5,1,0,1,0
5_5995681,feast_intoxication_shrimp_potato_guanabara_bosnia,5995681,5,1,0,1,0
5_2387977,feast_lubricity_shrimp_onion_guanabara_bosnia,2387977,5,1,0,1,0
5_6495327,feast_intoxication_shrimp_turkey_guanabara_bosnia,6495327,5,1,0,1,0
5_3580365,feast_satiety_shrimp_onion_guanabara_bosnia,3580365,5,1,0,1,0
5_2076064,feast_intoxication_shrimp_onion_guanabara_bosnia,2076064,5,1,0,1,0
5_282030,succumb_laceration_excitement_cherry_earth_uranus,282030,5,1,0,1,0
5_6541355,succumb_boils_intoxication_shrimp_earth_uranus,6541355,5,1,0,1,0
5_4944137,harmony_lubricity_earth,4944137,5,9,0,9,0
5_5647441,succumb_angina_satiety_onion_mercury_saturn,5647441,5,1,0,1,0
5_3202849,feast_achievement_haroset_marzipan_goias_bavaria,3202849,5,1,0,1,0
5_4941948,feast_achievement_haroset_turkey_goias_bavaria,4941948,5,1,0,1,0
5_7724808,feast_achievement_haroset_marzipan_bavaria_guanabara,7724808,5,1,0,1,0
5_3401200,feast_achievement_haroset_turkey_bavaria_guanabara,3401200,5,1,0,1,0
5_3111247,overcome_grief_satiety_wurst_mercury_saturn,3111247,5,1,0,1,0
5_3142942,overcome_grief_excitement_wurst_mercury_saturn,3142942,5,1,0,1,0
5_5603327,overcome_grief_love_wurst_earth_uranus,5603327,5,1,0,1,0
5_6415664,overcome_grief_excitement_wurst_saturn_earth,6415664,5,1,0,1,0
5_3065364,overcome_grief_excitement_wurst_earth_uranus,3065364,5,1,0,1,0
5_5090756,overcome_grief_entertainment_wurst_saturn_earth,5090756,5,1,0,1,0
5_1740456,overcome_grief_entertainment_wurst_earth_uranus,1740456,5,1,0,1,0
5_6538453,overcome_grief_achievement_wurst_saturn_earth,6538453,5,1,0,1,0
5_952650,overcome_grief_love_wurst_saturn_earth,952650,5,1,0,1,0
5_2879007,craves_grief_endive,2879007,5,10,0,10,0
5_7541487,locale_marzipan_alsace,7541487,5,2,0,2,0
5_5089410,locale_marzipan_bosnia,5089410,5,2,0,2,0
5_1582449,feast_excitement_marzipan_cherry_guanabara_bosnia,1582449,5,1,0,1,0
5_82049,feast_excitement_marzipan_onion_guanabara_bosnia,82049,5,1,0,1,0
5_6612090,feast_excitement_marzipan_cherry_bosnia_alsace,6612090,5,1,0,1,0
5_1566235,feast_excitement_marzipan_cherry_alsace_surrey,1566235,5,1,0,1,0
5_4038278,feast_excitement_marzipan_mutton_alsace_surrey,4038278,5,1,0,1,0
5_560928,feast_excitement_marzipan_mutton_guanabara_bosnia,560928,5,1,0,1,0
5_7899276,feast_excitement_marzipan_onion_alsace_surrey,7899276,5,1,0,1,0
5_5395724,feast_excitement_marzipan_haroset_bosnia_alsace,5395724,5,1,0,1,0
5_349869,feast_excitement_marzipan_haroset_alsace_surrey,349869,5,1,0,1,0
5_6084014,feast_excitement_marzipan_rice_bosnia_alsace,6084014,5,1,0,1,0
5_1038159,feast_excitement_marzipan_rice_alsace_surrey,1038159,5,1,0,1,0
5_1083156,feast_excitement_marzipan_mutton_bosnia_alsace,1083156,5,1,0,1,0
5_4944154,feast_excitement_marzipan_onion_bosnia_alsace,4944154,5,1,0,1,0
5_2394754,feast_excitement_marzipan_haroset_guanabara_bosnia,2394754,5,1,0,1,0
5_6318650,feast_excitement_marzipan_rice_guanabara_bosnia,6318650,5,1,0,1,0
5_7635499,succumb_anxiety_satiety_marzipan_mercury_saturn,7635499,5,1,0,1,0
5_7974847,succumb_anxiety_satiety_mutton_mercury_saturn,7974847,5,1,0,1,0
5_517446,succumb_anxiety_satiety_onion_mercury_saturn,517446,5,1,0,1,0
5_7209022,succumb_anxiety_satiety_cherry_mercury_saturn,7209022,5,1,0,1,0
5_1677712,succumb_anxiety_satiety_rice_mercury_saturn,1677712,5,1,0,1,0
5_184908,succumb_anxiety_satiety_haroset_mercury_saturn,184908,5,1,0,1,0
5_3478144,succumb_jealousy_excitement_rice_earth_uranus,3478144,5,1,0,1,0
5_6828444,succumb_jealousy_excitement_rice_saturn_earth,6828444,5,1,0,1,0
5_2844536,succumb_jealousy_excitement_papaya_saturn_earth,2844536,5,1,0,1,0
5_2776677,succumb_jealousy_excitement_marzipan_earth_uranus,2776677,5,1,0,1,0
5_7495213,succumb_jealousy_excitement_papaya_earth_uranus,7495213,5,1,0,1,0
5_1141850,succumb_jealousy_excitement_cherry_earth_uranus,1141850,5,1,0,1,0
5_7121790,succumb_jealousy_satiety_papaya_mercury_saturn,7121790,5,1,0,1,0
5_214883,succumb_jealousy_satiety_marzipan_mercury_saturn,214883,5,1,0,1,0
5_7099223,succumb_jealousy_satiety_rice_mercury_saturn,7099223,5,1,0,1,0
5_3967302,succumb_jealousy_satiety_cherry_mercury_saturn,3967302,5,1,0,1,0
5_4018899,succumb_laceration_achievement_rice_saturn_earth,4018899,5,1,0,1,0
5_524340,succumb_laceration_achievement_endive_mercury_saturn,524340,5,1,0,1,0
5_4634731,succumb_laceration_achievement_cherry_saturn_earth,4634731,5,1,0,1,0
5_6170330,succumb_laceration_achievement_cherry_mercury_saturn,6170330,5,1,0,1,0
5_1377167,succumb_laceration_achievement_endive_saturn_earth,1377167,5,1,0,1,0
5_5174257,succumb_laceration_achievement_marzipan_saturn_earth,5174257,5,1,0,1,0
5_834693,feast_excitement_rice_marzipan_bosnia_alsace,834693,5,1,0,1,0
5_537240,feast_love_rice_papaya_bosnia_alsace,537240,5,1,0,1,0
5_1601685,feast_rest_rice_marzipan_bosnia_alsace,1601685,5,1,0,1,0
5_1097034,feast_rest_rice_papaya_bosnia_alsace,1097034,5,1,0,1,0
5_6548280,feast_achievement_rice_marzipan_bosnia_alsace,6548280,5,1,0,1,0
5_7422623,feast_love_rice_marzipan_bosnia_alsace,7422623,5,1,0,1,0
5_6275620,feast_love_rice_cherry_bosnia_alsace,6275620,5,1,0,1,0
5_1689668,feast_lubricity_rice_cherry_bosnia_alsace,1689668,5,1,0,1,0
5_2766267,feast_achievement_rice_cherry_bosnia_alsace,2766267,5,1,0,1,0
5_4055766,feast_excitement_rice_cherry_bosnia_alsace,4055766,5,1,0,1,0
5_3952265,feast_lubricity_rice_papaya_bosnia_alsace,3952265,5,1,0,1,0
5_5028864,feast_achievement_rice_papaya_bosnia_alsace,5028864,5,1,0,1,0
5_6835414,feast_rest_rice_cherry_bosnia_alsace,6835414,5,1,0,1,0
5_6318363,feast_excitement_rice_papaya_bosnia_alsace,6318363,5,1,0,1,0
5_3171402,feast_lubricity_rice_marzipan_bosnia_alsace,3171402,5,1,0,1,0
5_437954,locale_rice_guanabara,437954,5,3,0,3,0
5_3876999,feast_rest_ham_mutton_bavaria_guanabara,3876999,5,1,0,1,0
5_6906997,feast_satisfaction_ham_wonderbread_bavaria_guanabara,6906997,5,1,0,1,0
5_3665438,feast_intoxication_ham_onion_bavaria_guanabara,3665438,5,1,0,1,0
5_7065083,feast_intoxication_ham_wonderbread_bavaria_guanabara,7065083,5,1,0,1,0
5_3932533,feast_satisfaction_ham_mutton_bavaria_guanabara,3932533,5,1,0,1,0
5_6455828,feast_intoxication_ham_mutton_bavaria_guanabara,6455828,5,1,0,1,0
5_1961477,feast_rest_ham_wonderbread_bavaria_guanabara,1961477,5,1,0,1,0
5_5131320,feast_lubricity_ham_onion_bavaria_guanabara,5131320,5,1,0,1,0
5_3734418,feast_lubricity_ham_wonderbread_bavaria_guanabara,3734418,5,1,0,1,0
5_5460315,feast_satiety_ham_wonderbread_bavaria_guanabara,5460315,5,1,0,1,0
5_1381564,feast_love_ham_onion_bavaria_guanabara,1381564,5,1,0,1,0
5_29662,feast_love_ham_wonderbread_bavaria_guanabara,29662,5,1,0,1,0
5_2552410,feast_satiety_ham_onion_bavaria_guanabara,2552410,5,1,0,1,0
5_7124755,feast_satisfaction_ham_onion_bavaria_guanabara,7124755,5,1,0,1,0
5_5855405,feast_love_ham_mutton_bavaria_guanabara,5855405,5,1,0,1,0
5_1554855,feast_satiety_ham_mutton_bavaria_guanabara,1554855,5,1,0,1,0
5_3561603,feast_rest_ham_onion_bavaria_guanabara,3561603,5,1,0,1,0
5_5675701,feast_lubricity_ham_mutton_bavaria_guanabara,5675701,5,1,0,1,0
5_3967861,locale_ham_bavaria,3967861,5,1,0,1,0
5_157616,locale_ham_goias,157616,5,1,0,1,0
5_159897,feast_excitement_rice_marzipan_guanabara_bosnia,159897,5,1,0,1,0
5_4286446,feast_love_rice_marzipan_guanabara_bosnia,4286446,5,1,0,1,0
5_4643246,feast_lubricity_rice_marzipan_guanabara_bosnia,4643246,5,1,0,1,0
5_5030440,feast_love_rice_cherry_guanabara_bosnia,5030440,5,1,0,1,0
5_5225988,feast_achievement_rice_cherry_guanabara_bosnia,5225988,5,1,0,1,0
5_4850736,feast_lubricity_rice_cherry_guanabara_bosnia,4850736,5,1,0,1,0
5_3052034,feast_rest_rice_cherry_guanabara_bosnia,3052034,5,1,0,1,0
5_6333876,feast_rest_rice_papaya_guanabara_bosnia,6333876,5,1,0,1,0
5_2007372,feast_excitement_rice_papaya_guanabara_bosnia,2007372,5,1,0,1,0
5_2155020,feast_achievement_rice_marzipan_guanabara_bosnia,2155020,5,1,0,1,0
5_3303115,feast_rest_rice_marzipan_guanabara_bosnia,3303115,5,1,0,1,0
5_6726507,feast_excitement_rice_cherry_guanabara_bosnia,6726507,5,1,0,1,0
5_311305,feast_love_rice_papaya_guanabara_bosnia,311305,5,1,0,1,0
5_506853,feast_achievement_rice_papaya_guanabara_bosnia,506853,5,1,0,1,0
5_131601,feast_lubricity_rice_papaya_guanabara_bosnia,131601,5,1,0,1,0
5_4351243,succumb_sciatica_intoxication_wonderbread_saturn_earth,4351243,5,1,0,1,0
5_5904586,succumb_boils-1_intoxication_arugula_saturn_earth,5904586,5,1,0,1,0
5_7126584,overcome_loneliness-3_intoxication_wonderbread_mercury_saturn,7126584,5,1,0,1,0
5_6942928,succumb_jealousy-2_intoxication_arugula_saturn_earth,6942928,5,1,0,1,0
5_1730674,succumb_loneliness_intoxication_potato_saturn_earth,1730674,5,1,0,1,0
5_686471,succumb_sciatica_intoxication_arugula_saturn_earth,686471,5,1,0,1,0
5_5129769,overcome_boils_intoxication_potato_mercury_saturn,5129769,5,1,0,1,0
5_5622962,succumb_boils-1_intoxication_wonderbread_saturn_earth,5622962,5,1,0,1,0
5_410311,overcome_sciatica_intoxication_wonderbread_mercury_saturn,410311,5,1,0,1,0
5_1006358,overcome_loneliness_intoxication_potato_mercury_saturn,1006358,5,1,0,1,0
5_2856908,succumb_boils-1_intoxication_potato_saturn_earth,2856908,5,1,0,1,0
5_169006,overcome_abrasion-4_intoxication_wonderbread_mercury_saturn,169006,5,1,0,1,0
5_5722904,overcome_loneliness_intoxication_arugula_mercury_saturn,5722904,5,1,0,1,0
5_5623854,succumb_loneliness_intoxication_arugula_saturn_earth,5623854,5,1,0,1,0
5_2053752,succumb_jealousy-2_intoxication_wonderbread_saturn_earth,2053752,5,1,0,1,0
5_2519751,overcome_boils-1_intoxication_arugula_mercury_saturn,2519751,5,1,0,1,0
5_5207110,succumb_prostatitis_satiety_wurst_mercury_saturn,5207110,5,1,0,1,0
5_2402640,harmony_entertainment_saturn,2402640,5,6,0,6,0
5_2810155,fears_prostatitis_entertainment,2810155,5,5,0,5,0
5_102332,feast_satiety_ham_mutton_goias_bavaria,102332,5,1,0,1,0
5_6136629,feast_satiety_ham_onion_goias_bavaria,6136629,5,1,0,1,0
5_7611715,feast_satiety_ham_wonderbread_goias_bavaria,7611715,5,1,0,1,0
5_4308749,feast_rest_rice_marzipan_goias_bavaria,4308749,5,1,0,1,0
5_3804098,feast_rest_rice_papaya_goias_bavaria,3804098,5,1,0,1,0
5_1541501,feast_rest_rice_cherry_goias_bavaria,1541501,5,1,0,1,0
5_4379955,locale_mutton_guanabara,4379955,5,1,0,1,0
5_419746,feast_lubricity_marzipan_rice_bosnia_alsace,419746,5,1,0,1,0
5_1878096,feast_lubricity_marzipan_haroset_bosnia_alsace,1878096,5,1,0,1,0
5_2464142,feast_lubricity_marzipan_cherry_guanabara_bosnia,2464142,5,1,0,1,0
5_6473334,feast_lubricity_marzipan_cherry_bosnia_alsace,6473334,5,1,0,1,0
5_3068383,feast_lubricity_marzipan_onion_bosnia_alsace,3068383,5,1,0,1,0
5_3679682,feast_lubricity_marzipan_onion_guanabara_bosnia,3679682,5,1,0,1,0
5_1427479,feast_lubricity_marzipan_cherry_alsace_surrey,1427479,5,1,0,1,0
5_2801022,feast_lubricity_marzipan_rice_guanabara_bosnia,2801022,5,1,0,1,0
5_3899522,feast_lubricity_marzipan_mutton_alsace_surrey,3899522,5,1,0,1,0
5_1442621,feast_lubricity_marzipan_mutton_guanabara_bosnia,1442621,5,1,0,1,0
5_3374868,feast_lubricity_marzipan_rice_alsace_surrey,3374868,5,1,0,1,0
5_4833218,feast_lubricity_marzipan_haroset_alsace_surrey,4833218,5,1,0,1,0
5_4080806,feast_lubricity_marzipan_haroset_guanabara_bosnia,4080806,5,1,0,1,0
5_6023505,feast_lubricity_marzipan_onion_alsace_surrey,6023505,5,1,0,1,0
5_944400,feast_lubricity_marzipan_mutton_bosnia_alsace,944400,5,1,0,1,0
5_6690149,feast_satiety_marzipan_cherry_guanabara_bosnia,6690149,5,1,0,1,0
5_312796,feast_achievement_marzipan_rice_guanabara_bosnia,312796,5,1,0,1,0
5_1997243,feast_achievement_marzipan_cherry_guanabara_bosnia,1997243,5,1,0,1,0
5_5053592,feast_love_marzipan_mutton_guanabara_bosnia,5053592,5,1,0,1,0
5_2477291,feast_satiety_marzipan_onion_guanabara_bosnia,2477291,5,1,0,1,0
5_1460891,feast_rest_marzipan_rice_guanabara_bosnia,1460891,5,1,0,1,0
5_6771986,feast_achievement_marzipan_onion_guanabara_bosnia,6771986,5,1,0,1,0
5_7253385,feast_satisfaction_marzipan_haroset_guanabara_bosnia,7253385,5,1,0,1,0
5_1341934,feast_rest_marzipan_mutton_guanabara_bosnia,1341934,5,1,0,1,0
5_492580,feast_satisfaction_marzipan_rice_guanabara_bosnia,492580,5,1,0,1,0
5_349629,feast_love_marzipan_onion_guanabara_bosnia,349629,5,1,0,1,0
5_5668628,feast_satiety_marzipan_mutton_guanabara_bosnia,5668628,5,1,0,1,0
5_4790828,feast_satisfaction_marzipan_onion_guanabara_bosnia,4790828,5,1,0,1,0
5_4015224,feast_satiety_marzipan_rice_guanabara_bosnia,4015224,5,1,0,1,0
5_6883323,feast_satisfaction_marzipan_cherry_guanabara_bosnia,6883323,5,1,0,1,0
5_2444222,feast_love_marzipan_rice_guanabara_bosnia,2444222,5,1,0,1,0
5_975722,feast_achievement_marzipan_mutton_guanabara_bosnia,975722,5,1,0,1,0
5_4569317,feast_achievement_marzipan_haroset_guanabara_bosnia,4569317,5,1,0,1,0
5_2307865,feast_rest_marzipan_haroset_guanabara_bosnia,2307865,5,1,0,1,0
5_6075113,feast_love_marzipan_cherry_guanabara_bosnia,6075113,5,1,0,1,0
5_4648157,feast_rest_marzipan_onion_guanabara_bosnia,4648157,5,1,0,1,0
5_2363455,feast_rest_marzipan_cherry_guanabara_bosnia,2363455,5,1,0,1,0
5_5806703,feast_satiety_marzipan_haroset_guanabara_bosnia,5806703,5,1,0,1,0
5_5861802,feast_satisfaction_marzipan_mutton_guanabara_bosnia,5861802,5,1,0,1,0
5_376050,feast_love_marzipan_haroset_guanabara_bosnia,376050,5,1,0,1,0
5_2021859,locale_marzipan_guanabara,2021859,5,2,0,2,0
5_4716892,overcome_boils-1_lubricity_wonderbread_earth_uranus,4716892,5,1,0,1,0
5_1460727,overcome_boils-1_satisfaction_wonderbread_mercury_saturn,1460727,5,1,0,1,0
5_944720,overcome_boils-1_rest_wonderbread_mercury_saturn,944720,5,1,0,1,0
5_1350547,overcome_abrasion-4_intoxication_wonderbread_saturn_earth,1350547,5,1,0,1,0
5_6387438,overcome_abrasion-4_rest_wonderbread_mercury_saturn,6387438,5,1,0,1,0
5_5911679,overcome_abrasion-4_lubricity_wonderbread_earth_uranus,5911679,5,1,0,1,0
5_1026372,overcome_abrasion-4_satisfaction_wonderbread_mercury_saturn,1026372,5,1,0,1,0
5_7948646,overcome_abrasion-4_lubricity_mutton_earth_uranus,7948646,5,1,0,1,0
5_3656889,overcome_abrasion-4_love_mutton_earth_uranus,3656889,5,1,0,1,0
5_7007189,overcome_abrasion-4_love_mutton_saturn_earth,7007189,5,1,0,1,0
5_1915570,overcome_abrasion-4_excitement_mutton_earth_uranus,1915570,5,1,0,1,0
5_3407214,overcome_abrasion-4_satiety_mutton_mercury_saturn,3407214,5,1,0,1,0
5_4754714,overcome_abrasion-4_rest_mutton_mercury_saturn,4754714,5,1,0,1,0
5_463561,overcome_abrasion-4_achievement_mutton_saturn_earth,463561,5,1,0,1,0
5_3992670,locale_onion_guanabara,3992670,5,2,0,2,0
5_4679870,locale_onion_bosnia,4679870,5,2,0,2,0
5_1024883,locale_turkey_bavaria,1024883,5,3,0,3,0
5_2275249,overcome_laceration_excitement_endive_earth_uranus,2275249,5,1,0,1,0
5_2113794,overcome_depression_excitement_cherry_earth_uranus,2113794,5,1,0,1,0
5_5392141,overcome_laceration_excitement_rice_earth_uranus,5392141,5,1,0,1,0
5_3292190,overcome_dread_excitement_papaya_earth_uranus,3292190,5,1,0,1,0
5_790639,overcome_prostatitis_excitement_wurst_earth_uranus,790639,5,1,0,1,0
5_158738,overcome_loneliness-3_excitement_onion_earth_uranus,158738,5,1,0,1,0
5_6317537,overcome_jealousy_excitement_papaya_earth_uranus,6317537,5,1,0,1,0
5_2807634,overcome_jealousy_excitement_rice_earth_uranus,2807634,5,1,0,1,0
5_2870934,overcome_dread_excitement_wurst_earth_uranus,2870934,5,1,0,1,0
5_26483,overcome_jealousy_excitement_marzipan_earth_uranus,26483,5,1,0,1,0
5_6477731,overcome_abrasion-4_excitement_onion_earth_uranus,6477731,5,1,0,1,0
5_6708022,overcome_grief_excitement_cherry_earth_uranus,6708022,5,1,0,1,0
5_2672372,overcome_depression_excitement_wurst_earth_uranus,2672372,5,1,0,1,0
5_2597569,overcome_angina_excitement_onion_earth_uranus,2597569,5,1,0,1,0
5_773917,overcome_anxiety_excitement_marzipan_earth_uranus,773917,5,1,0,1,0
5_6036864,overcome_dread_excitement_rice_earth_uranus,6036864,5,1,0,1,0
5_5532813,overcome_laceration_excitement_cherry_earth_uranus,5532813,5,1,0,1,0
5_5789063,overcome_laceration_excitement_marzipan_earth_uranus,5789063,5,1,0,1,0
5_5184812,overcome_hangover_excitement_wurst_earth_uranus,5184812,5,1,0,1,0
5_3572660,overcome_hangover_excitement_papaya_earth_uranus,3572660,5,1,0,1,0
5_6927360,overcome_boils_excitement_onion_earth_uranus,6927360,5,1,0,1,0
5_166809,overcome_anger_excitement_marzipan_earth_uranus,166809,5,1,0,1,0
5_7959559,overcome_laceration-8_excitement_haroset_earth_uranus,7959559,5,1,0,1,0
5_357708,overcome_hangover_excitement_rice_earth_uranus,357708,5,1,0,1,0
5_6857207,overcome_depression_excitement_endive_earth_uranus,6857207,5,1,0,1,0
5_7965151,overcome_jealousy_excitement_cherry_earth_uranus,7965151,5,1,0,1,0
5_4947099,feast_intoxication_ham_mutton_goias_bavaria,4947099,5,1,0,1,0
5_6581449,feast_love_ham_onion_goias_bavaria,6581449,5,1,0,1,0
5_1402192,feast_rest_ham_mutton_goias_bavaria,1402192,5,1,0,1,0
5_596239,feast_satisfaction_ham_mutton_goias_bavaria,596239,5,1,0,1,0
5_4417689,feast_love_ham_wonderbread_goias_bavaria,4417689,5,1,0,1,0
5_944538,feast_lubricity_ham_mutton_goias_bavaria,944538,5,1,0,1,0
5_2201938,feast_lubricity_ham_onion_goias_bavaria,2201938,5,1,0,1,0
5_3516386,feast_rest_ham_onion_goias_bavaria,3516386,5,1,0,1,0
5_686136,feast_intoxication_ham_onion_goias_bavaria,686136,5,1,0,1,0
5_6419327,feast_lubricity_ham_wonderbread_goias_bavaria,6419327,5,1,0,1,0
5_1962574,feast_love_ham_mutton_goias_bavaria,1962574,5,1,0,1,0
5_7044919,feast_satisfaction_ham_onion_goias_bavaria,7044919,5,1,0,1,0
5_6107414,feast_intoxication_ham_wonderbread_goias_bavaria,6107414,5,1,0,1,0
5_2007304,feast_rest_ham_wonderbread_goias_bavaria,2007304,5,1,0,1,0
5_222054,feast_satisfaction_ham_wonderbread_goias_bavaria,222054,5,1,0,1,0
5_6490141,feast_lubricity_turkey_shrimp_goias_bavaria,6490141,5,1,0,1,0
5_7214256,feast_lubricity_turkey_haroset_goias_bavaria,7214256,5,1,0,1,0
5_2310384,feast_lubricity_mutton_marzipan_goias_bavaria,2310384,5,1,0,1,0
5_445874,feast_lubricity_mutton_ham_goias_bavaria,445874,5,1,0,1,0
5_6562048,feast_intoxication_shrimp_potato_bavaria_guanabara,6562048,5,1,0,1,0
5_2029446,feast_intoxication_shrimp_onion_goias_bavaria,2029446,5,1,0,1,0
5_6455792,feast_intoxication_shrimp_turkey_bavaria_guanabara,6455792,5,1,0,1,0
5_4715375,feast_intoxication_shrimp_turkey_goias_bavaria,4715375,5,1,0,1,0
5_3262221,feast_intoxication_shrimp_onion_bavaria_guanabara,3262221,5,1,0,1,0
5_1466610,feast_intoxication_shrimp_potato_goias_bavaria,1466610,5,1,0,1,0
5_279197,overcome_prostatitis_achievement_wurst_saturn_earth,279197,5,1,0,1,0
5_4140939,overcome_prostatitis_excitement_wurst_saturn_earth,4140939,5,1,0,1,0
5_7759180,overcome_prostatitis_satiety_wurst_mercury_saturn,7759180,5,1,0,1,0
5_5230030,overcome_prostatitis_entertainment_wurst_earth_uranus,5230030,5,1,0,1,0
5_735774,overcome_prostatitis_love_wurst_earth_uranus,735774,5,1,0,1,0
5_4086074,overcome_prostatitis_love_wurst_saturn_earth,4086074,5,1,0,1,0
5_4749558,overcome_prostatitis_achievement_wurst_mercury_saturn,4749558,5,1,0,1,0
5_968806,overcome_prostatitis_excitement_wurst_mercury_saturn,968806,5,1,0,1,0
5_3500439,succumb_depression_love_endive_earth_uranus,3500439,5,1,0,1,0
5_1564660,succumb_anxiety_lubricity_marzipan_earth_uranus,1564660,5,1,0,1,0
5_4396732,feast_lubricity_rice_cherry_goias_bavaria,4396732,5,1,0,1,0
5_6659329,feast_lubricity_rice_papaya_goias_bavaria,6659329,5,1,0,1,0
5_5878466,feast_lubricity_rice_marzipan_goias_bavaria,5878466,5,1,0,1,0
5_2841049,overcome_loneliness-3_rest_onion_mercury_saturn,2841049,5,1,0,1,0
5_7533545,overcome_loneliness-3_lubricity_onion_mercury_saturn,7533545,5,1,0,1,0
5_2463542,overcome_loneliness-3_satisfaction_onion_mercury_saturn,2463542,5,1,0,1,0
5_4232481,overcome_loneliness-3_lubricity_onion_saturn_earth,4232481,5,1,0,1,0
5_882181,overcome_loneliness-3_lubricity_onion_earth_uranus,882181,5,1,0,1,0
5_8000626,overcome_loneliness-3_achievement_onion_saturn_earth,8000626,5,1,0,1,0
5_2537672,overcome_loneliness-3_satiety_onion_mercury_saturn,2537672,5,1,0,1,0
5_3247408,overcome_loneliness-3_love_onion_earth_uranus,3247408,5,1,0,1,0
5_6597708,overcome_loneliness-3_love_onion_saturn_earth,6597708,5,1,0,1,0
5_5853942,feast_lubricity_yogurt_potato_bavaria_guanabara,5853942,5,1,0,1,0
5_2851491,feast_lubricity_yogurt_wonderbread_goias_bavaria,2851491,5,1,0,1,0
5_2324540,feast_lubricity_yogurt_potato_goias_bavaria,2324540,5,1,0,1,0
5_1342175,feast_lubricity_yogurt_wonderbread_bavaria_guanabara,1342175,5,1,0,1,0
5_3868099,feast_lubricity_haroset_turkey_bavaria_guanabara,3868099,5,1,0,1,0
5_2680647,feast_lubricity_haroset_marzipan_bavaria_guanabara,2680647,5,1,0,1,0
5_6762194,feast_satisfaction_haroset_marzipan_bavaria_guanabara,6762194,5,1,0,1,0
5_3104093,feast_excitement_haroset_marzipan_bavaria_guanabara,3104093,5,1,0,1,0
5_6379374,feast_love_haroset_marzipan_bavaria_guanabara,6379374,5,1,0,1,0
5_7479070,feast_love_haroset_turkey_bavaria_guanabara,7479070,5,1,0,1,0
5_2986406,feast_excitement_haroset_turkey_bavaria_guanabara,2986406,5,1,0,1,0
5_286303,feast_satisfaction_haroset_turkey_bavaria_guanabara,286303,5,1,0,1,0
5_2397571,locale_haroset_goias,2397571,5,1,0,1,0
5_7733722,locale_haroset_bavaria,7733722,5,1,0,1,0
5_7390847,feast_achievement_marzipan_haroset_bosnia_alsace,7390847,5,1,0,1,0
5_6751746,feast_achievement_marzipan_rice_alsace_surrey,6751746,5,1,0,1,0
5_2344992,feast_achievement_marzipan_haroset_alsace_surrey,2344992,5,1,0,1,0
5_997188,feast_achievement_marzipan_mutton_bosnia_alsace,997188,5,1,0,1,0
5_3443635,feast_achievement_marzipan_onion_bosnia_alsace,3443635,5,1,0,1,0
5_3796624,feast_achievement_marzipan_rice_bosnia_alsace,3796624,5,1,0,1,0
5_6526122,feast_achievement_marzipan_cherry_bosnia_alsace,6526122,5,1,0,1,0
5_1480267,feast_achievement_marzipan_cherry_alsace_surrey,1480267,5,1,0,1,0
5_3952310,feast_achievement_marzipan_mutton_alsace_surrey,3952310,5,1,0,1,0
5_6398757,feast_achievement_marzipan_onion_alsace_surrey,6398757,5,1,0,1,0
5_3626488,succumb_abrasion_satisfaction_wonderbread_mercury_saturn,3626488,5,1,0,1,0
5_872036,succumb_abrasion_satisfaction_potato_mercury_saturn,872036,5,1,0,1,0
5_6315474,succumb_abrasion_satisfaction_yogurt_mercury_saturn,6315474,5,1,0,1,0
5_7626089,feast_love_marzipan_rice_alsace_surrey,7626089,5,1,0,1,0
5_4280337,feast_satisfaction_marzipan_onion_alsace_surrey,4280337,5,1,0,1,0
5_3493087,feast_rest_marzipan_haroset_alsace_surrey,3493087,5,1,0,1,0
5_1897884,feast_love_marzipan_mutton_alsace_surrey,1897884,5,1,0,1,0
5_3231183,feast_satisfaction_marzipan_cherry_alsace_surrey,3231183,5,1,0,1,0
5_5016433,feast_rest_marzipan_cherry_alsace_surrey,5016433,5,1,0,1,0
5_5703226,feast_satisfaction_marzipan_mutton_alsace_surrey,5703226,5,1,0,1,0
5_2524776,feast_satisfaction_marzipan_haroset_alsace_surrey,2524776,5,1,0,1,0
5_7488476,feast_rest_marzipan_mutton_alsace_surrey,7488476,5,1,0,1,0
5_6047420,feast_satiety_marzipan_haroset_alsace_surrey,6047420,5,1,0,1,0
5_7426818,feast_love_marzipan_cherry_alsace_surrey,7426818,5,1,0,1,0
5_4476418,feast_love_marzipan_haroset_alsace_surrey,4476418,5,1,0,1,0
5_2619867,feast_satiety_marzipan_cherry_alsace_surrey,2619867,5,1,0,1,0
5_5091910,feast_satiety_marzipan_mutton_alsace_surrey,5091910,5,1,0,1,0
5_1902659,feast_satiety_marzipan_onion_alsace_surrey,1902659,5,1,0,1,0
5_6203209,feast_love_marzipan_onion_alsace_surrey,6203209,5,1,0,1,0
5_795958,feast_satiety_marzipan_rice_alsace_surrey,795958,5,1,0,1,0
5_5368303,feast_satisfaction_marzipan_rice_alsace_surrey,5368303,5,1,0,1,0
5_4224803,feast_rest_marzipan_onion_alsace_surrey,4224803,5,1,0,1,0
5_1805151,feast_rest_marzipan_rice_alsace_surrey,1805151,5,1,0,1,0
5_2253099,succumb_boils_satisfaction_shrimp_mercury_saturn,2253099,5,1,0,1,0
5_3825697,succumb_boils-1_satisfaction_wonderbread_mercury_saturn,3825697,5,1,0,1,0
5_5042589,succumb_boils_satisfaction_onion_mercury_saturn,5042589,5,1,0,1,0
5_2781132,succumb_boils-1_satisfaction_arugula_mercury_saturn,2781132,5,1,0,1,0
5_641732,succumb_jealousy-2_satisfaction_wonderbread_mercury_saturn,641732,5,1,0,1,0
5_2958824,succumb_boils_satisfaction_potato_mercury_saturn,2958824,5,1,0,1,0
5_6626722,succumb_sciatica_satisfaction_wonderbread_mercury_saturn,6626722,5,1,0,1,0
5_2541056,succumb_boils_satisfaction_turkey_mercury_saturn,2541056,5,1,0,1,0
5_5370401,succumb_boils-1_satisfaction_potato_mercury_saturn,5370401,5,1,0,1,0
5_5408149,succumb_dread_excitement_rice_earth_uranus,5408149,5,1,0,1,0
5_1939434,succumb_dread_excitement_wurst_earth_uranus,1939434,5,1,0,1,0
5_5289734,succumb_dread_excitement_wurst_saturn_earth,5289734,5,1,0,1,0
5_206823,succumb_dread_excitement_papaya_saturn_earth,206823,5,1,0,1,0
5_757472,succumb_dread_excitement_rice_saturn_earth,757472,5,1,0,1,0
5_6726571,succumb_dread_excitement_marzipan_earth_uranus,6726571,5,1,0,1,0
5_6505114,succumb_dread_excitement_cherry_earth_uranus,6505114,5,1,0,1,0
5_6226455,succumb_dread_excitement_papaya_mercury_saturn,6226455,5,1,0,1,0
5_4857500,succumb_dread_excitement_papaya_earth_uranus,4857500,5,1,0,1,0
5_3960332,succumb_laceration-8_satiety_haroset_mercury_saturn,3960332,5,1,0,1,0
5_3491747,overcome_jealousy_satiety_papaya_mercury_saturn,3491747,5,1,0,1,0
5_7527344,overcome_jealousy_excitement_papaya_mercury_saturn,7527344,5,1,0,1,0
5_7659921,overcome_jealousy_love_papaya_earth_uranus,7659921,5,1,0,1,0
5_1666860,overcome_jealousy_excitement_papaya_saturn_earth,1666860,5,1,0,1,0
5_1625751,overcome_jealousy_achievement_papaya_saturn_earth,1625751,5,1,0,1,0
5_4555849,overcome_boils_achievement_onion_saturn_earth,4555849,5,1,0,1,0
5_6127047,overcome_boils_satiety_onion_mercury_saturn,6127047,5,1,0,1,0
5_2080970,overcome_boils_rest_onion_mercury_saturn,2080970,5,1,0,1,0
5_3864913,overcome_boils_satisfaction_onion_mercury_saturn,3864913,5,1,0,1,0
5_4024713,overcome_boils_love_onion_earth_uranus,4024713,5,1,0,1,0
5_7375013,overcome_boils_love_onion_saturn_earth,7375013,5,1,0,1,0
5_4471556,overcome_boils_lubricity_onion_earth_uranus,4471556,5,1,0,1,0
5_790146,locale_arugula_bosnia,790146,5,3,0,3,0
5_1014328,locale_arugula_guanabara,1014328,5,3,0,3,0
5_3242223,locale_arugula_alsace,3242223,5,3,0,3,0
5_1187150,locale_wonderbread_bosnia,1187150,5,2,0,2,0
5_5775144,feast_satiety_papaya_rice_guanabara_bosnia,5775144,5,1,0,1,0
5_2453239,feast_satiety_papaya_wurst_bavaria_guanabara,2453239,5,1,0,1,0
5_5166036,feast_satiety_papaya_wurst_bosnia_alsace,5166036,5,1,0,1,0
5_7863773,feast_satiety_papaya_rice_goias_bavaria,7863773,5,1,0,1,0
5_6111415,feast_satiety_papaya_rice_bavaria_guanabara,6111415,5,1,0,1,0
5_3760610,feast_satiety_papaya_wurst_guanabara_bosnia,3760610,5,1,0,1,0
5_5156709,feast_satiety_papaya_rice_bosnia_alsace,5156709,5,1,0,1,0
5_7873100,feast_satiety_papaya_wurst_goias_bavaria,7873100,5,1,0,1,0
5_5165696,feast_lubricity_cherry_marzipan_bavaria_guanabara,5165696,5,1,0,1,0
5_6891593,feast_satiety_cherry_marzipan_bavaria_guanabara,6891593,5,1,0,1,0
5_4565584,feast_lubricity_cherry_rice_bavaria_guanabara,4565584,5,1,0,1,0
5_5395477,feast_satiety_cherry_endive_bavaria_guanabara,5395477,5,1,0,1,0
5_5757972,feast_satiety_cherry_rice_bavaria_guanabara,5757972,5,1,0,1,0
5_6597868,feast_lubricity_cherry_endive_bavaria_guanabara,6597868,5,1,0,1,0
5_7926949,locale_cherry_goias,7926949,5,4,0,4,0
5_6821478,locale_cherry_bosnia,6821478,5,3,0,3,0
5_800046,locale_cherry_bavaria,800046,5,3,0,3,0
5_5307194,feast_lubricity_arugula_wonderbread_bosnia_alsace,5307194,5,1,0,1,0
5_261339,feast_lubricity_arugula_wonderbread_alsace_surrey,261339,5,1,0,1,0
5_3784536,feast_lubricity_arugula_potato_bosnia_alsace,3784536,5,1,0,1,0
5_6905485,feast_lubricity_arugula_potato_bavaria_guanabara,6905485,5,1,0,1,0
5_6090784,feast_lubricity_arugula_potato_guanabara_bosnia,6090784,5,1,0,1,0
5_4462517,feast_lubricity_arugula_wonderbread_bavaria_guanabara,4462517,5,1,0,1,0
5_6739658,feast_lubricity_arugula_potato_alsace_surrey,6739658,5,1,0,1,0
5_830600,feast_lubricity_arugula_wonderbread_guanabara_bosnia,830600,5,1,0,1,0
5_244947,overcome_laceration_satiety_endive_mercury_saturn,244947,5,1,0,1,0
5_386897,overcome_hangover_satiety_papaya_mercury_saturn,386897,5,1,0,1,0
5_6073996,overcome_dread_satiety_papaya_mercury_saturn,6073996,5,1,0,1,0
5_2720946,overcome_depression_satiety_cherry_mercury_saturn,2720946,5,1,0,1,0
5_4531346,overcome_abrasion-4_satiety_onion_mercury_saturn,4531346,5,1,0,1,0
5_6578941,overcome_angina_satiety_onion_mercury_saturn,6578941,5,1,0,1,0
5_3113938,overcome_grief_satiety_cherry_mercury_saturn,3113938,5,1,0,1,0
5_6711988,overcome_hangover_satiety_rice_mercury_saturn,6711988,5,1,0,1,0
5_5890937,overcome_laceration_satiety_cherry_mercury_saturn,5890937,5,1,0,1,0
5_579734,overcome_anger_satiety_marzipan_mercury_saturn,579734,5,1,0,1,0
5_4109834,overcome_depression_satiety_wurst_mercury_saturn,4109834,5,1,0,1,0
5_5075933,overcome_depression_satiety_endive_mercury_saturn,5075933,5,1,0,1,0
5_1168032,overcome_loneliness-3_satiety_ham_mercury_saturn,1168032,5,1,0,1,0
5_4164631,overcome_laceration_satiety_marzipan_mercury_saturn,4164631,5,1,0,1,0
5_7841129,overcome_boils_satiety_shrimp_mercury_saturn,7841129,5,1,0,1,0
5_5255227,overcome_laceration-8_satiety_haroset_mercury_saturn,5255227,5,1,0,1,0
5_6369923,overcome_hangover_satiety_wurst_mercury_saturn,6369923,5,1,0,1,0
5_6457823,overcome_anxiety_satiety_marzipan_mercury_saturn,6457823,5,1,0,1,0
5_7109218,overcome_dread_satiety_rice_mercury_saturn,7109218,5,1,0,1,0
5_5533913,overcome_jealousy_satiety_rice_mercury_saturn,5533913,5,1,0,1,0
5_7200461,overcome_laceration_satiety_rice_mercury_saturn,7200461,5,1,0,1,0
5_337259,overcome_jealousy_satiety_cherry_mercury_saturn,337259,5,1,0,1,0
5_128109,overcome_boils_satiety_turkey_mercury_saturn,128109,5,1,0,1,0
5_3178806,overcome_abrasion-4_satiety_ham_mercury_saturn,3178806,5,1,0,1,0
5_2766953,overcome_jealousy_satiety_marzipan_mercury_saturn,2766953,5,1,0,1,0
5_4048102,overcome_dread_satiety_wurst_mercury_saturn,4048102,5,1,0,1,0
5_6179401,overcome_loneliness_satiety_shrimp_mercury_saturn,6179401,5,1,0,1,0
5_268760,succumb_loneliness-3_lubricity_ham_earth_uranus,268760,5,1,0,1,0
5_3602347,feast_satiety_shrimp_turkey_goias_bavaria,3602347,5,1,0,1,0
5_2222695,feast_lubricity_shrimp_onion_goias_bavaria,2222695,5,1,0,1,0
5_2932492,feast_lubricity_shrimp_potato_goias_bavaria,2932492,5,1,0,1,0
5_82788,feast_love_shrimp_onion_goias_bavaria,82788,5,1,0,1,0
5_353582,feast_satiety_shrimp_potato_goias_bavaria,353582,5,1,0,1,0
5_4925927,feast_satisfaction_shrimp_potato_goias_bavaria,4925927,5,1,0,1,0
5_173715,feast_satisfaction_shrimp_turkey_goias_bavaria,173715,5,1,0,1,0
5_7183713,feast_love_shrimp_potato_goias_bavaria,7183713,5,1,0,1,0
5_2886812,feast_satisfaction_shrimp_onion_goias_bavaria,2886812,5,1,0,1,0
5_6181257,feast_lubricity_shrimp_turkey_goias_bavaria,6181257,5,1,0,1,0
5_6150602,feast_satiety_shrimp_onion_goias_bavaria,6150602,5,1,0,1,0
5_2431501,feast_love_shrimp_turkey_goias_bavaria,2431501,5,1,0,1,0
5_3540833,succumb_prostatitis_excitement_wurst_earth_uranus,3540833,5,1,0,1,0
5_6891133,succumb_prostatitis_excitement_wurst_saturn_earth,6891133,5,1,0,1,0
5_579846,overcome_jealousy_lubricity_rice_earth_uranus,579846,5,1,0,1,0
5_1017291,overcome_jealousy_achievement_rice_saturn_earth,1017291,5,1,0,1,0
5_6157934,overcome_jealousy_excitement_rice_saturn_earth,6157934,5,1,0,1,0
5_4911427,overcome_jealousy_love_rice_earth_uranus,4911427,5,1,0,1,0
5_7012364,overcome_jealousy_rest_rice_mercury_saturn,7012364,5,1,0,1,0
5_2612109,overcome_jealousy_excitement_rice_mercury_saturn,2612109,5,1,0,1,0
5_2571000,overcome_jealousy_achievement_rice_mercury_saturn,2571000,5,1,0,1,0
5_260750,overcome_jealousy_love_rice_saturn_earth,260750,5,1,0,1,0
5_1197398,overcome_laceration-8_love_haroset_earth_uranus,1197398,5,1,0,1,0
5_4547698,overcome_laceration-8_love_haroset_saturn_earth,4547698,5,1,0,1,0
5_4142325,overcome_laceration-8_lubricity_haroset_saturn_earth,4142325,5,1,0,1,0
5_792025,overcome_laceration-8_lubricity_haroset_earth_uranus,792025,5,1,0,1,0
5_3514708,overcome_laceration-8_satisfaction_haroset_mercury_saturn,3514708,5,1,0,1,0
5_120557,overcome_laceration-8_achievement_haroset_saturn_earth,120557,5,1,0,1,0
5_778253,overcome_laceration-8_rest_haroset_mercury_saturn,778253,5,1,0,1,0
5_3021047,feast_satiety_endive_cherry_goias_bavaria,3021047,5,1,0,1,0
5_2845996,feast_satiety_endive_wurst_bosnia_alsace,2845996,5,1,0,1,0
5_541684,feast_satiety_endive_wurst_guanabara_bosnia,541684,5,1,0,1,0
5_313983,feast_satiety_endive_cherry_bosnia_alsace,313983,5,1,0,1,0
5_7041815,feast_satiety_endive_cherry_bavaria_guanabara,7041815,5,1,0,1,0
5_2508814,feast_satiety_endive_wurst_bavaria_guanabara,2508814,5,1,0,1,0
5_2778412,feast_satiety_endive_cherry_guanabara_bosnia,2778412,5,1,0,1,0
5_5553060,feast_satiety_endive_wurst_goias_bavaria,5553060,5,1,0,1,0
5_1280349,feast_rest_potato_yogurt_goias_bavaria,1280349,5,1,0,1,0
5_5268046,feast_rest_potato_yogurt_bavaria_guanabara,5268046,5,1,0,1,0
5_6553195,feast_rest_potato_yogurt_guanabara_bosnia,6553195,5,1,0,1,0
5_215386,feast_rest_potato_shrimp_guanabara_bosnia,215386,5,1,0,1,0
5_7731776,feast_rest_potato_arugula_guanabara_bosnia,7731776,5,1,0,1,0
5_6987273,feast_rest_potato_shrimp_bavaria_guanabara,6987273,5,1,0,1,0
5_6825610,feast_rest_potato_arugula_goias_bavaria,6825610,5,1,0,1,0
5_2947656,feast_rest_potato_arugula_bavaria_guanabara,2947656,5,1,0,1,0
5_3100304,feast_rest_potato_shrimp_goias_bavaria,3100304,5,1,0,1,0
5_2057345,overcome_grief_excitement_cherry_saturn_earth,2057345,5,1,0,1,0
5_5399238,overcome_grief_rest_cherry_mercury_saturn,5399238,5,1,0,1,0
5_346436,overcome_grief_love_cherry_earth_uranus,346436,5,1,0,1,0
5_3696736,overcome_grief_love_cherry_saturn_earth,3696736,5,1,0,1,0
5_4254781,overcome_grief_lubricity_cherry_earth_uranus,4254781,5,1,0,1,0
5_1487421,overcome_grief_achievement_cherry_saturn_earth,1487421,5,1,0,1,0
5_5217445,overcome_loneliness_lubricity_arugula_saturn_earth,5217445,5,1,0,1,0
5_1867145,overcome_loneliness_lubricity_arugula_earth_uranus,1867145,5,1,0,1,0
5_1075940,overcome_loneliness_intoxication_arugula_saturn_earth,1075940,5,1,0,1,0
5_7279180,overcome_loneliness_satisfaction_arugula_mercury_saturn,7279180,5,1,0,1,0
5_3065860,overcome_loneliness_rest_arugula_mercury_saturn,3065860,5,1,0,1,0
5_5064249,overcome_loneliness_rest_yogurt_mercury_saturn,5064249,5,1,0,1,0
5_7086939,overcome_loneliness_intoxication_yogurt_saturn_earth,7086939,5,1,0,1,0
5_7571924,overcome_loneliness_lubricity_yogurt_saturn_earth,7571924,5,1,0,1,0
5_4221624,overcome_loneliness_lubricity_yogurt_earth_uranus,4221624,5,1,0,1,0
5_6830921,overcome_loneliness_satisfaction_yogurt_mercury_saturn,6830921,5,1,0,1,0
5_2491540,feast_love_onion_marzipan_bosnia_alsace,2491540,5,1,0,1,0
5_7860087,feast_love_onion_shrimp_bosnia_alsace,7860087,5,1,0,1,0
5_6370381,feast_love_onion_shrimp_bavaria_guanabara,6370381,5,1,0,1,0
5_4217621,feast_love_onion_marzipan_bavaria_guanabara,4217621,5,1,0,1,0
5_1059112,feast_love_onion_ham_bosnia_alsace,1059112,5,1,0,1,0
5_87961,feast_love_onion_shrimp_guanabara_bosnia,87961,5,1,0,1,0
5_2437810,feast_love_onion_ham_guanabara_bosnia,2437810,5,1,0,1,0
5_5830254,feast_love_onion_marzipan_guanabara_bosnia,5830254,5,1,0,1,0
5_7858450,feast_love_onion_ham_bavaria_guanabara,7858450,5,1,0,1,0
5_5337148,succumb_sciatica_intoxication_arugula_earth_uranus,5337148,5,1,0,1,0
5_1000943,succumb_sciatica_intoxication_wonderbread_earth_uranus,1000943,5,1,0,1,0
5_2141173,succumb_sciatica_intoxication_yogurt_earth_uranus,2141173,5,1,0,1,0
5_7746303,succumb_sciatica_intoxication_ham_earth_uranus,7746303,5,1,0,1,0
5_1296495,succumb_prostatitis_achievement_wurst_mercury_saturn,1296495,5,1,0,1,0
5_5405345,succumb_depression_achievement_wurst_mercury_saturn,5405345,5,1,0,1,0
5_2425929,succumb_grief_achievement_cherry_mercury_saturn,2425929,5,1,0,1,0
5_4890027,succumb_grief_achievement_wurst_mercury_saturn,4890027,5,1,0,1,0
5_4780916,succumb_grief_achievement_endive_mercury_saturn,4780916,5,1,0,1,0
5_685715,succumb_depression_achievement_endive_mercury_saturn,685715,5,1,0,1,0
5_6331705,succumb_depression_achievement_cherry_mercury_saturn,6331705,5,1,0,1,0
5_5510894,overcome_boils_satisfaction_potato_mercury_saturn,5510894,5,1,0,1,0
5_7217643,overcome_abrasion-4_satisfaction_ham_mercury_saturn,7217643,5,1,0,1,0
5_1477938,overcome_angina_satisfaction_onion_mercury_saturn,1477938,5,1,0,1,0
5_192087,overcome_jealousy_satisfaction_marzipan_mercury_saturn,192087,5,1,0,1,0
5_1760787,overcome_anger_satisfaction_marzipan_mercury_saturn,1760787,5,1,0,1,0
5_1387483,overcome_loneliness_satisfaction_potato_mercury_saturn,1387483,5,1,0,1,0
5_3748730,overcome_anxiety_satisfaction_marzipan_mercury_saturn,3748730,5,1,0,1,0
5_1267677,overcome_sciatica_satisfaction_wonderbread_mercury_saturn,1267677,5,1,0,1,0
5_4076027,overcome_boils-1_satisfaction_arugula_mercury_saturn,4076027,5,1,0,1,0
5_5093126,overcome_boils_satisfaction_turkey_mercury_saturn,5093126,5,1,0,1,0
5_7610369,overcome_abrasion_satisfaction_yogurt_mercury_saturn,7610369,5,1,0,1,0
5_4805169,overcome_boils_satisfaction_shrimp_mercury_saturn,4805169,5,1,0,1,0
5_4803167,overcome_laceration_satisfaction_marzipan_mercury_saturn,4803167,5,1,0,1,0
5_5431864,overcome_abrasion-4_satisfaction_onion_mercury_saturn,5431864,5,1,0,1,0
5_5406713,overcome_boils-1_satisfaction_potato_mercury_saturn,5406713,5,1,0,1,0
5_259961,overcome_loneliness-3_satisfaction_ham_mercury_saturn,259961,5,1,0,1,0
5_681758,overcome_loneliness_satisfaction_shrimp_mercury_saturn,681758,5,1,0,1,0
5_7983950,overcome_loneliness-3_satisfaction_wonderbread_mercury_saturn,7983950,5,1,0,1,0
5_1505179,overcome_anger_achievement_marzipan_saturn_earth,1505179,5,1,0,1,0
5_4069828,overcome_anger_rest_marzipan_mercury_saturn,4069828,5,1,0,1,0
5_4894876,overcome_anger_achievement_marzipan_mercury_saturn,4894876,5,1,0,1,0
5_5860172,overcome_anger_lubricity_marzipan_saturn_earth,5860172,5,1,0,1,0
5_2509872,overcome_anger_lubricity_marzipan_earth_uranus,2509872,5,1,0,1,0
5_1221816,overcome_anger_love_marzipan_earth_uranus,1221816,5,1,0,1,0
5_4572116,overcome_anger_love_marzipan_saturn_earth,4572116,5,1,0,1,0
5_3517109,overcome_anger_excitement_marzipan_saturn_earth,3517109,5,1,0,1,0
5_306789,feast_excitement_onion_ham_bosnia_alsace,306789,5,1,0,1,0
5_7725934,feast_excitement_onion_marzipan_bavaria_guanabara,7725934,5,1,0,1,0
5_2243832,feast_excitement_onion_shrimp_bavaria_guanabara,2243832,5,1,0,1,0
5_7646830,feast_excitement_onion_shrimp_bosnia_alsace,7646830,5,1,0,1,0
5_5562674,feast_excitement_onion_marzipan_guanabara_bosnia,5562674,5,1,0,1,0
5_1270520,feast_excitement_onion_ham_bavaria_guanabara,1270520,5,1,0,1,0
5_4187607,feast_excitement_onion_marzipan_bosnia_alsace,4187607,5,1,0,1,0
5_2228355,feast_excitement_onion_shrimp_guanabara_bosnia,2228355,5,1,0,1,0
5_2224553,feast_excitement_onion_ham_guanabara_bosnia,2224553,5,1,0,1,0
5_5821948,overcome_jealousy_rest_marzipan_mercury_saturn,5821948,5,1,0,1,0
5_3762192,overcome_jealousy_love_marzipan_earth_uranus,3762192,5,1,0,1,0
5_4697091,overcome_jealousy_lubricity_marzipan_earth_uranus,4697091,5,1,0,1,0
5_4763733,overcome_jealousy_achievement_marzipan_mercury_saturn,4763733,5,1,0,1,0
5_3376783,overcome_jealousy_excitement_marzipan_saturn_earth,3376783,5,1,0,1,0
5_46414,overcome_jealousy_lubricity_marzipan_saturn_earth,46414,5,1,0,1,0
5_5586608,overcome_jealousy_achievement_marzipan_saturn_earth,5586608,5,1,0,1,0
5_5025041,locale_papaya_bosnia,5025041,5,3,0,3,0
5_4968840,locale_papaya_bavaria,4968840,5,3,0,3,0
5_1275730,locale_papaya_guanabara,1275730,5,3,0,3,0
5_7099199,feast_love_papaya_wurst_bosnia_alsace,7099199,5,1,0,1,0
5_6885942,feast_excitement_papaya_wurst_bosnia_alsace,6885942,5,1,0,1,0
5_1320041,feast_love_papaya_rice_bosnia_alsace,1320041,5,1,0,1,0
5_5811665,feast_achievement_papaya_rice_bosnia_alsace,5811665,5,1,0,1,0
5_7101164,feast_excitement_papaya_rice_bosnia_alsace,7101164,5,1,0,1,0
5_4814255,feast_achievement_papaya_wurst_bosnia_alsace,4814255,5,1,0,1,0
5_4104692,succumb_laceration_satiety_mutton_mercury_saturn,4104692,5,1,0,1,0
5_2829527,succumb_laceration_satiety_rice_mercury_saturn,2829527,5,1,0,1,0
5_1546376,succumb_laceration_satiety_haroset_mercury_saturn,1546376,5,1,0,1,0
5_4128319,succumb_laceration_satiety_marzipan_mercury_saturn,4128319,5,1,0,1,0
5_3338867,succumb_laceration_satiety_cherry_mercury_saturn,3338867,5,1,0,1,0
5_7346914,succumb_laceration_satiety_onion_mercury_saturn,7346914,5,1,0,1,0
5_4581055,succumb_laceration_satiety_wurst_mercury_saturn,4581055,5,1,0,1,0
5_6493355,succumb_laceration_satiety_papaya_mercury_saturn,6493355,5,1,0,1,0
5_5693854,succumb_laceration_satiety_endive_mercury_saturn,5693854,5,1,0,1,0
5_6207880,feast_lubricity_wonderbread_ham_bavaria_guanabara,6207880,5,1,0,1,0
5_1345612,feast_lubricity_wonderbread_yogurt_bosnia_alsace,1345612,5,1,0,1,0
5_7338256,feast_lubricity_wonderbread_ham_bosnia_alsace,7338256,5,1,0,1,0
5_1747305,feast_lubricity_wonderbread_arugula_bosnia_alsace,1747305,5,1,0,1,0
5_706355,feast_lubricity_wonderbread_yogurt_bavaria_guanabara,706355,5,1,0,1,0
5_3297402,feast_lubricity_wonderbread_arugula_bavaria_guanabara,3297402,5,1,0,1,0
5_168876,succumb_depression_satiety_cherry_mercury_saturn,168876,5,1,0,1,0
5_2523863,succumb_depression_satiety_endive_mercury_saturn,2523863,5,1,0,1,0
5_5287510,succumb_depression_satiety_wurst_mercury_saturn,5287510,5,1,0,1,0
5_3737284,overcome_anxiety_lubricity_marzipan_saturn_earth,3737284,5,1,0,1,0
5_386984,overcome_anxiety_lubricity_marzipan_earth_uranus,386984,5,1,0,1,0
5_7184170,overcome_anxiety_achievement_marzipan_mercury_saturn,7184170,5,1,0,1,0
5_4124217,overcome_anxiety_excitement_marzipan_saturn_earth,4124217,5,1,0,1,0
5_4157067,overcome_anxiety_love_marzipan_earth_uranus,4157067,5,1,0,1,0
5_7507367,overcome_anxiety_love_marzipan_saturn_earth,7507367,5,1,0,1,0
5_4906264,overcome_anxiety_achievement_marzipan_saturn_earth,4906264,5,1,0,1,0
5_1189353,overcome_anxiety_rest_marzipan_mercury_saturn,1189353,5,1,0,1,0
5_2089599,feast_lubricity_onion_shrimp_guanabara_bosnia,2089599,5,1,0,1,0
5_504647,feast_satiety_onion_ham_guanabara_bosnia,504647,5,1,0,1,0
5_2125197,feast_intoxication_onion_marzipan_guanabara_bosnia,2125197,5,1,0,1,0
5_3281987,feast_satiety_onion_shrimp_guanabara_bosnia,3281987,5,1,0,1,0
5_2142387,feast_achievement_onion_shrimp_guanabara_bosnia,2142387,5,1,0,1,0
5_1777686,feast_intoxication_onion_shrimp_guanabara_bosnia,1777686,5,1,0,1,0
5_4251634,feast_achievement_onion_marzipan_guanabara_bosnia,4251634,5,1,0,1,0
5_1159330,feast_lubricity_onion_marzipan_guanabara_bosnia,1159330,5,1,0,1,0
5_4384468,feast_intoxication_onion_ham_guanabara_bosnia,4384468,5,1,0,1,0
5_4577717,feast_lubricity_onion_ham_guanabara_bosnia,4577717,5,1,0,1,0
5_7957916,feast_satiety_onion_marzipan_guanabara_bosnia,7957916,5,1,0,1,0
5_152866,feast_achievement_onion_ham_guanabara_bosnia,152866,5,1,0,1,0
5_4615811,locale_onion_bavaria,4615811,5,2,0,2,0
5_3164193,overcome_depression_excitement_wurst_mercury_saturn,3164193,5,1,0,1,0
5_4164178,succumb_hangover_excitement_wurst_saturn_earth,4164178,5,1,0,1,0
5_179771,overcome_laceration_excitement_rice_mercury_saturn,179771,5,1,0,1,0
5_4378518,succumb_hangover_excitement_rice_saturn_earth,4378518,5,1,0,1,0
5_5234163,overcome_hangover_excitement_papaya_mercury_saturn,5234163,5,1,0,1,0
5_2596412,overcome_dread_excitement_papaya_mercury_saturn,2596412,5,1,0,1,0
5_99659,succumb_hangover_excitement_papaya_saturn_earth,99659,5,1,0,1,0
5_793737,feast_satisfaction_shrimp_onion_bavaria_guanabara,793737,5,1,0,1,0
5_6707327,feast_satisfaction_shrimp_potato_bavaria_guanabara,6707327,5,1,0,1,0
5_6601071,feast_satisfaction_shrimp_turkey_bavaria_guanabara,6601071,5,1,0,1,0
5_2141347,feast_intoxication_onion_ham_bavaria_guanabara,2141347,5,1,0,1,0
5_7839292,feast_intoxication_onion_marzipan_bavaria_guanabara,7839292,5,1,0,1,0
5_7941383,feast_satiety_onion_shrimp_bavaria_guanabara,7941383,5,1,0,1,0
5_6727181,feast_lubricity_onion_shrimp_bavaria_guanabara,6727181,5,1,0,1,0
5_3607229,feast_lubricity_onion_ham_bavaria_guanabara,3607229,5,1,0,1,0
5_6887223,feast_intoxication_onion_shrimp_bavaria_guanabara,6887223,5,1,0,1,0
5_1028319,feast_satiety_onion_ham_bavaria_guanabara,1028319,5,1,0,1,0
5_4832657,feast_satiety_onion_marzipan_bavaria_guanabara,4832657,5,1,0,1,0
5_6984107,feast_achievement_onion_ham_bavaria_guanabara,6984107,5,1,0,1,0
5_4238955,feast_achievement_onion_shrimp_bavaria_guanabara,4238955,5,1,0,1,0
5_139751,feast_achievement_onion_marzipan_bavaria_guanabara,139751,5,1,0,1,0
5_606650,feast_lubricity_onion_marzipan_bavaria_guanabara,606650,5,1,0,1,0
5_2456363,locale_haroset_guanabara,2456363,5,3,0,3,0
5_7621788,overcome_loneliness_rest_potato_mercury_saturn,7621788,5,1,0,1,0
5_5102674,overcome_loneliness_lubricity_potato_mercury_saturn,5102674,5,1,0,1,0
5_3025569,overcome_loneliness_intoxication_potato_saturn_earth,3025569,5,1,0,1,0
5_3510554,overcome_loneliness_lubricity_potato_saturn_earth,3510554,5,1,0,1,0
5_160254,overcome_loneliness_lubricity_potato_earth_uranus,160254,5,1,0,1,0
5_2428495,overcome_boils_lubricity_turkey_earth_uranus,2428495,5,1,0,1,0
5_2246394,overcome_laceration_lubricity_rice_earth_uranus,2246394,5,1,0,1,0
5_6301194,overcome_sciatica_lubricity_wonderbread_earth_uranus,6301194,5,1,0,1,0
5_7796944,overcome_boils_lubricity_shrimp_earth_uranus,7796944,5,1,0,1,0
5_5505343,overcome_boils-1_lubricity_potato_earth_uranus,5505343,5,1,0,1,0
5_3861789,overcome_depression_lubricity_cherry_earth_uranus,3861789,5,1,0,1,0
5_1821982,overcome_boils_lubricity_potato_earth_uranus,1821982,5,1,0,1,0
5_7031780,overcome_laceration_lubricity_cherry_earth_uranus,7031780,5,1,0,1,0
5_1757921,overcome_hangover_lubricity_rice_earth_uranus,1757921,5,1,0,1,0
5_6094769,overcome_laceration_lubricity_marzipan_earth_uranus,6094769,5,1,0,1,0
5_6135216,overcome_loneliness_lubricity_shrimp_earth_uranus,6135216,5,1,0,1,0
5_6114062,overcome_loneliness-3_lubricity_wonderbread_earth_uranus,6114062,5,1,0,1,0
5_2042862,overcome_boils-1_lubricity_arugula_earth_uranus,2042862,5,1,0,1,0
5_7092061,overcome_loneliness-3_lubricity_ham_earth_uranus,7092061,5,1,0,1,0
5_1101858,overcome_abrasion-4_lubricity_ham_earth_uranus,1101858,5,1,0,1,0
5_2875855,overcome_abrasion-4_lubricity_onion_earth_uranus,2875855,5,1,0,1,0
5_3900703,overcome_abrasion_lubricity_yogurt_earth_uranus,3900703,5,1,0,1,0
5_1478102,overcome_jealousy_lubricity_cherry_earth_uranus,1478102,5,1,0,1,0
5_2155151,overcome_dread_lubricity_rice_earth_uranus,2155151,5,1,0,1,0
5_4923450,overcome_angina_lubricity_onion_earth_uranus,4923450,5,1,0,1,0
5_478796,feast_satisfaction_arugula_wonderbread_bosnia_alsace,478796,5,1,0,1,0
5_4996490,feast_satisfaction_arugula_potato_alsace_surrey,4996490,5,1,0,1,0
5_3323689,feast_satisfaction_arugula_potato_bavaria_guanabara,3323689,5,1,0,1,0
5_6363986,feast_satisfaction_arugula_wonderbread_bavaria_guanabara,6363986,5,1,0,1,0
5_7201930,feast_satisfaction_arugula_potato_guanabara_bosnia,7201930,5,1,0,1,0
5_431728,feast_satisfaction_arugula_wonderbread_guanabara_bosnia,431728,5,1,0,1,0
5_2041368,feast_satisfaction_arugula_potato_bosnia_alsace,2041368,5,1,0,1,0
5_3433918,feast_satisfaction_arugula_wonderbread_alsace_surrey,3433918,5,1,0,1,0
5_5672905,succumb_boils-1_lubricity_arugula_earth_uranus,5672905,5,1,0,1,0
5_112778,overcome_hangover_achievement_wurst_mercury_saturn,112778,5,1,0,1,0
5_1764016,overcome_hangover_love_wurst_earth_uranus,1764016,5,1,0,1,0
5_5114316,overcome_hangover_love_wurst_saturn_earth,5114316,5,1,0,1,0
5_5050705,overcome_hangover_achievement_wurst_saturn_earth,5050705,5,1,0,1,0
5_3943550,overcome_hangover_entertainment_wurst_saturn_earth,3943550,5,1,0,1,0
5_593250,overcome_hangover_entertainment_wurst_earth_uranus,593250,5,1,0,1,0
5_6979322,overcome_boils-1_rest_potato_mercury_saturn,6979322,5,1,0,1,0
5_854666,overcome_boils-1_lubricity_potato_saturn_earth,854666,5,1,0,1,0
5_2080364,overcome_boils-1_lubricity_potato_mercury_saturn,2080364,5,1,0,1,0
5_7498107,succumb_laceration-8_lubricity_haroset_earth_uranus,7498107,5,1,0,1,0
5_4393790,feast_satiety_shrimp_potato_bavaria_guanabara,4393790,5,1,0,1,0
5_4287534,feast_satiety_shrimp_turkey_bavaria_guanabara,4287534,5,1,0,1,0
5_4316381,feast_satiety_shrimp_onion_bavaria_guanabara,4316381,5,1,0,1,0
5_4566696,feast_lubricity_haroset_turkey_goias_bavaria,4566696,5,1,0,1,0
5_3382633,feast_satisfaction_haroset_marzipan_goias_bavaria,3382633,5,1,0,1,0
5_2823528,feast_satisfaction_haroset_turkey_goias_bavaria,2823528,5,1,0,1,0
5_1207726,feast_excitement_haroset_marzipan_goias_bavaria,1207726,5,1,0,1,0
5_5691075,feast_lubricity_haroset_marzipan_goias_bavaria,5691075,5,1,0,1,0
5_5334275,feast_love_haroset_marzipan_goias_bavaria,5334275,5,1,0,1,0
5_6442467,feast_excitement_haroset_turkey_goias_bavaria,6442467,5,1,0,1,0
5_4746400,feast_love_haroset_turkey_goias_bavaria,4746400,5,1,0,1,0
5_46149,feast_intoxication_yogurt_wonderbread_bavaria_guanabara,46149,5,1,0,1,0
5_3396440,feast_rest_yogurt_wonderbread_bavaria_guanabara,3396440,5,1,0,1,0
5_6822417,feast_rest_yogurt_potato_bavaria_guanabara,6822417,5,1,0,1,0
5_6819809,feast_intoxication_yogurt_potato_bavaria_guanabara,6819809,5,1,0,1,0
5_6759901,locale_yogurt_bosnia,6759901,5,2,0,2,0
5_1985834,feast_rest_arugula_potato_bosnia_alsace,1985834,5,1,0,1,0
5_3534253,feast_rest_arugula_wonderbread_bosnia_alsace,3534253,5,1,0,1,0
5_3968678,overcome_laceration_achievement_rice_mercury_saturn,3968678,5,1,0,1,0
5_3284124,overcome_laceration_love_rice_saturn_earth,3284124,5,1,0,1,0
5_2655423,overcome_laceration_rest_rice_mercury_saturn,2655423,5,1,0,1,0
5_6570969,overcome_laceration_achievement_rice_saturn_earth,6570969,5,1,0,1,0
5_741464,overcome_laceration_excitement_rice_saturn_earth,741464,5,1,0,1,0
5_7934801,overcome_laceration_love_rice_earth_uranus,7934801,5,1,0,1,0
5_3329198,feast_satiety_cherry_rice_goias_bavaria,3329198,5,1,0,1,0
5_6215745,feast_satiety_cherry_marzipan_guanabara_bosnia,6215745,5,1,0,1,0
5_622134,feast_satiety_cherry_rice_bosnia_alsace,622134,5,1,0,1,0
5_6860625,feast_satiety_cherry_marzipan_goias_bavaria,6860625,5,1,0,1,0
5_5425724,feast_satiety_cherry_endive_goias_bavaria,5425724,5,1,0,1,0
5_4153561,feast_satiety_cherry_marzipan_bosnia_alsace,4153561,5,1,0,1,0
5_2718660,feast_satiety_cherry_endive_bosnia_alsace,2718660,5,1,0,1,0
5_7367708,feast_satiety_cherry_rice_guanabara_bosnia,7367708,5,1,0,1,0
5_5834855,feast_satiety_cherry_endive_guanabara_bosnia,5834855,5,1,0,1,0
5_7513147,succumb_grief_achievement_rice_earth_uranus,7513147,5,1,0,1,0
5_3551044,succumb_grief_achievement_endive_earth_uranus,3551044,5,1,0,1,0
5_6901344,succumb_grief_achievement_endive_saturn_earth,6901344,5,1,0,1,0
5_102786,succumb_grief_achievement_wurst_saturn_earth,102786,5,1,0,1,0
5_6080533,succumb_grief_achievement_marzipan_earth_uranus,6080533,5,1,0,1,0
5_2157931,succumb_grief_achievement_cherry_saturn_earth,2157931,5,1,0,1,0
5_2862470,succumb_grief_achievement_rice_saturn_earth,2862470,5,1,0,1,0
5_4753463,succumb_grief_achievement_wurst_earth_uranus,4753463,5,1,0,1,0
5_6808608,succumb_grief_achievement_cherry_earth_uranus,6808608,5,1,0,1,0
5_1429856,succumb_grief_achievement_marzipan_saturn_earth,1429856,5,1,0,1,0
5_1910192,overcome_dread_love_rice_saturn_earth,1910192,5,1,0,1,0
5_3599540,overcome_dread_achievement_rice_saturn_earth,3599540,5,1,0,1,0
5_4176937,overcome_dread_achievement_rice_mercury_saturn,4176937,5,1,0,1,0
5_3643029,overcome_dread_rest_rice_mercury_saturn,3643029,5,1,0,1,0
5_6560869,overcome_dread_love_rice_earth_uranus,6560869,5,1,0,1,0
5_1551669,succumb_depression-7_satiety_haroset_mercury_saturn,1551669,5,1,0,1,0
5_3263248,feast_excitement_endive_cherry_goias_bavaria,3263248,5,1,0,1,0
5_5201279,feast_achievement_endive_wurst_goias_bavaria,5201279,5,1,0,1,0
5_7486223,feast_love_endive_wurst_goias_bavaria,7486223,5,1,0,1,0
5_7272966,feast_excitement_endive_wurst_goias_bavaria,7272966,5,1,0,1,0
5_975858,feast_achievement_endive_cherry_goias_bavaria,975858,5,1,0,1,0
5_1850201,feast_love_endive_cherry_goias_bavaria,1850201,5,1,0,1,0
5_3950433,locale_endive_guanabara,3950433,5,3,0,3,0
5_6411945,locale_endive_bosnia,6411945,5,3,0,3,0
5_1693030,overcome_laceration_love_endive_earth_uranus,1693030,5,1,0,1,0
5_5043330,overcome_laceration_love_endive_saturn_earth,5043330,5,1,0,1,0
5_1413479,overcome_laceration_achievement_endive_saturn_earth,1413479,5,1,0,1,0
5_3977403,overcome_laceration_achievement_endive_mercury_saturn,3977403,5,1,0,1,0
5_5764793,feast_satisfaction_wonderbread_yogurt_bosnia_alsace,5764793,5,1,0,1,0
5_4919884,feast_satisfaction_wonderbread_arugula_bosnia_alsace,4919884,5,1,0,1,0
5_307483,feast_satisfaction_wonderbread_yogurt_bavaria_guanabara,307483,5,1,0,1,0
5_1140983,feast_satisfaction_wonderbread_ham_bosnia_alsace,1140983,5,1,0,1,0
5_1379482,feast_satisfaction_wonderbread_ham_bavaria_guanabara,1379482,5,1,0,1,0
5_5198871,feast_satisfaction_wonderbread_arugula_bavaria_guanabara,5198871,5,1,0,1,0
5_308746,feast_love_mutton_marzipan_goias_bavaria,308746,5,1,0,1,0
5_1463910,feast_love_mutton_ham_goias_bavaria,1463910,5,1,0,1,0
5_3583146,succumb_loneliness_lubricity_shrimp_earth_uranus,3583146,5,1,0,1,0
5_6933446,succumb_loneliness_lubricity_shrimp_saturn_earth,6933446,5,1,0,1,0
5_4617339,succumb_loneliness_lubricity_arugula_earth_uranus,4617339,5,1,0,1,0
5_958484,succumb_loneliness_lubricity_potato_saturn_earth,958484,5,1,0,1,0
5_5609161,succumb_loneliness_lubricity_potato_earth_uranus,5609161,5,1,0,1,0
5_1669554,succumb_loneliness_lubricity_yogurt_earth_uranus,1669554,5,1,0,1,0
5_3146267,overcome_boils_lubricity_shrimp_saturn_earth,3146267,5,1,0,1,0
5_5418814,overcome_boils_love_shrimp_earth_uranus,5418814,5,1,0,1,0
5_6261612,overcome_boils_intoxication_shrimp_saturn_earth,6261612,5,1,0,1,0
5_6105210,overcome_boils_lubricity_shrimp_mercury_saturn,6105210,5,1,0,1,0
5_4171450,overcome_boils_rest_shrimp_mercury_saturn,4171450,5,1,0,1,0
5_5941935,overcome_loneliness-3_rest_ham_mercury_saturn,5941935,5,1,0,1,0
5_2441384,overcome_loneliness-3_lubricity_ham_saturn_earth,2441384,5,1,0,1,0
5_6584833,overcome_loneliness-3_love_ham_earth_uranus,6584833,5,1,0,1,0
5_5942320,overcome_loneliness-3_intoxication_ham_saturn_earth,5942320,5,1,0,1,0
5_7026343,feast_intoxication_wonderbread_ham_bosnia_alsace,7026343,5,1,0,1,0
5_7975341,feast_rest_wonderbread_arugula_bosnia_alsace,7975341,5,1,0,1,0
5_2926233,feast_rest_wonderbread_ham_bosnia_alsace,2926233,5,1,0,1,0
5_577277,feast_intoxication_wonderbread_yogurt_bosnia_alsace,577277,5,1,0,1,0
5_1244925,feast_rest_wonderbread_yogurt_bosnia_alsace,1244925,5,1,0,1,0
5_5077970,feast_intoxication_wonderbread_arugula_bosnia_alsace,5077970,5,1,0,1,0
5_6489375,feast_rest_arugula_wonderbread_alsace_surrey,6489375,5,1,0,1,0
5_4940956,feast_rest_arugula_potato_alsace_surrey,4940956,5,1,0,1,0
5_242885,succumb_prostatitis_achievement_wurst_saturn_earth,242885,5,1,0,1,0
5_4647334,succumb_jealousy_achievement_rice_saturn_earth,4647334,5,1,0,1,0
5_5335632,succumb_depression_achievement_marzipan_saturn_earth,5335632,5,1,0,1,0
5_6582681,overcome_jealousy_achievement_cherry_mercury_saturn,6582681,5,1,0,1,0
5_4138778,overcome_depression_achievement_endive_mercury_saturn,4138778,5,1,0,1,0
5_531226,overcome_laceration_achievement_marzipan_mercury_saturn,531226,5,1,0,1,0
5_6215773,succumb_depression_achievement_endive_saturn_earth,6215773,5,1,0,1,0
5_4694419,succumb_depression_achievement_wurst_saturn_earth,4694419,5,1,0,1,0
5_1622416,overcome_laceration_achievement_cherry_mercury_saturn,1622416,5,1,0,1,0
5_3968464,overcome_hangover_achievement_rice_mercury_saturn,3968464,5,1,0,1,0
5_1472360,succumb_depression_achievement_cherry_saturn_earth,1472360,5,1,0,1,0
5_848908,succumb_depression_achievement_rice_saturn_earth,848908,5,1,0,1,0
5_5476004,overcome_dread_achievement_wurst_mercury_saturn,5476004,5,1,0,1,0
5_6222824,succumb_anxiety_excitement_marzipan_earth_uranus,6222824,5,1,0,1,0
5_5089444,succumb_depression-7_lubricity_haroset_earth_uranus,5089444,5,1,0,1,0
5_2740385,feast_love_turkey_shrimp_goias_bavaria,2740385,5,1,0,1,0
5_7393960,feast_love_turkey_haroset_goias_bavaria,7393960,5,1,0,1,0
5_1269681,feast_rest_marzipan_onion_bosnia_alsace,1269681,5,1,0,1,0
5_537965,feast_rest_marzipan_haroset_bosnia_alsace,537965,5,1,0,1,0
5_2061311,feast_rest_marzipan_cherry_bosnia_alsace,2061311,5,1,0,1,0
5_6851006,feast_rest_marzipan_rice_bosnia_alsace,6851006,5,1,0,1,0
5_4533354,feast_rest_marzipan_mutton_bosnia_alsace,4533354,5,1,0,1,0
5_200491,feast_lubricity_cherry_rice_bosnia_alsace,200491,5,1,0,1,0
5_2961173,feast_lubricity_cherry_marzipan_bosnia_alsace,2961173,5,1,0,1,0
5_5297570,feast_lubricity_cherry_endive_bosnia_alsace,5297570,5,1,0,1,0
5_4553765,locale_cherry_guanabara,4553765,5,3,0,3,0
5_6123037,succumb_depression_achievement_cherry_earth_uranus,6123037,5,1,0,1,0
5_5499585,succumb_depression_achievement_rice_earth_uranus,5499585,5,1,0,1,0
5_1985332,succumb_depression_achievement_marzipan_earth_uranus,1985332,5,1,0,1,0
5_2865473,succumb_depression_achievement_endive_earth_uranus,2865473,5,1,0,1,0
5_1344119,succumb_depression_achievement_wurst_earth_uranus,1344119,5,1,0,1,0
5_1989738,feast_lubricity_cherry_marzipan_guanabara_bosnia,1989738,5,1,0,1,0
5_3487577,feast_lubricity_cherry_rice_guanabara_bosnia,3487577,5,1,0,1,0
5_4620653,feast_lubricity_cherry_endive_guanabara_bosnia,4620653,5,1,0,1,0
5_5796473,succumb_grief_love_endive_earth_uranus,5796473,5,1,0,1,0
5_6804798,feast_rest_arugula_potato_bavaria_guanabara,6804798,5,1,0,1,0
5_2289875,feast_rest_arugula_wonderbread_bavaria_guanabara,2289875,5,1,0,1,0
5_6288341,overcome_depression_love_wurst_earth_uranus,6288341,5,1,0,1,0
5_2530035,overcome_depression_entertainment_wurst_saturn_earth,2530035,5,1,0,1,0
5_1944225,overcome_depression_achievement_wurst_saturn_earth,1944225,5,1,0,1,0
5_6022672,overcome_depression_excitement_wurst_saturn_earth,6022672,5,1,0,1,0
5_1637664,overcome_depression_love_wurst_saturn_earth,1637664,5,1,0,1,0
5_7180712,overcome_depression_entertainment_wurst_earth_uranus,7180712,5,1,0,1,0
5_2767387,overcome_angina_love_onion_earth_uranus,2767387,5,1,0,1,0
5_6117687,overcome_angina_love_onion_saturn_earth,6117687,5,1,0,1,0
5_264179,overcome_angina_achievement_onion_saturn_earth,264179,5,1,0,1,0
5_7798075,overcome_angina_lubricity_onion_mercury_saturn,7798075,5,1,0,1,0
5_272773,overcome_angina_lubricity_onion_saturn_earth,272773,5,1,0,1,0
5_4026357,overcome_angina_rest_onion_mercury_saturn,4026357,5,1,0,1,0
5_4471696,feast_love_marzipan_cherry_bosnia_alsace,4471696,5,1,0,1,0
5_1521296,feast_love_marzipan_haroset_bosnia_alsace,1521296,5,1,0,1,0
5_6943739,feast_love_marzipan_mutton_bosnia_alsace,6943739,5,1,0,1,0
5_3248087,feast_love_marzipan_onion_bosnia_alsace,3248087,5,1,0,1,0
5_4670967,feast_love_marzipan_rice_bosnia_alsace,4670967,5,1,0,1,0
5_2449140,feast_excitement_mutton_marzipan_goias_bavaria,2449140,5,1,0,1,0
5_892670,feast_excitement_mutton_ham_goias_bavaria,892670,5,1,0,1,0
5_2917389,feast_love_papaya_rice_bavaria_guanabara,2917389,5,1,0,1,0
5_6751788,feast_achievement_papaya_wurst_bavaria_guanabara,6751788,5,1,0,1,0
5_882237,feast_love_papaya_wurst_bavaria_guanabara,882237,5,1,0,1,0
5_5057783,feast_excitement_papaya_rice_bavaria_guanabara,5057783,5,1,0,1,0
5_4971815,feast_achievement_papaya_rice_bavaria_guanabara,4971815,5,1,0,1,0
5_4756665,feast_excitement_papaya_wurst_bavaria_guanabara,4756665,5,1,0,1,0
5_4260336,overcome_abrasion-4_intoxication_ham_saturn_earth,4260336,5,1,0,1,0
5_6459978,overcome_abrasion-4_rest_ham_mercury_saturn,6459978,5,1,0,1,0
5_4452158,overcome_abrasion-4_lubricity_ham_saturn_earth,4452158,5,1,0,1,0
5_4407451,overcome_abrasion-4_love_ham_earth_uranus,4407451,5,1,0,1,0
5_5314247,succumb_jealousy_love_mutton_earth_uranus,5314247,5,1,0,1,0
5_5891246,succumb_jealousy_love_endive_earth_uranus,5891246,5,1,0,1,0
5_7501196,succumb_jealousy_love_papaya_earth_uranus,7501196,5,1,0,1,0
5_2830692,succumb_jealousy_love_marzipan_earth_uranus,2830692,5,1,0,1,0
5_6334738,succumb_jealousy_love_onion_earth_uranus,6334738,5,1,0,1,0
5_1147833,succumb_jealousy_love_cherry_earth_uranus,1147833,5,1,0,1,0
5_2449822,succumb_jealousy_love_wurst_earth_uranus,2449822,5,1,0,1,0
5_227201,succumb_jealousy_love_haroset_earth_uranus,227201,5,1,0,1,0
5_1784700,succumb_jealousy_love_rice_earth_uranus,1784700,5,1,0,1,0
5_4396949,overcome_loneliness_lubricity_shrimp_mercury_saturn,4396949,5,1,0,1,0
5_997422,overcome_abrasion-4_lubricity_onion_mercury_saturn,997422,5,1,0,1,0
5_3796852,succumb_anger_excitement_marzipan_earth_uranus,3796852,5,1,0,1,0
5_7530746,succumb_abrasion_lubricity_yogurt_earth_uranus,7530746,5,1,0,1,0
5_5473331,feast_achievement_rice_cherry_goias_bavaria,5473331,5,1,0,1,0
5_6762830,feast_excitement_rice_cherry_goias_bavaria,6762830,5,1,0,1,0
5_7735928,feast_achievement_rice_papaya_goias_bavaria,7735928,5,1,0,1,0
5_1254367,feast_achievement_rice_marzipan_goias_bavaria,1254367,5,1,0,1,0
5_2128710,feast_love_rice_marzipan_goias_bavaria,2128710,5,1,0,1,0
5_3541757,feast_excitement_rice_marzipan_goias_bavaria,3541757,5,1,0,1,0
5_981707,feast_love_rice_cherry_goias_bavaria,981707,5,1,0,1,0
5_3244304,feast_love_rice_papaya_goias_bavaria,3244304,5,1,0,1,0
5_1024450,feast_excitement_rice_papaya_goias_bavaria,1024450,5,1,0,1,0
5_626343,overcome_laceration_achievement_marzipan_saturn_earth,626343,5,1,0,1,0
5_1444092,overcome_laceration_lubricity_marzipan_saturn_earth,1444092,5,1,0,1,0
5_6143992,overcome_laceration_love_marzipan_earth_uranus,6143992,5,1,0,1,0
5_1138386,overcome_laceration_excitement_marzipan_saturn_earth,1138386,5,1,0,1,0
5_405478,overcome_laceration_rest_marzipan_mercury_saturn,405478,5,1,0,1,0
5_1493315,overcome_laceration_love_marzipan_saturn_earth,1493315,5,1,0,1,0
5_2231547,feast_achievement_mutton_ham_goias_bavaria,2231547,5,1,0,1,0
5_5899338,feast_rest_mutton_marzipan_goias_bavaria,5899338,5,1,0,1,0
5_4448435,feast_intoxication_mutton_ham_goias_bavaria,4448435,5,1,0,1,0
5_903528,feast_rest_mutton_ham_goias_bavaria,903528,5,1,0,1,0
5_2363172,feast_achievement_mutton_marzipan_goias_bavaria,2363172,5,1,0,1,0
5_1998471,feast_intoxication_mutton_marzipan_goias_bavaria,1998471,5,1,0,1,0
5_5956476,overcome_dread_entertainment_wurst_earth_uranus,5956476,5,1,0,1,0
5_3616283,harmony_entertainment_earth,3616283,5,1,0,1,0
5_6642490,overcome_dread_excitement_papaya_saturn_earth,6642490,5,1,0,1,0
5_3231688,overcome_dread_achievement_papaya_saturn_earth,3231688,5,1,0,1,0
5_4290586,overcome_dread_love_papaya_earth_uranus,4290586,5,1,0,1,0
5_7640886,overcome_dread_love_papaya_saturn_earth,7640886,5,1,0,1,0
5_5596181,feast_lubricity_shrimp_potato_bavaria_guanabara,5596181,5,1,0,1,0
5_3102179,feast_lubricity_shrimp_onion_bavaria_guanabara,3102179,5,1,0,1,0
5_5489925,feast_lubricity_shrimp_turkey_bavaria_guanabara,5489925,5,1,0,1,0
5_5575143,feast_achievement_onion_shrimp_bosnia_alsace,5575143,5,1,0,1,0
5_2687088,feast_achievement_onion_marzipan_bosnia_alsace,2687088,5,1,0,1,0
5_4906330,feast_achievement_onion_ham_bosnia_alsace,4906330,5,1,0,1,0
5_4920424,feast_rest_turkey_shrimp_goias_bavaria,4920424,5,1,0,1,0
5_5415554,feast_rest_turkey_haroset_goias_bavaria,5415554,5,1,0,1,0
5_4812240,feast_excitement_endive_wurst_bavaria_guanabara,4812240,5,1,0,1,0
5_3335533,feast_achievement_endive_cherry_bavaria_guanabara,3335533,5,1,0,1,0
5_4646573,feast_excitement_endive_cherry_bavaria_guanabara,4646573,5,1,0,1,0
5_6807363,feast_achievement_endive_wurst_bavaria_guanabara,6807363,5,1,0,1,0
5_937812,feast_love_endive_wurst_bavaria_guanabara,937812,5,1,0,1,0
5_4914153,feast_love_endive_cherry_bavaria_guanabara,4914153,5,1,0,1,0
5_7973276,locale_endive_bavaria,7973276,5,3,0,3,0
5_7994383,feast_intoxication_turkey_haroset_goias_bavaria,7994383,5,1,0,1,0
5_5024259,feast_intoxication_turkey_shrimp_goias_bavaria,5024259,5,1,0,1,0
5_1607211,locale_turkey_goias,1607211,5,0,0,0,0
5_483496,succumb_hangover_excitement_marzipan_earth_uranus,483496,5,1,0,1,0
5_5464094,overcome_depression_excitement_cherry_saturn_earth,5464094,5,1,0,1,0
5_882136,overcome_laceration_excitement_cherry_saturn_earth,882136,5,1,0,1,0
5_4750336,succumb_hangover_excitement_papaya_earth_uranus,4750336,5,1,0,1,0
5_813878,succumb_hangover_excitement_wurst_earth_uranus,813878,5,1,0,1,0
5_3314474,overcome_jealousy_excitement_cherry_saturn_earth,3314474,5,1,0,1,0
5_1028218,succumb_hangover_excitement_rice_earth_uranus,1028218,5,1,0,1,0
5_6922960,overcome_hangover_excitement_papaya_saturn_earth,6922960,5,1,0,1,0
5_6397950,succumb_hangover_excitement_cherry_earth_uranus,6397950,5,1,0,1,0
5_1305799,overcome_dread_entertainment_wurst_saturn_earth,1305799,5,1,0,1,0
5_5713536,succumb_boils-1_intoxication_ham_earth_uranus,5713536,5,1,0,1,0
5_2554286,succumb_boils-1_intoxication_arugula_earth_uranus,2554286,5,1,0,1,0
5_7507585,succumb_boils-1_intoxication_potato_earth_uranus,7507585,5,1,0,1,0
5_3567978,succumb_boils-1_intoxication_yogurt_earth_uranus,3567978,5,1,0,1,0
5_5481570,succumb_boils-1_intoxication_shrimp_earth_uranus,5481570,5,1,0,1,0
5_2272662,succumb_boils-1_intoxication_wonderbread_earth_uranus,2272662,5,1,0,1,0
5_754823,feast_rest_yogurt_potato_goias_bavaria,754823,5,1,0,1,0
5_2750804,feast_rest_yogurt_wonderbread_goias_bavaria,2750804,5,1,0,1,0
5_7874447,feast_satisfaction_potato_arugula_guanabara_bosnia,7874447,5,1,0,1,0
5_6881144,feast_satisfaction_potato_arugula_goias_bavaria,6881144,5,1,0,1,0
5_7129944,feast_satisfaction_potato_shrimp_bavaria_guanabara,7129944,5,1,0,1,0
5_5584884,feast_satisfaction_potato_yogurt_guanabara_bosnia,5584884,5,1,0,1,0
5_7467524,feast_satisfaction_potato_arugula_bavaria_guanabara,7467524,5,1,0,1,0
5_5410717,feast_satisfaction_potato_yogurt_bavaria_guanabara,5410717,5,1,0,1,0
5_6663456,feast_satisfaction_potato_shrimp_goias_bavaria,6663456,5,1,0,1,0
5_7248052,feast_satisfaction_potato_shrimp_guanabara_bosnia,7248052,5,1,0,1,0
5_4843501,feast_satisfaction_potato_yogurt_goias_bavaria,4843501,5,1,0,1,0
5_7308797,overcome_hangover_rest_rice_mercury_saturn,7308797,5,1,0,1,0
5_5161686,overcome_abrasion-4_rest_onion_mercury_saturn,5161686,5,1,0,1,0
5_7430733,overcome_loneliness-3_rest_wonderbread_mercury_saturn,7430733,5,1,0,1,0
5_5874531,overcome_depression_rest_cherry_mercury_saturn,5874531,5,1,0,1,0
5_6615081,overcome_boils-1_rest_arugula_mercury_saturn,6615081,5,1,0,1,0
5_7825528,overcome_sciatica_rest_wonderbread_mercury_saturn,7825528,5,1,0,1,0
5_2652325,overcome_laceration_rest_cherry_mercury_saturn,2652325,5,1,0,1,0
5_270525,overcome_jealousy_rest_cherry_mercury_saturn,270525,5,1,0,1,0
5_4877175,overcome_boils_rest_potato_mercury_saturn,4877175,5,1,0,1,0
5_6916063,overcome_loneliness_rest_shrimp_mercury_saturn,6916063,5,1,0,1,0
5_4942809,overcome_abrasion_rest_yogurt_mercury_saturn,4942809,5,1,0,1,0
5_4459407,overcome_boils_rest_turkey_mercury_saturn,4459407,5,1,0,1,0
5_7984357,succumb_hangover_excitement_papaya_mercury_saturn,7984357,5,1,0,1,0
5_3180382,succumb_anger_lubricity_marzipan_earth_uranus,3180382,5,1,0,1,0
5_5668237,feast_lubricity_cherry_marzipan_goias_bavaria,5668237,5,1,0,1,0
5_3657,feast_lubricity_cherry_endive_goias_bavaria,3657,5,1,0,1,0
5_2907555,feast_lubricity_cherry_rice_goias_bavaria,2907555,5,1,0,1,0
5_2197149,overcome_loneliness_love_shrimp_earth_uranus,2197149,5,1,0,1,0
5_1484539,overcome_loneliness_lubricity_shrimp_saturn_earth,1484539,5,1,0,1,0
5_999554,overcome_loneliness_intoxication_shrimp_saturn_earth,999554,5,1,0,1,0
5_50365,overcome_boils_love_turkey_earth_uranus,50365,5,1,0,1,0
5_4950594,overcome_laceration_love_cherry_earth_uranus,4950594,5,1,0,1,0
5_4671043,overcome_laceration_achievement_cherry_saturn_earth,4671043,5,1,0,1,0
5_299917,overcome_laceration_love_cherry_saturn_earth,299917,5,1,0,1,0
5_1772368,succumb_abrasion-4_lubricity_ham_earth_uranus,1772368,5,1,0,1,0
5_2413181,feast_satisfaction_marzipan_rice_bosnia_alsace,2413181,5,1,0,1,0
5_7570631,feast_satisfaction_marzipan_haroset_bosnia_alsace,7570631,5,1,0,1,0
5_1325215,feast_satisfaction_marzipan_onion_bosnia_alsace,1325215,5,1,0,1,0
5_276061,feast_satisfaction_marzipan_cherry_bosnia_alsace,276061,5,1,0,1,0
5_2748104,feast_satisfaction_marzipan_mutton_bosnia_alsace,2748104,5,1,0,1,0
5_1569386,overcome_hangover_love_rice_saturn_earth,1569386,5,1,0,1,0
5_5913418,overcome_hangover_achievement_rice_saturn_earth,5913418,5,1,0,1,0
5_6220063,overcome_hangover_love_rice_earth_uranus,6220063,5,1,0,1,0
5_2441744,succumb_loneliness_intoxication_yogurt_earth_uranus,2441744,5,1,0,1,0
5_4654543,overcome_sciatica_intoxication_wonderbread_saturn_earth,4654543,5,1,0,1,0
5_3154392,overcome_boils-1_intoxication_arugula_saturn_earth,3154392,5,1,0,1,0
5_2384389,succumb_jealousy-2_intoxication_yogurt_earth_uranus,2384389,5,1,0,1,0
5_4355336,succumb_loneliness_intoxication_shrimp_earth_uranus,4355336,5,1,0,1,0
5_7611429,overcome_abrasion_intoxication_yogurt_saturn_earth,7611429,5,1,0,1,0
5_6704429,succumb_jealousy-2_intoxication_wonderbread_earth_uranus,6704429,5,1,0,1,0
5_3592628,succumb_jealousy-2_intoxication_arugula_earth_uranus,3592628,5,1,0,1,0
5_2040923,overcome_loneliness-3_intoxication_wonderbread_saturn_earth,2040923,5,1,0,1,0
5_5807460,succumb_jealousy-2_intoxication_ham_earth_uranus,5807460,5,1,0,1,0
5_2273554,succumb_loneliness_intoxication_arugula_earth_uranus,2273554,5,1,0,1,0
5_6381351,succumb_loneliness_intoxication_potato_earth_uranus,6381351,5,1,0,1,0
5_286650,overcome_boils_intoxication_potato_saturn_earth,286650,5,1,0,1,0
5_2311836,feast_lubricity_onion_marzipan_bosnia_alsace,2311836,5,1,0,1,0
5_4680578,feast_lubricity_onion_ham_bosnia_alsace,4680578,5,1,0,1,0
5_1999017,feast_lubricity_onion_shrimp_bosnia_alsace,1999017,5,1,0,1,0
5_3092298,feast_satiety_marzipan_haroset_bosnia_alsace,3092298,5,1,0,1,0
5_2136788,feast_satiety_marzipan_mutton_bosnia_alsace,2136788,5,1,0,1,0
5_7665722,feast_satiety_marzipan_cherry_bosnia_alsace,7665722,5,1,0,1,0
5_6948514,feast_satiety_marzipan_onion_bosnia_alsace,6948514,5,1,0,1,0
5_5841813,feast_satiety_marzipan_rice_bosnia_alsace,5841813,5,1,0,1,0
5_4431939,overcome_depression_love_endive_earth_uranus,4431939,5,1,0,1,0
5_7782239,overcome_depression_love_endive_saturn_earth,7782239,5,1,0,1,0
5_6252085,overcome_depression_achievement_endive_saturn_earth,6252085,5,1,0,1,0
5_5393162,overcome_boils-1_lubricity_arugula_saturn_earth,5393162,5,1,0,1,0
5_6226155,overcome_abrasion-4_lubricity_onion_saturn_earth,6226155,5,1,0,1,0
5_7251003,overcome_abrasion_lubricity_yogurt_saturn_earth,7251003,5,1,0,1,0
5_4770235,overcome_dread_achievement_wurst_saturn_earth,4770235,5,1,0,1,0
5_999605,overcome_dread_love_wurst_earth_uranus,999605,5,1,0,1,0
5_4349905,overcome_dread_love_wurst_saturn_earth,4349905,5,1,0,1,0
5_5142496,succumb_dread_satiety_papaya_mercury_saturn,5142496,5,1,0,1,0
5_858658,feast_intoxication_yogurt_potato_goias_bavaria,858658,5,1,0,1,0
5_2083156,feast_intoxication_yogurt_wonderbread_goias_bavaria,2083156,5,1,0,1,0
5_4470090,succumb_anger_love_haroset_earth_uranus,4470090,5,1,0,1,0
5_5882477,succumb_anger_love_onion_earth_uranus,5882477,5,1,0,1,0
5_5383672,succumb_anger_love_cherry_earth_uranus,5383672,5,1,0,1,0
5_1549109,succumb_anger_love_mutton_earth_uranus,1549109,5,1,0,1,0
5_877404,succumb_anger_love_marzipan_earth_uranus,877404,5,1,0,1,0
5_6439752,succumb_anger_love_rice_earth_uranus,6439752,5,1,0,1,0
5_3164776,feast_intoxication_onion_ham_bosnia_alsace,3164776,5,1,0,1,0
5_1805768,feast_intoxication_onion_shrimp_bosnia_alsace,1805768,5,1,0,1,0
5_3091963,feast_intoxication_onion_marzipan_bosnia_alsace,3091963,5,1,0,1,0
5_1464503,overcome_abrasion-4_achievement_onion_saturn_earth,1464503,5,1,0,1,0
5_3765451,overcome_abrasion-4_love_onion_earth_uranus,3765451,5,1,0,1,0
5_7115751,overcome_abrasion-4_love_onion_saturn_earth,7115751,5,1,0,1,0
5_7003098,succumb_dread_love_wurst_earth_uranus,7003098,5,1,0,1,0
5_4827441,succumb_laceration-8_love_haroset_earth_uranus,4827441,5,1,0,1,0
5_5927990,succumb_dread_love_rice_earth_uranus,5927990,5,1,0,1,0
5_3093336,succumb_hangover_love_rice_earth_uranus,3093336,5,1,0,1,0
5_7797629,succumb_hangover_love_papaya_earth_uranus,7797629,5,1,0,1,0
5_3305677,overcome_hangover_love_papaya_saturn_earth,3305677,5,1,0,1,0
5_4206177,succumb_depression-7_love_haroset_earth_uranus,4206177,5,1,0,1,0
5_3038826,overcome_depression_love_cherry_saturn_earth,3038826,5,1,0,1,0
5_3474011,succumb_angina_love_onion_earth_uranus,3474011,5,1,0,1,0
5_4997210,succumb_dread_love_papaya_earth_uranus,4997210,5,1,0,1,0
5_1419604,succumb_hangover_love_wurst_earth_uranus,1419604,5,1,0,1,0
5_7805251,succumb_prostatitis_love_wurst_earth_uranus,7805251,5,1,0,1,0
5_4434939,feast_rest_wonderbread_ham_bavaria_guanabara,4434939,5,1,0,1,0
5_2760620,feast_rest_wonderbread_yogurt_bavaria_guanabara,2760620,5,1,0,1,0
5_1124760,feast_rest_wonderbread_arugula_bavaria_guanabara,1124760,5,1,0,1,0
5_1805286,feast_love_papaya_wurst_goias_bavaria,1805286,5,1,0,1,0
5_566584,feast_love_papaya_wurst_guanabara_bosnia,566584,5,1,0,1,0
5_2074717,feast_love_papaya_rice_guanabara_bosnia,2074717,5,1,0,1,0
5_4027105,feast_love_papaya_rice_goias_bavaria,4027105,5,1,0,1,0
5_7555780,feast_intoxication_wonderbread_arugula_bavaria_guanabara,7555780,5,1,0,1,0
5_1537568,feast_intoxication_wonderbread_ham_bavaria_guanabara,1537568,5,1,0,1,0
5_7411306,feast_intoxication_wonderbread_yogurt_bavaria_guanabara,7411306,5,1,0,1,0
5_1592029,feast_excitement_papaya_wurst_goias_bavaria,1592029,5,1,0,1,0
5_7521319,feast_achievement_papaya_wurst_goias_bavaria,7521319,5,1,0,1,0
5_517752,feast_achievement_papaya_rice_goias_bavaria,517752,5,1,0,1,0
5_1807251,feast_excitement_papaya_rice_goias_bavaria,1807251,5,1,0,1,0
5_5348635,feast_love_endive_wurst_guanabara_bosnia,5348635,5,1,0,1,0
5_7144114,feast_love_endive_cherry_bosnia_alsace,7144114,5,1,0,1,0
5_1207410,feast_love_endive_cherry_guanabara_bosnia,1207410,5,1,0,1,0
5_4779159,feast_love_endive_wurst_bosnia_alsace,4779159,5,1,0,1,0
5_3770784,feast_excitement_papaya_rice_guanabara_bosnia,3770784,5,1,0,1,0
5_2706978,feast_excitement_papaya_wurst_guanabara_bosnia,2706978,5,1,0,1,0
5_2270265,feast_achievement_papaya_rice_guanabara_bosnia,2270265,5,1,0,1,0
5_2621010,feast_achievement_papaya_wurst_guanabara_bosnia,2621010,5,1,0,1,0
5_3023215,overcome_hangover_achievement_papaya_saturn_earth,3023215,5,1,0,1,0
5_7956354,overcome_hangover_love_papaya_earth_uranus,7956354,5,1,0,1,0
5_2745379,feast_love_shrimp_onion_bavaria_guanabara,2745379,5,1,0,1,0
5_2266128,feast_love_shrimp_potato_bavaria_guanabara,2266128,5,1,0,1,0
5_2159872,feast_love_shrimp_turkey_bavaria_guanabara,2159872,5,1,0,1,0
5_1306558,overcome_jealousy_love_cherry_earth_uranus,1306558,5,1,0,1,0
5_7689503,overcome_depression_love_cherry_earth_uranus,7689503,5,1,0,1,0
5_5081838,feast_excitement_endive_cherry_guanabara_bosnia,5081838,5,1,0,1,0
5_556184,feast_excitement_endive_cherry_bosnia_alsace,556184,5,1,0,1,0
5_7489029,feast_excitement_endive_wurst_guanabara_bosnia,7489029,5,1,0,1,0
5_4565902,feast_excitement_endive_wurst_bosnia_alsace,4565902,5,1,0,1,0
5_6018798,feast_lubricity_potato_shrimp_bavaria_guanabara,6018798,5,1,0,1,0
5_3048343,feast_lubricity_potato_arugula_bavaria_guanabara,3048343,5,1,0,1,0
5_5265438,feast_intoxication_potato_yogurt_bavaria_guanabara,5265438,5,1,0,1,0
5_4299571,feast_lubricity_potato_yogurt_bavaria_guanabara,4299571,5,1,0,1,0
5_6984665,feast_intoxication_potato_shrimp_bavaria_guanabara,6984665,5,1,0,1,0
5_2280008,feast_intoxication_potato_arugula_bavaria_guanabara,2280008,5,1,0,1,0
5_3491505,locale_potato_goias,3491505,5,2,0,2,0
5_614292,feast_satiety_onion_ham_bosnia_alsace,614292,5,1,0,1,0
5_5926924,feast_satiety_onion_shrimp_bosnia_alsace,5926924,5,1,0,1,0
5_6191967,feast_satiety_onion_marzipan_bosnia_alsace,6191967,5,1,0,1,0
5_6269771,feast_achievement_endive_cherry_bosnia_alsace,6269771,5,1,0,1,0
5_2494215,feast_achievement_endive_wurst_bosnia_alsace,2494215,5,1,0,1,0
5_7403061,feast_achievement_endive_wurst_guanabara_bosnia,7403061,5,1,0,1,0
5_7076961,feast_achievement_endive_cherry_guanabara_bosnia,7076961,5,1,0,1,0
5_1203896,succumb_anger_satiety_onion_mercury_saturn,1203896,5,1,0,1,0
5_1250244,succumb_anger_satiety_marzipan_mercury_saturn,1250244,5,1,0,1,0
5_2182438,succumb_grief_satiety_cherry_mercury_saturn,2182438,5,1,0,1,0
5_2482532,succumb_grief_satiety_wurst_mercury_saturn,2482532,5,1,0,1,0
5_6918728,succumb_anger_satiety_cherry_mercury_saturn,6918728,5,1,0,1,0
5_4537425,succumb_grief_satiety_endive_mercury_saturn,4537425,5,1,0,1,0
5_3118069,succumb_anger_satiety_rice_mercury_saturn,3118069,5,1,0,1,0
5_5879414,succumb_anger_satiety_haroset_mercury_saturn,5879414,5,1,0,1,0
5_7684553,succumb_anger_satiety_mutton_mercury_saturn,7684553,5,1,0,1,0
5_623335,feast_lubricity_potato_arugula_goias_bavaria,623335,5,1,0,1,0
5_7893326,feast_lubricity_potato_yogurt_guanabara_bosnia,7893326,5,1,0,1,0
5_4670021,feast_lubricity_potato_shrimp_goias_bavaria,4670021,5,1,0,1,0
5_1555517,feast_lubricity_potato_shrimp_guanabara_bosnia,1555517,5,1,0,1,0
5_2850066,feast_lubricity_potato_yogurt_goias_bavaria,2850066,5,1,0,1,0
5_6763301,feast_lubricity_potato_arugula_guanabara_bosnia,6763301,5,1,0,1,0
5_2884865,feast_rest_arugula_wonderbread_guanabara_bosnia,2884865,5,1,0,1,0
5_7059259,feast_rest_arugula_potato_guanabara_bosnia,7059259,5,1,0,1,0
5_1508672,overcome_depression_achievement_cherry_saturn_earth,1508672,5,1,0,1,0
5_3273365,overcome_jealousy_achievement_cherry_saturn_earth,3273365,5,1,0,1,0
5_52391,feast_intoxication_potato_yogurt_guanabara_bosnia,52391,5,1,0,1,0
5_7729168,feast_intoxication_potato_arugula_guanabara_bosnia,7729168,5,1,0,1,0
5_1715559,feast_intoxication_potato_shrimp_guanabara_bosnia,1715559,5,1,0,1,0
5_3204139,feast_intoxication_potato_shrimp_goias_bavaria,3204139,5,1,0,1,0
5_1384184,feast_intoxication_potato_yogurt_goias_bavaria,1384184,5,1,0,1,0
5_1403462,feast_intoxication_potato_arugula_goias_bavaria,1403462,5,1,0,1,0
