id,name,hash,time,ind,otd,ad,bc
0_3046200,locale_tofu_manitoba,3046200,0,0,1,1,0
1_191203,noop_locale_tofu_manitoba,191203,1,1,1,2,0
0_918250,pain_boils,918250,0,0,3,3,0
1_6427428,noop_pain_boils,6427428,1,1,1,2,0
1_5715987,overcome_boils_lubricity_lemon_saturn_earth,5715987,1,14,23,37,0
0_3715801,orbits_saturn_earth,3715801,0,0,13,13,0
1_5861162,noop_orbits_saturn_earth,5861162,1,1,1,2,0
1_5592600,overcome_sciatica_aesthetics_bacon_saturn_earth,5592600,1,13,19,32,0
1_1277058,overcome_laceration_stimulation_lamb_saturn_earth,1277058,1,13,25,38,0
0_2289801,eats_haroset_lobster,2289801,0,0,4,4,0
1_7435781,noop_eats_haroset_lobster,7435781,1,1,1,2,0
1_7135015,feast_love_haroset_lobster_bavaria_manitoba,7135015,1,12,31,43,0
0_137551,eats_ham_lemon,137551,0,0,2,2,0
1_923989,noop_eats_ham_lemon,923989,1,1,1,2,0
0_7563751,eats_cantelope_lemon,7563751,0,0,1,1,0
1_4708754,noop_eats_cantelope_lemon,4708754,1,1,1,2,0
0_3344601,craves_loneliness_tofu,3344601,0,0,1,1,0
1_1108354,noop_craves_loneliness_tofu,1108354,1,1,1,2,0
0_2247302,craves_entertainment_lobster,2247302,0,0,5,5,0
1_937738,noop_craves_entertainment_lobster,937738,1,3,13,16,0
1_5347858,feast_entertainment_lobster_haroset_bavaria_manitoba,5347858,1,11,23,34,0
1_7467054,feast_entertainment_lobster_bacon_bavaria_manitoba,7467054,1,11,23,34,0
1_2432615,overcome_grief_entertainment_lobster_vulcan_uranus,2432615,1,13,23,36,0
0_4569802,eats_haroset_lamb,4569802,0,0,4,4,0
1_1616227,noop_eats_haroset_lamb,1616227,1,1,1,2,0
1_5112850,feast_love_haroset_lamb_bavaria_manitoba,5112850,1,12,31,43,0
0_4730552,eats_beef_lemon,4730552,0,0,3,3,0
1_6034255,noop_eats_beef_lemon,6034255,1,1,1,2,0
0_6188452,food_ham,6188452,0,0,6,6,0
1_1903589,noop_food_ham,1903589,1,1,1,2,0
1_6955647,feast_lubricity_lemon_ham_bavaria_manitoba,6955647,1,12,21,33,0
0_7461953,craves_anger_flounder,7461953,0,0,2,2,0
1_4671628,noop_craves_anger_flounder,4671628,1,1,2,3,0
0_4138703,eats_wonderbread_marzipan,4138703,0,0,1,1,0
1_2516280,noop_eats_wonderbread_marzipan,2516280,1,1,1,2,0
0_2200903,pleasure_love,2200903,0,0,17,17,0
1_1016330,noop_pleasure_love,1016330,1,1,1,2,0
1_328749,feast_love_haroset_flounder_bavaria_manitoba,328749,1,12,31,43,0
1_4951120,overcome_jealousy_love_haroset_vulcan_uranus,4951120,1,14,29,43,0
0_6425404,eats_marzipan_wonderbread,6425404,0,0,1,1,0
1_4802981,noop_eats_marzipan_wonderbread,4802981,1,1,1,2,0
0_1891404,harmony_expectation_saturn,1891404,0,0,4,4,0
1_2601920,noop_harmony_expectation_saturn,2601920,1,2,7,9,0
1_4306136,overcome_hangover_expectation_okra_uranus_saturn,4306136,1,13,20,33,0
0_3412554,food_marzipan,3412554,0,0,3,3,0
1_2227981,noop_food_marzipan,2227981,1,1,1,2,0
0_6634256,eats_onion_snickers,6634256,0,0,1,1,0
1_778640,noop_eats_onion_snickers,778640,1,1,1,2,0
0_20256,province_oregon,20256,0,0,1,1,0
1_1323959,noop_province_oregon,1323959,1,1,1,2,0
0_2633557,craves_hangover_okra,2633557,0,0,3,3,0
1_7779537,noop_craves_hangover_okra,7779537,1,2,6,8,0
0_794907,harmony_stimulation_earth,794907,0,0,4,4,0
1_7173461,noop_harmony_stimulation_earth,7173461,1,2,7,9,0
0_3135358,eats_snickers_onion,3135358,0,0,3,3,0
1_5280719,noop_eats_snickers_onion,5280719,1,1,1,2,0
1_2466891,feast_learning_snickers_onion_bavaria_manitoba,2466891,1,12,22,34,0
0_4536909,craves_boils_lemon,4536909,0,0,2,2,0
1_513547,noop_craves_boils_lemon,513547,1,2,5,7,0
0_7952859,craves_dread_wonderbread,7952859,0,0,5,5,0
1_7165176,noop_craves_dread_wonderbread,7165176,1,2,8,10,0
1_4648643,overcome_dread_achievement_wonderbread_uranus_saturn,4648643,1,11,12,23,0
0_4985459,pain_sciatica,4985459,0,0,4,4,0
1_3800886,noop_pain_sciatica,3800886,1,1,1,2,0
0_1222810,harmony_learning_saturn,1222810,0,0,5,5,0
1_4813922,noop_harmony_learning_saturn,4813922,1,2,8,10,0
1_2696465,overcome_depression_learning_snickers_uranus_saturn,2696465,1,14,22,36,0
0_6088560,attacks_pennsylvania_oregon,6088560,0,0,9,9,0
1_3958185,noop_attacks_pennsylvania_oregon,3958185,1,1,1,2,0
0_1370260,pain_anxiety,1370260,0,0,2,2,0
1_6772543,noop_pain_anxiety,6772543,1,1,1,2,0
0_1803361,craves_abrasion_beef,1803361,0,0,3,3,0
1_6949341,noop_craves_abrasion_beef,6949341,1,1,3,4,0
0_4615811,locale_onion_bavaria,4615811,0,0,1,1,0
1_1760814,noop_locale_onion_bavaria,1760814,1,1,1,2,0
0_5075412,craves_achievement_wonderbread,5075412,0,0,3,3,0
1_7969387,noop_craves_achievement_wonderbread,7969387,1,1,1,2,0
0_7420512,orbits_vulcan_uranus,7420512,0,0,10,10,0
1_4565515,noop_orbits_vulcan_uranus,4565515,1,1,1,2,0
0_3151412,food_lamb,3151412,0,0,15,15,0
1_2360333,noop_food_lamb,2360333,1,1,1,2,0
1_5170983,feast_stimulation_lamb_beef_goias_bosnia,5170983,1,11,24,35,0
1_6902405,feast_stimulation_lamb_haroset_goias_bosnia,6902405,1,11,24,35,0
0_2268262,food_tofu,2268262,0,0,1,1,0
1_1477183,noop_food_tofu,1477183,1,1,1,2,0
0_5474563,craves_grief_lobster,5474563,0,0,4,4,0
1_2619566,noop_craves_grief_lobster,2619566,1,2,7,9,0
0_1484863,eats_lobster_haroset,1484863,0,0,4,4,0
1_6630843,noop_eats_lobster_haroset,6630843,1,1,1,2,0
0_1930663,food_flounder,1930663,0,0,8,8,0
1_746090,noop_food_flounder,746090,1,1,1,2,0
0_5586764,craves_stimulation_lamb,5586764,0,0,5,5,0
1_1176899,noop_craves_stimulation_lamb,1176899,1,3,16,19,0
0_3163114,planet_earth,3163114,0,0,10,10,0
1_564420,noop_planet_earth,564420,1,1,1,2,0
0_6588915,locale_wonderbread_bavaria,6588915,0,0,1,1,0
1_7299431,noop_locale_wonderbread_bavaria,7299431,1,1,1,2,0
0_4244617,craves_aesthetics_bacon,4244617,0,0,5,5,0
1_7835729,noop_craves_aesthetics_bacon,7835729,1,3,10,13,0
1_7476923,feast_aesthetics_bacon_lobster_bavaria_manitoba,7476923,1,11,18,29,0
1_394853,feast_aesthetics_bacon_wonderbread_bavaria_manitoba,394853,1,11,18,29,0
0_7012217,locale_flounder_oregon,7012217,0,0,3,3,0
1_4775970,noop_locale_flounder_oregon,4775970,1,1,3,4,0
0_3048718,craves_prostatitis_marzipan,3048718,0,0,1,1,0
1_918343,noop_craves_prostatitis_marzipan,918343,1,1,1,2,0
0_2161368,pleasure_expectation,2161368,0,0,10,10,0
1_7307348,noop_pleasure_expectation,7307348,1,1,1,2,0
1_1923741,feast_expectation_okra_snickers_bavaria_manitoba,1923741,1,11,19,30,0
1_2186495,feast_expectation_okra_wonderbread_bavaria_manitoba,2186495,1,11,19,30,0
0_1840068,food_wonderbread,1840068,0,0,12,12,0
1_7547979,noop_food_wonderbread,7547979,1,1,1,2,0
1_5107816,feast_learning_snickers_wonderbread_bavaria_manitoba,5107816,1,12,22,34,0
0_4177969,food_cantelope,4177969,0,0,2,2,0
1_4964407,noop_food_cantelope,4964407,1,1,1,2,0
1_5457751,feast_lubricity_lemon_cantelope_bavaria_manitoba,5457751,1,12,21,33,0
0_3659869,food_beef,3659869,0,0,13,13,0
1_2868790,noop_food_beef,2868790,1,1,1,2,0
1_2330190,feast_lubricity_lemon_beef_bavaria_manitoba,2330190,1,12,21,33,0
0_4889270,eats_flounder_haroset,4889270,0,0,2,2,0
1_2098945,noop_eats_flounder_haroset,2098945,1,1,1,2,0
0_6305720,harmony_aesthetics_earth,6305720,0,0,4,4,0
1_5518037,noop_harmony_aesthetics_earth,5518037,1,2,7,9,0
0_7813070,pain_abrasion,7813070,0,0,3,3,0
1_6628497,noop_pain_abrasion,6628497,1,1,1,2,0
0_6885171,craves_expectation_okra,6885171,0,0,5,5,0
1_2475306,noop_craves_expectation_okra,2475306,1,3,11,14,0
0_4101071,locale_lobster_manitoba,4101071,0,0,7,7,0
1_7692183,noop_locale_lobster_manitoba,7692183,1,3,17,20,0
0_496271,craves_laceration_lamb,496271,0,0,3,3,0
1_6261001,noop_craves_laceration_lamb,6261001,1,2,6,8,0
0_2278622,eats_okra_snickers,2278622,0,0,3,3,0
1_6256237,noop_eats_okra_snickers,6256237,1,1,1,2,0
0_7480922,planet_uranus,7480922,0,0,16,16,0
1_6296349,noop_planet_uranus,6296349,1,1,1,2,0
0_1626822,province_pennsylvania,1626822,0,0,1,1,0
1_6837474,noop_province_pennsylvania,6837474,1,1,1,2,0
0_7835272,food_snickers,7835272,0,0,12,12,0
1_6650699,noop_food_snickers,6650699,1,1,1,2,0
1_1212556,feast_learning_snickers_okra_bavaria_manitoba,1212556,1,12,22,34,0
0_2289523,eats_beef_marzipan,2289523,0,0,3,3,0
1_6267138,noop_eats_beef_marzipan,6267138,1,1,1,2,0
0_3933873,province_bavaria,3933873,0,0,1,1,0
1_1640807,noop_province_bavaria,1640807,1,1,1,2,0
0_1486223,pain_angina,1486223,0,0,2,2,0
1_3663839,noop_pain_angina,3663839,1,1,1,2,0
0_7159023,pain_depression,7159023,0,0,4,4,0
1_461749,noop_pain_depression,461749,1,1,1,2,0
0_6905224,attacks_oregon_goias,6905224,0,0,3,3,0
1_4050227,noop_attacks_oregon_goias,4050227,1,1,1,2,0
0_4700324,craves_depression_snickers,4700324,0,0,3,3,0
1_5410840,noop_craves_depression_snickers,5410840,1,2,6,8,0
0_6456524,eats_lamb_beef,6456524,0,0,4,4,0
1_7242962,noop_eats_lamb_beef,7242962,1,1,1,2,0
0_7650924,eats_onion_tofu,7650924,0,0,1,1,0
1_953650,noop_eats_onion_tofu,953650,1,1,1,2,0
0_895075,eats_marzipan_tofu,895075,0,0,1,1,0
1_4872690,noop_eats_marzipan_tofu,4872690,1,1,1,2,0
0_778475,pain_hangover,778475,0,0,4,4,0
1_7594879,noop_pain_hangover,7594879,1,1,1,2,0
0_2114526,locale_ham_bosnia,2114526,0,0,3,3,0
1_7161928,noop_locale_ham_bosnia,7161928,1,1,3,4,0
0_5978126,eats_lamb_haroset,5978126,0,0,4,4,0
1_3024551,noop_eats_lamb_haroset,3024551,1,1,1,2,0
0_1567476,pain_anger,1567476,0,0,2,2,0
1_7076654,noop_pain_anger,7076654,1,1,1,2,0
0_5583426,food_bacon,5583426,0,0,11,11,0
1_3091627,noop_food_bacon,3091627,1,1,1,2,0
0_4281177,eats_okra_wonderbread,4281177,0,0,3,3,0
1_1490852,noop_eats_okra_wonderbread,1490852,1,1,1,2,0
0_2984277,harmony_achievement_saturn,2984277,0,0,2,2,0
1_3694793,noop_harmony_achievement_saturn,3694793,1,2,5,7,0
0_7281678,eats_snickers_wonderbread,7281678,0,0,3,3,0
1_5659255,noop_eats_snickers_wonderbread,5659255,1,1,1,2,0
0_3121428,craves_sciatica_bacon,3121428,0,0,3,3,0
1_331103,noop_craves_sciatica_bacon,331103,1,2,6,8,0
0_677729,eats_tofu_onion,677729,0,0,1,1,0
1_1981432,noop_eats_tofu_onion,1981432,1,1,1,2,0
0_3976229,planet_vulcan,3976229,0,0,8,8,0
1_2791656,noop_planet_vulcan,2791656,1,1,1,2,0
0_5127929,pleasure_learning,5127929,0,0,11,11,0
1_2174354,noop_pleasure_learning,2174354,1,1,1,2,0
0_44280,locale_lemon_manitoba,44280,0,0,4,4,0
1_5254932,noop_locale_lemon_manitoba,5254932,1,4,15,19,0
0_6322230,eats_wonderbread_bacon,6322230,0,0,1,1,0
1_4085983,noop_eats_wonderbread_bacon,4085983,1,1,1,2,0
0_6052830,eats_lobster_bacon,6052830,0,0,4,4,0
1_2029468,noop_eats_lobster_bacon,2029468,1,1,1,2,0
0_473381,eats_ham_flounder,473381,0,0,2,2,0
1_5520783,noop_eats_ham_flounder,5520783,1,1,1,2,0
0_3477531,harmony_entertainment_uranus,3477531,0,0,4,4,0
1_2167967,noop_harmony_entertainment_uranus,2167967,1,2,7,9,0
0_292731,craves_lubricity_lemon,292731,0,0,6,6,0
1_6057461,noop_craves_lubricity_lemon,6057461,1,4,15,19,0
0_6406031,planet_saturn,6406031,0,0,18,18,0
1_5221458,noop_planet_saturn,5221458,1,1,1,2,0
0_5711881,pain_prostatitis,5711881,0,0,1,1,0
1_3418815,noop_pain_prostatitis,3418815,1,1,1,2,0
0_1767281,food_lemon,1767281,0,0,9,9,0
1_7276459,noop_food_lemon,7276459,1,1,1,2,0
0_2286682,eats_marzipan_beef,2286682,0,0,1,1,0
1_6264297,noop_eats_marzipan_beef,6264297,1,1,1,2,0
0_3933582,pain_jealousy,3933582,0,0,5,5,0
1_2749009,noop_pain_jealousy,2749009,1,1,1,2,0
0_7865332,pain_dread,7865332,0,0,6,6,0
1_5373533,noop_pain_dread,5373533,1,1,1,2,0
0_601332,pleasure_achievement,601332,0,0,3,3,0
1_5747312,noop_pleasure_achievement,5747312,1,1,1,2,0
0_1830183,province_goias,1830183,0,0,1,1,0
1_2616621,noop_province_goias,2616621,1,1,1,2,0
0_2922283,pleasure_stimulation,2922283,0,0,13,13,0
1_67286,noop_pleasure_stimulation,67286,1,1,1,2,0
0_2875084,craves_learning_snickers,2875084,0,0,6,6,0
1_2087401,noop_craves_learning_snickers,2087401,1,4,13,17,0
0_4362134,eats_flounder_ham,4362134,0,0,2,2,0
1_1408559,noop_eats_flounder_ham,1408559,1,1,1,2,0
0_2799034,locale_bacon_manitoba,2799034,0,0,5,5,0
1_8709,noop_locale_bacon_manitoba,8709,1,3,12,15,0
0_1742084,eats_haroset_flounder,1742084,0,0,4,4,0
1_6952736,noop_eats_haroset_flounder,6952736,1,1,1,2,0
0_6290134,craves_love_haroset,6290134,0,0,6,6,0
1_434518,noop_craves_love_haroset,434518,1,4,19,23,0
0_222734,craves_jealousy_haroset,222734,0,0,4,4,0
1_3813846,noop_craves_jealousy_haroset,3813846,1,2,7,9,0
0_2380884,food_haroset,2380884,0,0,21,21,0
1_7783167,noop_food_haroset,7783167,1,1,1,2,0
0_1265535,locale_haroset_manitoba,1265535,0,0,10,10,0
1_4856647,noop_locale_haroset_manitoba,4856647,1,4,25,29,0
0_4623385,province_manitoba,4623385,0,0,1,1,0
1_1669810,noop_province_manitoba,1669810,1,1,1,2,0
0_5601736,eats_cantelope_marzipan,5601736,0,0,1,1,0
1_1191871,noop_eats_cantelope_marzipan,1191871,1,1,1,2,0
0_1221736,eats_bacon_lobster,1221736,0,0,3,3,0
1_5199351,noop_eats_bacon_lobster,5199351,1,1,1,2,0
0_511036,eats_wonderbread_okra,511036,0,0,1,1,0
1_5721688,noop_eats_wonderbread_okra,5721688,1,1,1,2,0
0_522536,locale_cantelope_bavaria,522536,0,0,1,1,0
1_7735830,noop_locale_cantelope_bavaria,7735830,1,1,1,2,0
0_1243086,pleasure_entertainment,1243086,0,0,12,12,0
1_7007816,noop_pleasure_entertainment,7007816,1,1,1,2,0
0_3810436,food_onion,3810436,0,0,4,4,0
1_1318637,noop_food_onion,1318637,1,1,1,2,0
0_5991737,eats_marzipan_cantelope,5991737,0,0,1,1,0
1_1581872,noop_eats_marzipan_cantelope,1581872,1,1,1,2,0
0_4944137,harmony_lubricity_earth,4944137,0,0,4,4,0
1_534272,noop_harmony_lubricity_earth,534272,1,2,7,9,0
0_6133837,food_okra,6133837,0,0,10,10,0
1_5342758,noop_food_okra,5342758,1,1,1,2,0
0_6444638,eats_beef_lamb,6444638,0,0,3,3,0
1_7231076,noop_eats_beef_lamb,7231076,1,1,1,2,0
0_7283739,eats_tofu_marzipan,7283739,0,0,1,1,0
1_3260377,noop_eats_tofu_marzipan,3260377,1,1,1,2,0
0_1180739,pain_laceration,1180739,0,0,4,4,0
1_2484442,noop_pain_laceration,2484442,1,1,1,2,0
0_3590140,orbits_uranus_saturn,3590140,0,0,12,12,0
1_735143,noop_orbits_uranus_saturn,735143,1,1,1,2,0
0_5255941,locale_lamb_bosnia,5255941,0,0,5,5,0
1_1232579,noop_locale_lamb_bosnia,1232579,1,3,18,21,0
0_2046441,eats_lemon_ham,2046441,0,0,2,2,0
1_2832879,noop_eats_lemon_ham,2832879,1,1,1,2,0
0_5631791,pain_loneliness,5631791,0,0,1,1,0
1_6935494,noop_pain_loneliness,6935494,1,1,1,2,0
0_1619342,locale_okra_manitoba,1619342,0,0,5,5,0
1_6765322,noop_locale_okra_manitoba,6765322,1,3,13,16,0
0_6616492,eats_lemon_cantelope,6616492,0,0,2,2,0
1_3761495,noop_eats_lemon_cantelope,3761495,1,1,1,2,0
0_3837243,craves_anxiety_onion,3837243,0,0,2,2,0
1_982246,noop_craves_anxiety_onion,982246,1,1,2,3,0
0_2928243,harmony_love_uranus,2928243,0,0,5,5,0
1_5073604,noop_harmony_love_uranus,5073604,1,2,8,10,0
0_3456443,pain_grief,3456443,0,0,5,5,0
1_964644,noop_pain_grief,964644,1,1,1,2,0
0_696593,food_lobster,696593,0,0,16,16,0
1_6098876,noop_food_lobster,6098876,1,1,1,2,0
0_560444,eats_wonderbread_snickers,560444,0,0,1,1,0
1_6938998,noop_eats_wonderbread_snickers,6938998,1,1,1,2,0
0_4022794,attacks_bavaria_manitoba,4022794,0,0,33,33,0
1_3235111,noop_attacks_bavaria_manitoba,3235111,1,1,1,2,0
0_6505494,craves_angina_ham,6505494,0,0,2,2,0
1_3551919,noop_craves_angina_ham,3551919,1,1,2,3,0
0_7434994,eats_lemon_beef,7434994,0,0,2,2,0
1_737720,noop_eats_lemon_beef,737720,1,1,1,2,0
0_7318845,eats_snickers_okra,7318845,0,0,3,3,0
1_3295483,noop_eats_snickers_okra,3295483,1,1,1,2,0
0_1344146,locale_snickers_manitoba,1344146,0,0,7,7,0
1_556463,noop_locale_snickers_manitoba,556463,1,4,16,20,0
0_6870746,locale_marzipan_oregon,6870746,0,0,1,1,0
1_4634499,noop_locale_marzipan_oregon,4634499,1,1,1,2,0
0_2339897,locale_beef_oregon,2339897,0,0,7,7,0
1_6317512,noop_locale_beef_oregon,6317512,1,1,7,8,0
0_6857847,attacks_manitoba_pennsylvania,6857847,0,0,1,1,0
1_7650497,noop_attacks_manitoba_pennsylvania,7650497,1,1,1,2,0
0_6239897,province_bosnia,6239897,0,0,1,1,0
1_7543600,noop_province_bosnia,7543600,1,1,1,2,0
0_1366298,attacks_goias_bosnia,1366298,0,0,7,7,0
1_6512278,noop_attacks_goias_bosnia,6512278,1,1,1,2,0
0_4679598,eats_bacon_wonderbread,4679598,0,0,3,3,0
1_2443351,noop_eats_bacon_wonderbread,2443351,1,1,1,2,0
0_1013998,pleasure_aesthetics,1013998,0,0,9,9,0
1_3159359,noop_pleasure_aesthetics,3159359,1,1,1,2,0
0_6440549,pleasure_lubricity,6440549,0,0,13,13,0
1_2417187,noop_pleasure_lubricity,2417187,1,1,1,2,0
0_7543600,noop_province_bosnia,7543600,0,0,1,1,0
1_6239897,province_bosnia,6239897,1,1,1,2,0
0_953650,noop_eats_onion_tofu,953650,0,0,1,1,0
1_7650924,eats_onion_tofu,7650924,1,1,1,2,0
0_5112850,feast_love_haroset_lamb_bavaria_manitoba,5112850,0,0,7,7,0
1_7733722,locale_haroset_bavaria,7733722,1,3,5,8,0
1_3553209,craves_love_lamb,3553209,1,1,8,9,0
1_6290134,craves_love_haroset,6290134,1,3,10,13,0
1_1265535,locale_haroset_manitoba,1265535,1,3,17,20,0
0_5592600,overcome_sciatica_aesthetics_bacon_saturn_earth,5592600,0,0,6,6,0
1_2814490,harmony_aesthetics_saturn,2814490,1,1,14,15,0
1_5951675,fears_sciatica_aesthetics,5951675,1,1,7,8,0
1_3121428,craves_sciatica_bacon,3121428,1,1,7,8,0
1_6305720,harmony_aesthetics_earth,6305720,1,1,5,6,0
0_2443351,noop_eats_bacon_wonderbread,2443351,0,0,1,1,0
1_4679598,eats_bacon_wonderbread,4679598,1,1,4,5,0
0_5199351,noop_eats_bacon_lobster,5199351,0,0,1,1,0
1_1221736,eats_bacon_lobster,1221736,1,1,4,5,0
0_2087401,noop_craves_learning_snickers,2087401,0,0,4,4,0
1_2875084,craves_learning_snickers,2875084,1,4,11,15,0
0_3024551,noop_eats_lamb_haroset,3024551,0,0,1,1,0
1_5978126,eats_lamb_haroset,5978126,1,1,11,12,0
0_6261001,noop_craves_laceration_lamb,6261001,0,0,2,2,0
1_496271,craves_laceration_lamb,496271,1,2,8,10,0
0_5457751,feast_lubricity_lemon_cantelope_bavaria_manitoba,5457751,0,0,7,7,0
1_6447545,locale_lemon_bavaria,6447545,1,3,5,8,0
1_6631441,craves_lubricity_cantelope,6631441,1,1,6,7,0
1_292731,craves_lubricity_lemon,292731,1,3,11,14,0
1_44280,locale_lemon_manitoba,44280,1,3,11,14,0
0_1490852,noop_eats_okra_wonderbread,1490852,0,0,1,1,0
1_4281177,eats_okra_wonderbread,4281177,1,1,3,4,0
0_331103,noop_craves_sciatica_bacon,331103,0,0,2,2,0
0_191203,noop_locale_tofu_manitoba,191203,0,0,1,1,0
1_3046200,locale_tofu_manitoba,3046200,1,1,1,2,0
0_394853,feast_aesthetics_bacon_wonderbread_bavaria_manitoba,394853,0,0,6,6,0
1_5395676,locale_bacon_bavaria,5395676,1,2,3,5,0
1_658980,craves_aesthetics_wonderbread,658980,1,1,10,11,0
1_4244617,craves_aesthetics_bacon,4244617,1,2,6,8,0
1_2799034,locale_bacon_manitoba,2799034,1,2,10,12,0
0_5073604,noop_harmony_love_uranus,5073604,0,0,2,2,0
1_2928243,harmony_love_uranus,2928243,1,2,10,12,0
0_2174354,noop_pleasure_learning,2174354,0,0,1,1,0
1_5127929,pleasure_learning,5127929,1,1,21,22,0
0_7076654,noop_pain_anger,7076654,0,0,1,1,0
1_1567476,pain_anger,1567476,1,1,6,7,0
0_1108354,noop_craves_loneliness_tofu,1108354,0,0,1,1,0
1_3344601,craves_loneliness_tofu,3344601,1,1,1,2,0
0_4708754,noop_eats_cantelope_lemon,4708754,0,0,1,1,0
1_7563751,eats_cantelope_lemon,7563751,1,1,1,2,0
0_7467054,feast_entertainment_lobster_bacon_bavaria_manitoba,7467054,0,0,6,6,0
1_5244493,locale_lobster_bavaria,5244493,1,2,5,7,0
1_132955,craves_entertainment_bacon,132955,1,1,7,8,0
1_2247302,craves_entertainment_lobster,2247302,1,2,5,7,0
1_4101071,locale_lobster_manitoba,4101071,1,2,12,14,0
0_5659255,noop_eats_snickers_wonderbread,5659255,0,0,1,1,0
1_7281678,eats_snickers_wonderbread,7281678,1,1,3,4,0
0_6034255,noop_eats_beef_lemon,6034255,0,0,1,1,0
1_4730552,eats_beef_lemon,4730552,1,1,7,8,0
0_6902405,feast_stimulation_lamb_haroset_goias_bosnia,6902405,0,0,6,6,0
1_4451660,locale_lamb_goias,4451660,1,2,11,13,0
1_7695533,craves_stimulation_haroset,7695533,1,1,13,14,0
1_5586764,craves_stimulation_lamb,5586764,1,2,13,15,0
1_5255941,locale_lamb_bosnia,5255941,1,2,12,14,0
0_2791656,noop_planet_vulcan,2791656,0,0,1,1,0
1_3976229,planet_vulcan,3976229,1,1,21,22,0
0_2475306,noop_craves_expectation_okra,2475306,0,0,3,3,0
1_6885171,craves_expectation_okra,6885171,1,3,7,10,0
0_1212556,feast_learning_snickers_okra_bavaria_manitoba,1212556,0,0,8,8,0
1_2639657,locale_snickers_bavaria,2639657,1,3,5,8,0
1_2404175,craves_learning_okra,2404175,1,1,13,14,0
1_1344146,locale_snickers_manitoba,1344146,1,3,11,14,0
0_1640807,noop_province_bavaria,1640807,0,0,1,1,0
1_3933873,province_bavaria,3933873,1,1,1,2,0
0_4964407,noop_food_cantelope,4964407,0,0,1,1,0
1_4177969,food_cantelope,4177969,1,1,6,7,0
0_5342758,noop_food_okra,5342758,0,0,1,1,0
1_6133837,food_okra,6133837,1,1,14,15,0
0_5221458,noop_planet_saturn,5221458,0,0,1,1,0
1_6406031,planet_saturn,6406031,1,1,36,37,0
0_5347858,feast_entertainment_lobster_haroset_bavaria_manitoba,5347858,0,0,8,8,0
1_3931593,craves_entertainment_haroset,3931593,1,1,12,13,0
0_1277058,overcome_laceration_stimulation_lamb_saturn_earth,1277058,0,0,7,7,0
1_218314,harmony_stimulation_saturn,218314,1,1,14,15,0
1_2883160,fears_laceration_stimulation,2883160,1,1,4,5,0
1_794907,harmony_stimulation_earth,794907,1,1,8,9,0
0_3159359,noop_pleasure_aesthetics,3159359,0,0,1,1,0
1_1013998,pleasure_aesthetics,1013998,1,1,20,21,0
0_8709,noop_locale_bacon_manitoba,8709,0,0,3,3,0
0_1408559,noop_eats_flounder_ham,1408559,0,0,1,1,0
1_4362134,eats_flounder_ham,4362134,1,1,6,7,0
0_2749009,noop_pain_jealousy,2749009,0,0,1,1,0
1_3933582,pain_jealousy,3933582,1,1,12,13,0
0_7276459,noop_food_lemon,7276459,0,0,1,1,0
1_1767281,food_lemon,1767281,1,1,20,21,0
0_1323959,noop_province_oregon,1323959,0,0,1,1,0
1_20256,province_oregon,20256,1,1,1,2,0
0_1669810,noop_province_manitoba,1669810,0,0,1,1,0
1_4623385,province_manitoba,4623385,1,1,1,2,0
0_3235111,noop_attacks_bavaria_manitoba,3235111,0,0,1,1,0
1_4022794,attacks_bavaria_manitoba,4022794,1,1,43,44,0
0_6057461,noop_craves_lubricity_lemon,6057461,0,0,4,4,0
0_7173461,noop_harmony_stimulation_earth,7173461,0,0,2,2,0
0_6317512,noop_locale_beef_oregon,6317512,0,0,1,1,0
1_2339897,locale_beef_oregon,2339897,1,1,10,11,0
0_5747312,noop_pleasure_achievement,5747312,0,0,1,1,0
1_601332,pleasure_achievement,601332,1,1,3,4,0
0_7242962,noop_eats_lamb_beef,7242962,0,0,1,1,0
1_6456524,eats_lamb_beef,6456524,1,1,11,12,0
0_5861162,noop_orbits_saturn_earth,5861162,0,0,1,1,0
1_3715801,orbits_saturn_earth,3715801,1,1,34,35,0
0_556463,noop_locale_snickers_manitoba,556463,0,0,4,4,0
0_1760814,noop_locale_onion_bavaria,1760814,0,0,1,1,0
1_4615811,locale_onion_bavaria,4615811,1,1,1,2,0
0_3418815,noop_pain_prostatitis,3418815,0,0,1,1,0
1_5711881,pain_prostatitis,5711881,1,1,3,4,0
0_4565515,noop_orbits_vulcan_uranus,4565515,0,0,1,1,0
1_7420512,orbits_vulcan_uranus,7420512,1,1,33,34,0
0_7135015,feast_love_haroset_lobster_bavaria_manitoba,7135015,0,0,9,9,0
1_4605843,craves_love_lobster,4605843,1,1,12,13,0
0_2696465,overcome_depression_learning_snickers_uranus_saturn,2696465,0,0,7,7,0
1_2297701,harmony_learning_uranus,2297701,1,1,12,13,0
1_7517629,fears_depression_learning,7517629,1,1,11,12,0
1_4700324,craves_depression_snickers,4700324,1,1,7,8,0
1_1222810,harmony_learning_saturn,1222810,1,1,7,8,0
0_2432615,overcome_grief_entertainment_lobster_vulcan_uranus,2432615,0,0,6,6,0
1_7973815,harmony_entertainment_vulcan,7973815,1,1,11,12,0
1_5021913,fears_grief_entertainment,5021913,1,1,7,8,0
1_5474563,craves_grief_lobster,5474563,1,1,8,9,0
1_3477531,harmony_entertainment_uranus,3477531,1,1,9,10,0
0_7007816,noop_pleasure_entertainment,7007816,0,0,1,1,0
1_1243086,pleasure_entertainment,1243086,1,1,25,26,0
0_2619566,noop_craves_grief_lobster,2619566,0,0,2,2,0
0_5107816,feast_learning_snickers_wonderbread_bavaria_manitoba,5107816,0,0,9,9,0
1_2138506,craves_learning_wonderbread,2138506,1,1,7,8,0
0_7783167,noop_food_haroset,7783167,0,0,1,1,0
1_2380884,food_haroset,2380884,1,1,42,43,0
0_2167967,noop_harmony_entertainment_uranus,2167967,0,0,2,2,0
0_434518,noop_craves_love_haroset,434518,0,0,4,4,0
0_2029468,noop_eats_lobster_bacon,2029468,0,0,1,1,0
1_6052830,eats_lobster_bacon,6052830,1,1,5,6,0
0_3551919,noop_craves_angina_ham,3551919,0,0,1,1,0
1_6505494,craves_angina_ham,6505494,1,1,4,5,0
0_5280719,noop_eats_snickers_onion,5280719,0,0,1,1,0
1_3135358,eats_snickers_onion,3135358,1,1,3,4,0
0_737720,noop_eats_lemon_beef,737720,0,0,1,1,0
1_7434994,eats_lemon_beef,7434994,1,1,3,4,0
0_4775970,noop_locale_flounder_oregon,4775970,0,0,1,1,0
1_7012217,locale_flounder_oregon,7012217,1,1,9,10,0
0_564420,noop_planet_earth,564420,0,0,1,1,0
1_3163114,planet_earth,3163114,1,1,18,19,0
0_2601920,noop_harmony_expectation_saturn,2601920,0,0,2,2,0
1_1891404,harmony_expectation_saturn,1891404,1,2,7,9,0
0_4951120,overcome_jealousy_love_haroset_vulcan_uranus,4951120,0,0,8,8,0
1_7424527,harmony_love_vulcan,7424527,1,1,10,11,0
1_4484680,fears_jealousy_love,4484680,1,1,11,12,0
1_222734,craves_jealousy_haroset,222734,1,1,8,9,0
0_1191871,noop_eats_cantelope_marzipan,1191871,0,0,1,1,0
1_5601736,eats_cantelope_marzipan,5601736,1,1,1,2,0
0_2616621,noop_province_goias,2616621,0,0,1,1,0
1_1830183,province_goias,1830183,1,1,1,2,0
0_6765322,noop_locale_okra_manitoba,6765322,0,0,3,3,0
1_1619342,locale_okra_manitoba,1619342,1,3,8,11,0
0_534272,noop_harmony_lubricity_earth,534272,0,0,2,2,0
1_4944137,harmony_lubricity_earth,4944137,1,2,9,11,0
0_1581872,noop_eats_marzipan_cantelope,1581872,0,0,1,1,0
1_5991737,eats_marzipan_cantelope,5991737,1,1,3,4,0
0_4813922,noop_harmony_learning_saturn,4813922,0,0,2,2,0
0_7476923,feast_aesthetics_bacon_lobster_bavaria_manitoba,7476923,0,0,8,8,0
1_7224728,craves_aesthetics_lobster,7224728,1,1,12,13,0
0_6837474,noop_province_pennsylvania,6837474,0,0,1,1,0
1_1626822,province_pennsylvania,1626822,1,1,1,2,0
0_6098876,noop_food_lobster,6098876,0,0,1,1,0
1_696593,food_lobster,696593,1,1,26,27,0
0_7231076,noop_eats_beef_lamb,7231076,0,0,1,1,0
1_6444638,eats_beef_lamb,6444638,1,1,7,8,0
0_7165176,noop_craves_dread_wonderbread,7165176,0,0,2,2,0
1_7952859,craves_dread_wonderbread,7952859,1,2,9,11,0
0_3260377,noop_eats_tofu_marzipan,3260377,0,0,1,1,0
1_7283739,eats_tofu_marzipan,7283739,1,1,1,2,0
0_3091627,noop_food_bacon,3091627,0,0,1,1,0
1_5583426,food_bacon,5583426,1,1,18,19,0
0_4050227,noop_attacks_oregon_goias,4050227,0,0,1,1,0
1_6905224,attacks_oregon_goias,6905224,1,1,11,12,0
0_1616227,noop_eats_haroset_lamb,1616227,0,0,1,1,0
1_4569802,eats_haroset_lamb,4569802,1,1,5,6,0
0_6512278,noop_attacks_goias_bosnia,6512278,0,0,1,1,0
1_1366298,attacks_goias_bosnia,1366298,1,1,13,14,0
0_7161928,noop_locale_ham_bosnia,7161928,0,0,1,1,0
1_2114526,locale_ham_bosnia,2114526,1,1,5,6,0
0_4671628,noop_craves_anger_flounder,4671628,0,0,1,1,0
1_7461953,craves_anger_flounder,7461953,1,1,5,6,0
0_6427428,noop_pain_boils,6427428,0,0,1,1,0
1_918250,pain_boils,918250,1,1,8,9,0
0_2832879,noop_eats_lemon_ham,2832879,0,0,1,1,0
1_2046441,eats_lemon_ham,2046441,1,1,3,4,0
0_1232579,noop_locale_lamb_bosnia,1232579,0,0,3,3,0
0_7594879,noop_pain_hangover,7594879,0,0,1,1,0
1_778475,pain_hangover,778475,1,1,9,10,0
0_7547979,noop_food_wonderbread,7547979,0,0,1,1,0
1_1840068,food_wonderbread,1840068,1,1,25,26,0
0_7835729,noop_craves_aesthetics_bacon,7835729,0,0,3,3,0
0_7735830,noop_locale_cantelope_bavaria,7735830,0,0,1,1,0
1_522536,locale_cantelope_bavaria,522536,1,1,1,2,0
0_1016330,noop_pleasure_love,1016330,0,0,1,1,0
1_2200903,pleasure_love,2200903,1,1,38,39,0
0_2516280,noop_eats_wonderbread_marzipan,2516280,0,0,1,1,0
1_4138703,eats_wonderbread_marzipan,4138703,1,1,1,2,0
0_7299431,noop_locale_wonderbread_bavaria,7299431,0,0,1,1,0
1_6588915,locale_wonderbread_bavaria,6588915,1,1,1,2,0
0_2227981,noop_food_marzipan,2227981,0,0,1,1,0
1_3412554,food_marzipan,3412554,1,1,17,18,0
0_4802981,noop_eats_marzipan_wonderbread,4802981,0,0,1,1,0
1_6425404,eats_marzipan_wonderbread,6425404,1,1,3,4,0
0_7435781,noop_eats_haroset_lobster,7435781,0,0,1,1,0
1_2289801,eats_haroset_lobster,2289801,1,1,5,6,0
0_5254932,noop_locale_lemon_manitoba,5254932,0,0,4,4,0
0_1981432,noop_eats_tofu_onion,1981432,0,0,1,1,0
1_677729,eats_tofu_onion,677729,1,1,1,2,0
0_3295483,noop_eats_snickers_okra,3295483,0,0,1,1,0
1_7318845,eats_snickers_okra,7318845,1,1,3,4,0
0_5373533,noop_pain_dread,5373533,0,0,1,1,0
1_7865332,pain_dread,7865332,1,1,13,14,0
0_5520783,noop_eats_ham_flounder,5520783,0,0,1,1,0
1_473381,eats_ham_flounder,473381,1,1,4,5,0
0_4085983,noop_eats_wonderbread_bacon,4085983,0,0,1,1,0
1_6322230,eats_wonderbread_bacon,6322230,1,1,1,2,0
0_7692183,noop_locale_lobster_manitoba,7692183,0,0,3,3,0
0_1477183,noop_food_tofu,1477183,0,0,1,1,0
1_2268262,food_tofu,2268262,1,1,3,4,0
0_2360333,noop_food_lamb,2360333,0,0,1,1,0
1_3151412,food_lamb,3151412,1,1,39,40,0
0_5170983,feast_stimulation_lamb_beef_goias_bosnia,5170983,0,0,8,8,0
1_6095221,craves_stimulation_beef,6095221,1,1,16,17,0
0_3958185,noop_attacks_pennsylvania_oregon,3958185,0,0,1,1,0
1_6088560,attacks_pennsylvania_oregon,6088560,1,1,30,31,0
0_6952736,noop_eats_haroset_flounder,6952736,0,0,1,1,0
1_1742084,eats_haroset_flounder,1742084,1,1,5,6,0
0_67286,noop_pleasure_stimulation,67286,0,0,1,1,0
1_2922283,pleasure_stimulation,2922283,1,1,42,43,0
0_3800886,noop_pain_sciatica,3800886,0,0,1,1,0
1_4985459,pain_sciatica,4985459,1,1,9,10,0
0_4306136,overcome_hangover_expectation_okra_uranus_saturn,4306136,0,0,7,7,0
1_2966295,harmony_expectation_uranus,2966295,1,1,14,15,0
1_478591,fears_hangover_expectation,478591,1,1,7,8,0
1_2633557,craves_hangover_okra,2633557,1,1,7,8,0
0_2417187,noop_pleasure_lubricity,2417187,0,0,1,1,0
1_6440549,pleasure_lubricity,6440549,1,1,41,42,0
0_1318637,noop_food_onion,1318637,0,0,1,1,0
1_3810436,food_onion,3810436,1,1,8,9,0
0_6256237,noop_eats_okra_snickers,6256237,0,0,1,1,0
1_2278622,eats_okra_snickers,2278622,1,1,3,4,0
0_5518037,noop_harmony_aesthetics_earth,5518037,0,0,2,2,0
0_7969387,noop_craves_achievement_wonderbread,7969387,0,0,1,1,0
1_5075412,craves_achievement_wonderbread,5075412,1,1,3,4,0
0_7779537,noop_craves_hangover_okra,7779537,0,0,2,2,0
0_5715987,overcome_boils_lubricity_lemon_saturn_earth,5715987,0,0,8,8,0
1_6292230,harmony_lubricity_saturn,6292230,1,1,16,17,0
1_5022204,fears_boils_lubricity,5022204,1,1,5,6,0
1_4536909,craves_boils_lemon,4536909,1,1,4,5,0
0_5721688,noop_eats_wonderbread_okra,5721688,0,0,1,1,0
1_511036,eats_wonderbread_okra,511036,1,1,1,2,0
0_6267138,noop_eats_beef_marzipan,6267138,0,0,1,1,0
1_2289523,eats_beef_marzipan,2289523,1,1,7,8,0
0_937738,noop_craves_entertainment_lobster,937738,0,0,3,3,0
0_3663839,noop_pain_angina,3663839,0,0,1,1,0
1_1486223,pain_angina,1486223,1,1,5,6,0
0_1903589,noop_food_ham,1903589,0,0,1,1,0
1_6188452,food_ham,6188452,1,1,19,20,0
0_923989,noop_eats_ham_lemon,923989,0,0,1,1,0
1_137551,eats_ham_lemon,137551,1,1,4,5,0
0_4872690,noop_eats_marzipan_tofu,4872690,0,0,1,1,0
1_895075,eats_marzipan_tofu,895075,1,1,3,4,0
0_5410840,noop_craves_depression_snickers,5410840,0,0,2,2,0
0_2868790,noop_food_beef,2868790,0,0,1,1,0
1_3659869,food_beef,3659869,1,1,42,43,0
0_746090,noop_food_flounder,746090,0,0,1,1,0
1_1930663,food_flounder,1930663,1,1,24,25,0
0_778640,noop_eats_onion_snickers,778640,0,0,1,1,0
1_6634256,eats_onion_snickers,6634256,1,1,1,2,0
0_2330190,feast_lubricity_lemon_beef_bavaria_manitoba,2330190,0,0,9,9,0
1_4341693,craves_lubricity_beef,4341693,1,1,17,18,0
0_6949341,noop_craves_abrasion_beef,6949341,0,0,1,1,0
1_1803361,craves_abrasion_beef,1803361,1,1,6,7,0
0_1923741,feast_expectation_okra_snickers_bavaria_manitoba,1923741,0,0,8,8,0
1_765503,locale_okra_bavaria,765503,1,2,1,3,0
1_2455781,craves_expectation_snickers,2455781,1,1,13,14,0
0_2466891,feast_learning_snickers_onion_bavaria_manitoba,2466891,0,0,9,9,0
1_1133227,craves_learning_onion,1133227,1,1,11,12,0
0_2484442,noop_pain_laceration,2484442,0,0,1,1,0
1_1180739,pain_laceration,1180739,1,1,10,11,0
0_735143,noop_orbits_uranus_saturn,735143,0,0,1,1,0
1_3590140,orbits_uranus_saturn,3590140,1,1,32,33,0
0_3694793,noop_harmony_achievement_saturn,3694793,0,0,2,2,0
1_2984277,harmony_achievement_saturn,2984277,1,2,4,6,0
0_918343,noop_craves_prostatitis_marzipan,918343,0,0,1,1,0
1_3048718,craves_prostatitis_marzipan,3048718,1,1,3,4,0
0_6630843,noop_eats_lobster_haroset,6630843,0,0,1,1,0
1_1484863,eats_lobster_haroset,1484863,1,1,5,6,0
0_6772543,noop_pain_anxiety,6772543,0,0,1,1,0
1_1370260,pain_anxiety,1370260,1,1,5,6,0
0_4648643,overcome_dread_achievement_wonderbread_uranus_saturn,4648643,0,0,6,6,0
1_4059168,harmony_achievement_uranus,4059168,1,1,4,5,0
1_7129906,fears_dread_achievement,7129906,1,1,2,3,0
0_964644,noop_pain_grief,964644,0,0,1,1,0
1_3456443,pain_grief,3456443,1,1,11,12,0
0_6935494,noop_pain_loneliness,6935494,0,0,1,1,0
1_5631791,pain_loneliness,5631791,1,1,1,2,0
0_3761495,noop_eats_lemon_cantelope,3761495,0,0,1,1,0
1_6616492,eats_lemon_cantelope,6616492,1,1,3,4,0
0_2098945,noop_eats_flounder_haroset,2098945,0,0,1,1,0
1_4889270,eats_flounder_haroset,4889270,1,1,6,7,0
0_2186495,feast_expectation_okra_wonderbread_bavaria_manitoba,2186495,0,0,8,8,0
1_4150653,craves_expectation_wonderbread,4150653,1,1,9,10,0
0_982246,noop_craves_anxiety_onion,982246,0,0,1,1,0
1_3837243,craves_anxiety_onion,3837243,1,1,4,5,0
0_3813846,noop_craves_jealousy_haroset,3813846,0,0,2,2,0
0_7650497,noop_attacks_manitoba_pennsylvania,7650497,0,0,1,1,0
1_6857847,attacks_manitoba_pennsylvania,6857847,1,1,12,13,0
0_4856647,noop_locale_haroset_manitoba,4856647,0,0,4,4,0
0_6264297,noop_eats_marzipan_beef,6264297,0,0,1,1,0
1_2286682,eats_marzipan_beef,2286682,1,1,3,4,0
0_6628497,noop_pain_abrasion,6628497,0,0,1,1,0
1_7813070,pain_abrasion,7813070,1,1,8,9,0
0_513547,noop_craves_boils_lemon,513547,0,0,2,2,0
0_6955647,feast_lubricity_lemon_ham_bavaria_manitoba,6955647,0,0,9,9,0
1_3190749,craves_lubricity_ham,3190749,1,1,13,14,0
0_6938998,noop_eats_wonderbread_snickers,6938998,0,0,1,1,0
1_560444,eats_wonderbread_snickers,560444,1,1,1,2,0
0_7307348,noop_pleasure_expectation,7307348,0,0,1,1,0
1_2161368,pleasure_expectation,2161368,1,1,18,19,0
0_4634499,noop_locale_marzipan_oregon,4634499,0,0,1,1,0
1_6870746,locale_marzipan_oregon,6870746,1,1,9,10,0
0_461749,noop_pain_depression,461749,0,0,1,1,0
1_7159023,pain_depression,7159023,1,1,10,11,0
0_6650699,noop_food_snickers,6650699,0,0,1,1,0
1_7835272,food_snickers,7835272,1,1,16,17,0
0_6296349,noop_planet_uranus,6296349,0,0,1,1,0
1_7480922,planet_uranus,7480922,1,1,39,40,0
0_1176899,noop_craves_stimulation_lamb,1176899,0,0,3,3,0
0_328749,feast_love_haroset_flounder_bavaria_manitoba,328749,0,0,9,9,0
1_2576538,craves_love_flounder,2576538,1,1,12,13,0
2_6427428,noop_pain_boils,6427428,2,1,1,2,0
2_5087272,succumb_boils_lubricity_lemon_saturn_earth,5087272,2,26,59,85,0
2_5715987,overcome_boils_lubricity_lemon_saturn_earth,5715987,2,28,56,84,0
2_191203,noop_locale_tofu_manitoba,191203,2,1,1,2,0
2_5888813,noop_harmony_learning_uranus,5888813,2,15,17,32,0
2_2660153,succumb_depression_learning_snickers_uranus_saturn,2660153,2,25,37,62,0
2_1133227,craves_learning_onion,1133227,2,7,15,22,0
2_2404175,craves_learning_okra,2404175,2,9,16,25,0
2_4700324,craves_depression_snickers,4700324,2,5,7,12,0
2_1222810,harmony_learning_saturn,1222810,2,7,14,21,0
2_2639657,locale_snickers_bavaria,2639657,2,10,2,12,0
2_2138506,craves_learning_wonderbread,2138506,2,8,15,23,0
2_1108354,noop_craves_loneliness_tofu,1108354,2,1,1,2,0
2_4708754,noop_eats_cantelope_lemon,4708754,2,1,1,2,0
2_923989,noop_eats_ham_lemon,923989,2,1,1,2,0
2_5596192,feast_lubricity_ham_lemon_goias_bosnia,5596192,2,26,61,87,0
2_7435781,noop_eats_haroset_lobster,7435781,2,1,1,2,0
2_7068455,feast_stimulation_haroset_lobster_bavaria_manitoba,7068455,2,46,123,169,0
2_7135015,feast_love_haroset_lobster_bavaria_manitoba,7135015,2,34,87,121,0
2_5442106,feast_entertainment_haroset_lobster_bavaria_manitoba,5442106,2,47,107,154,0
2_5861162,noop_orbits_saturn_earth,5861162,2,1,1,2,0
2_6725965,succumb_laceration_stimulation_lamb_saturn_earth,6725965,2,28,64,92,0
2_1221666,succumb_sciatica_aesthetics_bacon_saturn_earth,1221666,2,22,35,57,0
2_5592600,overcome_sciatica_aesthetics_bacon_saturn_earth,5592600,2,24,35,59,0
2_4424872,overcome_abrasion_stimulation_beef_saturn_earth,4424872,2,30,68,98,0
2_4910584,overcome_abrasion_lubricity_beef_saturn_earth,4910584,2,29,67,96,0
2_1843106,overcome_angina_lubricity_ham_saturn_earth,1843106,2,28,63,91,0
2_6282974,overcome_dread_aesthetics_wonderbread_saturn_earth,6282974,2,31,50,81,0
2_6139003,overcome_jealousy_stimulation_haroset_saturn_earth,6139003,2,34,73,107,0
2_1277058,overcome_laceration_stimulation_lamb_saturn_earth,1277058,2,30,61,91,0
2_168939,overcome_grief_aesthetics_lobster_saturn_earth,168939,2,30,47,77,0
2_1903589,noop_food_ham,1903589,2,1,1,2,0
2_6955647,feast_lubricity_lemon_ham_bavaria_manitoba,6955647,2,24,60,84,0
2_4770690,feast_love_flounder_ham_pennsylvania_oregon,4770690,2,36,88,124,0
2_7859946,feast_lubricity_ham_flounder_goias_bosnia,7859946,2,26,61,87,0
2_6034255,noop_eats_beef_lemon,6034255,2,1,1,2,0
2_152103,feast_stimulation_beef_lemon_pennsylvania_oregon,152103,2,30,85,115,0
2_2384133,feast_lubricity_beef_lemon_pennsylvania_oregon,2384133,2,29,80,109,0
2_1616227,noop_eats_haroset_lamb,1616227,2,1,1,2,0
2_3042773,feast_stimulation_haroset_lamb_bavaria_manitoba,3042773,2,46,123,169,0
2_5112850,feast_love_haroset_lamb_bavaria_manitoba,5112850,2,34,87,121,0
2_718803,feast_entertainment_haroset_lamb_bavaria_manitoba,718803,2,47,107,154,0
2_937738,noop_craves_entertainment_lobster,937738,2,13,30,43,0
2_5182809,succumb_grief_entertainment_lobster_vulcan_uranus,5182809,2,26,46,72,0
2_5347858,feast_entertainment_lobster_haroset_bavaria_manitoba,5347858,2,26,52,78,0
2_7467054,feast_entertainment_lobster_bacon_bavaria_manitoba,7467054,2,26,52,78,0
2_2432615,overcome_grief_entertainment_lobster_vulcan_uranus,2432615,2,28,46,74,0
2_5244493,locale_lobster_bavaria,5244493,2,10,2,12,0
2_3931593,craves_entertainment_haroset,3931593,2,9,18,27,0
2_132955,craves_entertainment_bacon,132955,2,8,14,22,0
2_2910864,noop_locale_okra_bavaria,2910864,2,11,6,17,0
2_2966295,harmony_expectation_uranus,2966295,2,9,20,29,0
2_1619342,locale_okra_manitoba,1619342,2,7,10,17,0
2_478591,fears_hangover_expectation,478591,2,7,14,21,0
2_6885171,craves_expectation_okra,6885171,2,6,16,22,0
2_7044628,noop_craves_expectation_wonderbread,7044628,2,16,21,37,0
2_3164387,overcome_dread_expectation_wonderbread_uranus_saturn,3164387,2,32,45,77,0
2_2455781,craves_expectation_snickers,2455781,2,9,16,25,0
2_1016330,noop_pleasure_love,1016330,2,1,1,2,0
2_4019620,succumb_jealousy_love_haroset_vulcan_uranus,4019620,2,32,69,101,0
2_5016585,feast_love_lamb_beef_oregon_goias,5016585,2,44,95,139,0
2_7478636,feast_love_lamb_beef_goias_bosnia,7478636,2,46,124,170,0
2_5661286,feast_love_lamb_haroset_oregon_goias,5661286,2,44,95,139,0
2_122360,feast_love_lamb_haroset_goias_bosnia,122360,2,46,124,170,0
2_328749,feast_love_haroset_flounder_bavaria_manitoba,328749,2,34,87,121,0
2_6749570,feast_love_flounder_haroset_pennsylvania_oregon,6749570,2,36,88,124,0
2_7040767,feast_love_lobster_haroset_bavaria_manitoba,7040767,2,47,107,154,0
2_4205329,feast_love_lobster_bacon_bavaria_manitoba,4205329,2,47,107,154,0
2_2734050,overcome_anger_love_flounder_vulcan_uranus,2734050,2,38,90,128,0
2_4951120,overcome_jealousy_love_haroset_vulcan_uranus,4951120,2,34,61,95,0
2_139886,overcome_laceration_love_lamb_vulcan_uranus,139886,2,42,96,138,0
2_5842625,overcome_grief_love_lobster_vulcan_uranus,5842625,2,43,98,141,0
2_2516280,noop_eats_wonderbread_marzipan,2516280,2,1,1,2,0
2_4671628,noop_craves_anger_flounder,4671628,2,2,7,9,0
2_2231879,noop_fears_boils_lubricity,2231879,2,16,39,55,0
2_3190749,craves_lubricity_ham,3190749,2,9,24,33,0
2_6447545,locale_lemon_bavaria,6447545,2,7,2,9,0
2_4341693,craves_lubricity_beef,4341693,2,10,30,40,0
2_6631441,craves_lubricity_cantelope,6631441,2,7,13,20,0
2_4944137,harmony_lubricity_earth,4944137,2,6,25,31,0
2_4536909,craves_boils_lemon,4536909,2,4,8,12,0
2_2227981,noop_food_marzipan,2227981,2,1,1,2,0
2_6501770,feast_stimulation_beef_marzipan_pennsylvania_oregon,6501770,2,30,85,115,0
2_3242955,feast_lubricity_beef_marzipan_pennsylvania_oregon,3242955,2,29,80,109,0
2_2601920,noop_harmony_expectation_saturn,2601920,2,7,17,24,0
2_5868596,overcome_depression_expectation_snickers_uranus_saturn,5868596,2,30,39,69,0
2_4306136,overcome_hangover_expectation_okra_uranus_saturn,4306136,2,25,33,58,0
2_4802981,noop_eats_marzipan_wonderbread,4802981,2,1,1,2,0
2_843471,noop_craves_entertainment_bacon,843471,2,20,44,64,0
2_4744463,feast_entertainment_bacon_lobster_bavaria_manitoba,4744463,2,35,66,101,0
2_5546013,feast_entertainment_bacon_wonderbread_bavaria_manitoba,5546013,2,35,66,101,0
2_3736378,overcome_sciatica_entertainment_bacon_vulcan_uranus,3736378,2,34,60,94,0
2_4101071,locale_lobster_manitoba,4101071,2,9,18,27,0
2_7973815,harmony_entertainment_vulcan,7973815,2,9,21,30,0
2_5021913,fears_grief_entertainment,5021913,2,7,15,22,0
2_2247302,craves_entertainment_lobster,2247302,2,7,9,16,0
2_8131,noop_craves_learning_wonderbread,8131,2,19,28,47,0
2_5285237,overcome_dread_learning_wonderbread_uranus_saturn,5285237,2,35,52,87,0
2_1344146,locale_snickers_manitoba,1344146,2,10,14,24,0
2_2875084,craves_learning_snickers,2875084,2,8,18,26,0
2_7517629,fears_depression_learning,7517629,2,8,15,23,0
2_2297701,harmony_learning_uranus,2297701,2,11,17,28,0
2_2720041,noop_fears_dread_achievement,2720041,2,8,18,26,0
2_3353748,succumb_dread_achievement_wonderbread_uranus_saturn,3353748,2,15,22,37,0
2_2984277,harmony_achievement_saturn,2984277,2,4,7,11,0
2_7952859,craves_dread_wonderbread,7952859,2,7,16,23,0
2_1323959,noop_province_oregon,1323959,2,1,1,2,0
2_778640,noop_eats_onion_snickers,778640,2,1,1,2,0
2_6230769,noop_locale_snickers_bavaria,6230769,2,13,8,21,0
2_7173461,noop_harmony_stimulation_earth,7173461,2,7,20,27,0
2_218314,harmony_stimulation_saturn,218314,2,9,36,45,0
2_2883160,fears_laceration_stimulation,2883160,2,7,20,27,0
2_7779537,noop_craves_hangover_okra,7779537,2,6,11,17,0
2_118053,overcome_hangover_learning_okra_uranus_saturn,118053,2,33,45,78,0
2_5280719,noop_eats_snickers_onion,5280719,2,1,1,2,0
2_6245149,feast_expectation_snickers_onion_bavaria_manitoba,6245149,2,34,51,85,0
2_2466891,feast_learning_snickers_onion_bavaria_manitoba,2466891,2,25,37,62,0
2_1260143,noop_craves_love_lamb,1260143,2,28,79,107,0
2_4605843,craves_love_lobster,4605843,2,9,23,32,0
2_2576538,craves_love_flounder,2576538,2,9,26,35,0
2_1265535,locale_haroset_manitoba,1265535,2,13,31,44,0
2_6290134,craves_love_haroset,6290134,2,11,20,31,0
2_4484680,fears_jealousy_love,4484680,2,8,20,28,0
2_7424527,harmony_love_vulcan,7424527,2,11,26,37,0
2_3800886,noop_pain_sciatica,3800886,2,1,1,2,0
2_7165176,noop_craves_dread_wonderbread,7165176,2,8,18,26,0
2_4648643,overcome_dread_achievement_wonderbread_uranus_saturn,4648643,2,17,22,39,0
2_4059168,harmony_achievement_uranus,4059168,2,4,10,14,0
2_7129906,fears_dread_achievement,7129906,2,4,4,8,0
2_513547,noop_craves_boils_lemon,513547,2,5,9,14,0
2_6292230,harmony_lubricity_saturn,6292230,2,10,32,42,0
2_5022204,fears_boils_lubricity,5022204,2,8,17,25,0
2_1498085,noop_locale_lamb_goias,1498085,2,13,23,36,0
2_5255941,locale_lamb_bosnia,5255941,2,7,22,29,0
2_5586764,craves_stimulation_lamb,5586764,2,7,29,36,0
2_1573596,noop_fears_laceration_stimulation,1573596,2,19,43,62,0
2_7695533,craves_stimulation_haroset,7695533,2,9,23,32,0
2_496271,craves_laceration_lamb,496271,2,5,11,16,0
2_6095221,craves_stimulation_beef,6095221,2,9,29,38,0
2_794907,harmony_stimulation_earth,794907,2,6,24,30,0
2_4451660,locale_lamb_goias,4451660,2,10,13,23,0
2_6772543,noop_pain_anxiety,6772543,2,1,1,2,0
2_321444,overcome_anxiety_learning_onion_uranus_saturn,321444,2,29,39,68,0
2_3958185,noop_attacks_pennsylvania_oregon,3958185,2,1,1,2,0
2_5919561,feast_stimulation_beef_lamb_pennsylvania_oregon,5919561,2,30,85,115,0
2_1990299,feast_lubricity_beef_lamb_pennsylvania_oregon,1990299,2,29,80,109,0
2_4813922,noop_harmony_learning_saturn,4813922,2,8,21,29,0
2_2696465,overcome_depression_learning_snickers_uranus_saturn,2696465,2,27,37,64,0
2_1760814,noop_locale_onion_bavaria,1760814,2,1,1,2,0
2_6949341,noop_craves_abrasion_beef,6949341,2,3,10,13,0
2_1477183,noop_food_tofu,1477183,2,1,1,2,0
2_2360333,noop_food_lamb,2360333,2,1,1,2,0
2_5170983,feast_stimulation_lamb_beef_goias_bosnia,5170983,2,27,78,105,0
2_6902405,feast_stimulation_lamb_haroset_goias_bosnia,6902405,2,27,78,105,0
2_4565515,noop_orbits_vulcan_uranus,4565515,2,1,1,2,0
2_1053216,overcome_jealousy_entertainment_haroset_vulcan_uranus,1053216,2,35,64,99,0
2_7969387,noop_craves_achievement_wonderbread,7969387,2,1,1,2,0
2_3399490,noop_fears_grief_entertainment,3399490,2,17,33,50,0
2_3477531,harmony_entertainment_uranus,3477531,2,6,23,29,0
2_5474563,craves_grief_lobster,5474563,2,6,10,16,0
2_746090,noop_food_flounder,746090,2,1,1,2,0
2_7292320,feast_stimulation_haroset_flounder_bavaria_manitoba,7292320,2,46,123,169,0
2_6997780,feast_entertainment_haroset_flounder_bavaria_manitoba,6997780,2,47,107,154,0
2_6630843,noop_eats_lobster_haroset,6630843,2,1,1,2,0
2_1979204,feast_aesthetics_lobster_haroset_bavaria_manitoba,1979204,2,35,67,102,0
2_2619566,noop_craves_grief_lobster,2619566,2,7,14,21,0
2_928830,noop_harmony_stimulation_saturn,928830,2,19,32,51,0
2_564420,noop_planet_earth,564420,2,1,1,2,0
2_1176899,noop_craves_stimulation_lamb,1176899,2,16,47,63,0
2_6664251,noop_harmony_entertainment_vulcan,6664251,2,17,22,39,0
2_7299431,noop_locale_wonderbread_bavaria,7299431,2,1,1,2,0
2_4775970,noop_locale_flounder_oregon,4775970,2,3,18,21,0
2_7835729,noop_craves_aesthetics_bacon,7835729,2,10,22,32,0
2_7476923,feast_aesthetics_bacon_lobster_bavaria_manitoba,7476923,2,21,36,57,0
2_394853,feast_aesthetics_bacon_wonderbread_bavaria_manitoba,394853,2,21,36,57,0
2_658980,craves_aesthetics_wonderbread,658980,2,6,21,27,0
2_7224728,craves_aesthetics_lobster,7224728,2,8,20,28,0
2_5395676,locale_bacon_bavaria,5395676,2,8,2,10,0
2_4769684,noop_harmony_achievement_uranus,4769684,2,8,18,26,0
2_7547979,noop_food_wonderbread,7547979,2,1,1,2,0
2_2186495,feast_expectation_okra_wonderbread_bavaria_manitoba,2186495,2,22,30,52,0
2_4506403,feast_learning_okra_wonderbread_bavaria_manitoba,4506403,2,34,51,85,0
2_7618197,feast_expectation_snickers_wonderbread_bavaria_manitoba,7618197,2,34,51,85,0
2_5107816,feast_learning_snickers_wonderbread_bavaria_manitoba,5107816,2,25,37,62,0
2_7307348,noop_pleasure_expectation,7307348,2,1,1,2,0
2_5483812,succumb_hangover_expectation_okra_uranus_saturn,5483812,2,23,33,56,0
2_1923741,feast_expectation_okra_snickers_bavaria_manitoba,1923741,2,22,30,52,0
2_7665601,feast_expectation_snickers_okra_bavaria_manitoba,7665601,2,34,51,85,0
2_918343,noop_craves_prostatitis_marzipan,918343,2,1,3,4,0
2_2868790,noop_food_beef,2868790,2,1,1,2,0
2_2330190,feast_lubricity_lemon_beef_bavaria_manitoba,2330190,2,24,60,84,0
2_4964407,noop_food_cantelope,4964407,2,1,1,2,0
2_5457751,feast_lubricity_lemon_cantelope_bavaria_manitoba,5457751,2,24,60,84,0
2_6628497,noop_pain_abrasion,6628497,2,1,1,2,0
2_5518037,noop_harmony_aesthetics_earth,5518037,2,7,17,24,0
2_2814490,harmony_aesthetics_saturn,2814490,2,9,21,30,0
2_5951675,fears_sciatica_aesthetics,5951675,2,7,13,20,0
2_2098945,noop_eats_flounder_haroset,2098945,2,1,1,2,0
2_1685356,noop_craves_stimulation_beef,1685356,2,19,52,71,0
2_6261001,noop_craves_laceration_lamb,6261001,2,6,12,18,0
2_7692183,noop_locale_lobster_manitoba,7692183,2,17,46,63,0
2_2198537,feast_aesthetics_lobster_bacon_bavaria_manitoba,2198537,2,35,67,102,0
2_2475306,noop_craves_expectation_okra,2475306,2,11,20,31,0
2_4150653,craves_expectation_wonderbread,4150653,2,7,14,21,0
2_765503,locale_okra_bavaria,765503,2,8,2,10,0
2_5497475,noop_locale_haroset_bavaria,5497475,2,16,14,30,0
2_6650699,noop_food_snickers,6650699,2,1,1,2,0
2_3471673,feast_learning_okra_snickers_bavaria_manitoba,3471673,2,34,51,85,0
2_1212556,feast_learning_snickers_okra_bavaria_manitoba,1212556,2,25,37,62,0
2_6837474,noop_province_pennsylvania,6837474,2,1,1,2,0
2_6296349,noop_planet_uranus,6296349,2,1,1,2,0
2_6256237,noop_eats_okra_snickers,6256237,2,1,1,2,0
2_461749,noop_pain_depression,461749,2,1,1,2,0
2_3663839,noop_pain_angina,3663839,2,1,1,2,0
2_1640807,noop_province_bavaria,1640807,2,1,1,2,0
2_6267138,noop_eats_beef_marzipan,6267138,2,1,1,2,0
2_953650,noop_eats_onion_tofu,953650,2,1,1,2,0
2_7242962,noop_eats_lamb_beef,7242962,2,1,1,2,0
2_5410840,noop_craves_depression_snickers,5410840,2,6,12,18,0
2_4050227,noop_attacks_oregon_goias,4050227,2,1,1,2,0
2_7550155,noop_craves_learning_okra,7550155,2,19,28,47,0
2_4329252,noop_fears_sciatica_aesthetics,4329252,2,13,23,36,0
2_3121428,craves_sciatica_bacon,3121428,2,5,9,14,0
2_6305720,harmony_aesthetics_earth,6305720,2,6,17,23,0
2_7594879,noop_pain_hangover,7594879,2,1,1,2,0
2_4872690,noop_eats_marzipan_tofu,4872690,2,1,1,2,0
2_2540679,noop_locale_bacon_bavaria,2540679,2,11,8,19,0
2_2799034,locale_bacon_manitoba,2799034,2,7,15,22,0
2_4244617,craves_aesthetics_bacon,4244617,2,6,17,23,0
2_3091627,noop_food_bacon,3091627,2,1,1,2,0
2_7076654,noop_pain_anger,7076654,2,1,1,2,0
2_3024551,noop_eats_lamb_haroset,3024551,2,1,1,2,0
2_7161928,noop_locale_ham_bosnia,7161928,2,3,14,17,0
2_6343879,noop_craves_learning_onion,6343879,2,19,28,47,0
2_1568911,noop_harmony_love_vulcan,1568911,2,22,39,61,0
2_2928243,harmony_love_uranus,2928243,2,7,27,34,0
2_222734,craves_jealousy_haroset,222734,2,6,12,18,0
2_7733722,locale_haroset_bavaria,7733722,2,13,2,15,0
2_3553209,craves_love_lamb,3553209,2,11,28,39,0
2_3694793,noop_harmony_achievement_saturn,3694793,2,5,5,10,0
2_1490852,noop_eats_okra_wonderbread,1490852,2,1,1,2,0
2_5602305,noop_craves_aesthetics_lobster,5602305,2,15,27,42,0
2_331103,noop_craves_sciatica_bacon,331103,2,6,11,17,0
2_5659255,noop_eats_snickers_wonderbread,5659255,2,1,1,2,0
2_5895206,noop_fears_depression_learning,5895206,2,15,22,37,0
2_2174354,noop_pleasure_learning,2174354,2,1,1,2,0
2_2791656,noop_planet_vulcan,2791656,2,1,1,2,0
2_1981432,noop_eats_tofu_onion,1981432,2,1,1,2,0
2_1451630,noop_craves_aesthetics_wonderbread,1451630,2,15,27,42,0
2_5504547,noop_harmony_lubricity_saturn,5504547,2,16,37,53,0
2_6630041,noop_fears_jealousy_love,6630041,2,22,51,73,0
2_2029468,noop_eats_lobster_bacon,2029468,2,1,1,2,0
2_4085983,noop_eats_wonderbread_bacon,4085983,2,1,1,2,0
2_5254932,noop_locale_lemon_manitoba,5254932,2,15,53,68,0
2_325406,noop_craves_expectation_snickers,325406,2,16,21,37,0
2_7276459,noop_food_lemon,7276459,2,1,1,2,0
2_3418815,noop_pain_prostatitis,3418815,2,1,1,2,0
2_5221458,noop_planet_saturn,5221458,2,1,1,2,0
2_6057461,noop_craves_lubricity_lemon,6057461,2,15,46,61,0
2_2167967,noop_harmony_entertainment_uranus,2167967,2,7,16,23,0
2_5520783,noop_eats_ham_flounder,5520783,2,1,1,2,0
2_5747312,noop_pleasure_achievement,5747312,2,1,1,2,0
2_5373533,noop_pain_dread,5373533,2,1,1,2,0
2_2749009,noop_pain_jealousy,2749009,2,1,1,2,0
2_6264297,noop_eats_marzipan_beef,6264297,2,1,1,2,0
2_405072,noop_craves_stimulation_haroset,405072,2,19,52,71,0
2_67286,noop_pleasure_stimulation,67286,2,1,1,2,0
2_2616621,noop_province_goias,2616621,2,1,1,2,0
2_7783167,noop_food_haroset,7783167,2,1,1,2,0
2_3813846,noop_craves_jealousy_haroset,3813846,2,7,15,22,0
2_434518,noop_craves_love_haroset,434518,2,19,45,64,0
2_6952736,noop_eats_haroset_flounder,6952736,2,1,1,2,0
2_8709,noop_locale_bacon_manitoba,8709,2,12,29,41,0
2_1408559,noop_eats_flounder_ham,1408559,2,1,1,2,0
2_2087401,noop_craves_learning_snickers,2087401,2,13,24,37,0
2_1669810,noop_province_manitoba,1669810,2,1,1,2,0
2_4856647,noop_locale_haroset_manitoba,4856647,2,25,81,106,0
2_1318637,noop_food_onion,1318637,2,1,1,2,0
2_7007816,noop_pleasure_entertainment,7007816,2,1,1,2,0
2_7735830,noop_locale_cantelope_bavaria,7735830,2,1,1,2,0
2_5721688,noop_eats_wonderbread_okra,5721688,2,1,1,2,0
2_5199351,noop_eats_bacon_lobster,5199351,2,1,1,2,0
2_1191871,noop_eats_cantelope_marzipan,1191871,2,1,1,2,0
2_5342758,noop_food_okra,5342758,2,1,1,2,0
2_534272,noop_harmony_lubricity_earth,534272,2,7,20,27,0
2_1581872,noop_eats_marzipan_cantelope,1581872,2,1,1,2,0
2_7722518,noop_craves_love_flounder,7722518,2,28,79,107,0
2_7231076,noop_eats_beef_lamb,7231076,2,1,1,2,0
2_2484442,noop_pain_laceration,2484442,2,1,1,2,0
2_3260377,noop_eats_tofu_marzipan,3260377,2,1,1,2,0
2_1192067,noop_harmony_aesthetics_saturn,1192067,2,13,18,31,0
2_735143,noop_orbits_uranus_saturn,735143,2,1,1,2,0
2_7341957,noop_craves_lubricity_cantelope,7341957,2,19,55,74,0
2_292731,craves_lubricity_lemon,292731,2,9,21,30,0
2_44280,locale_lemon_manitoba,44280,2,7,19,26,0
2_1189107,noop_fears_hangover_expectation,1189107,2,14,20,34,0
2_2633557,craves_hangover_okra,2633557,2,5,7,12,0
2_1891404,harmony_expectation_saturn,1891404,2,6,11,17,0
2_6935494,noop_pain_loneliness,6935494,2,1,1,2,0
2_2832879,noop_eats_lemon_ham,2832879,2,1,1,2,0
2_1232579,noop_locale_lamb_bosnia,1232579,2,18,71,89,0
2_3761495,noop_eats_lemon_cantelope,3761495,2,1,1,2,0
2_6765322,noop_locale_okra_manitoba,6765322,2,13,23,36,0
2_2622029,noop_craves_entertainment_haroset,2622029,2,20,44,64,0
2_3008246,noop_locale_lobster_bavaria,3008246,2,13,10,23,0
2_1551368,noop_craves_lubricity_beef,1551368,2,18,51,69,0
2_6751204,noop_craves_love_lobster,6751204,2,28,79,107,0
2_6098876,noop_food_lobster,6098876,2,1,1,2,0
2_964644,noop_pain_grief,964644,2,1,1,2,0
2_5073604,noop_harmony_love_uranus,5073604,2,8,20,28,0
2_982246,noop_craves_anxiety_onion,982246,2,2,6,8,0
2_737720,noop_eats_lemon_beef,737720,2,1,1,2,0
2_3551919,noop_craves_angina_ham,3551919,2,2,6,8,0
2_3235111,noop_attacks_bavaria_manitoba,3235111,2,1,1,2,0
2_6938998,noop_eats_wonderbread_snickers,6938998,2,1,1,2,0
2_3592548,noop_locale_lemon_bavaria,3592548,2,10,8,18,0
2_3676811,noop_harmony_expectation_uranus,3676811,2,14,15,29,0
2_3295483,noop_eats_snickers_okra,3295483,2,1,1,2,0
2_4634499,noop_locale_marzipan_oregon,4634499,2,1,9,10,0
2_556463,noop_locale_snickers_manitoba,556463,2,16,30,46,0
2_7543600,noop_province_bosnia,7543600,2,1,1,2,0
2_7650497,noop_attacks_manitoba_pennsylvania,7650497,2,1,1,2,0
2_6317512,noop_locale_beef_oregon,6317512,2,7,45,52,0
2_3159359,noop_pleasure_aesthetics,3159359,2,1,1,2,0
2_2443351,noop_eats_bacon_wonderbread,2443351,2,1,1,2,0
2_6512278,noop_attacks_goias_bosnia,6512278,2,1,1,2,0
2_335752,noop_craves_lubricity_ham,335752,2,18,51,69,0
2_2417187,noop_pleasure_lubricity,2417187,2,1,1,2,0
2_6239897,province_bosnia,6239897,2,1,1,2,0
2_7650924,eats_onion_tofu,7650924,2,1,1,2,0
1_2734050,overcome_anger_love_flounder_vulcan_uranus,2734050,1,8,32,40,0
0_2576538,craves_love_flounder,2576538,0,0,3,3,0
2_809839,fears_anger_love,809839,2,1,21,22,0
2_7461953,craves_anger_flounder,7461953,2,1,9,10,0
2_4679598,eats_bacon_wonderbread,4679598,2,1,5,6,0
2_1221736,eats_bacon_lobster,1221736,2,1,5,6,0
2_5978126,eats_lamb_haroset,5978126,2,1,19,20,0
1_6664251,noop_harmony_entertainment_vulcan,6664251,1,0,17,17,0
0_7973815,harmony_entertainment_vulcan,7973815,0,0,1,1,0
1_7665601,feast_expectation_snickers_okra_bavaria_manitoba,7665601,1,6,31,37,0
0_2455781,craves_expectation_snickers,2455781,0,0,4,4,0
1_335752,noop_craves_lubricity_ham,335752,1,0,18,18,0
0_3190749,craves_lubricity_ham,3190749,0,0,3,3,0
2_4281177,eats_okra_wonderbread,4281177,2,1,3,4,0
1_4329252,noop_fears_sciatica_aesthetics,4329252,1,0,13,13,0
0_5951675,fears_sciatica_aesthetics,5951675,0,0,1,1,0
2_3046200,locale_tofu_manitoba,3046200,2,1,5,6,0
1_2660153,succumb_depression_learning_snickers_uranus_saturn,2660153,1,5,22,27,0
0_2297701,harmony_learning_uranus,2297701,0,0,1,1,0
0_7517629,fears_depression_learning,7517629,0,0,1,1,0
1_152103,feast_stimulation_beef_lemon_pennsylvania_oregon,152103,1,6,26,32,0
0_6095221,craves_stimulation_beef,6095221,0,0,4,4,0
2_7015491,locale_beef_pennsylvania,7015491,2,6,14,20,0
2_1141187,craves_stimulation_lemon,1141187,2,1,23,24,0
2_2339897,locale_beef_oregon,2339897,2,6,17,23,0
1_4506403,feast_learning_okra_wonderbread_bavaria_manitoba,4506403,1,6,31,37,0
0_2404175,craves_learning_okra,2404175,0,0,3,3,0
1_718803,feast_entertainment_haroset_lamb_bavaria_manitoba,718803,1,6,44,50,0
0_3931593,craves_entertainment_haroset,3931593,0,0,4,4,0
2_4849081,craves_entertainment_lamb,4849081,2,1,35,36,0
1_118053,overcome_hangover_learning_okra_uranus_saturn,118053,1,9,28,37,0
2_2802576,fears_hangover_learning,2802576,2,1,17,18,0
1_6139003,overcome_jealousy_stimulation_haroset_saturn_earth,6139003,1,8,29,37,0
0_7695533,craves_stimulation_haroset,7695533,0,0,4,4,0
2_5363829,fears_jealousy_stimulation,5363829,2,1,19,20,0
1_6751204,noop_craves_love_lobster,6751204,1,0,28,28,0
0_4605843,craves_love_lobster,4605843,0,0,3,3,0
2_5127929,pleasure_learning,5127929,2,1,41,42,0
2_1567476,pain_anger,1567476,2,1,14,15,0
2_7563751,eats_cantelope_lemon,7563751,2,1,1,2,0
2_3344601,craves_loneliness_tofu,3344601,2,1,3,4,0
1_1979204,feast_aesthetics_lobster_haroset_bavaria_manitoba,1979204,1,6,32,38,0
0_7224728,craves_aesthetics_lobster,7224728,0,0,3,3,0
2_908042,craves_aesthetics_haroset,908042,2,1,28,29,0
2_7281678,eats_snickers_wonderbread,7281678,2,1,3,4,0
1_5602305,noop_craves_aesthetics_lobster,5602305,1,1,15,16,0
1_7550155,noop_craves_learning_okra,7550155,1,1,19,20,0
2_4730552,eats_beef_lemon,4730552,2,1,13,14,0
1_7068455,feast_stimulation_haroset_lobster_bavaria_manitoba,7068455,1,7,43,50,0
2_6011242,craves_stimulation_lobster,6011242,2,1,35,36,0
1_3242955,feast_lubricity_beef_marzipan_pennsylvania_oregon,3242955,1,6,26,32,0
0_4341693,craves_lubricity_beef,4341693,0,0,4,4,0
2_4422260,craves_lubricity_marzipan,4422260,2,1,26,27,0
1_325406,noop_craves_expectation_snickers,325406,1,1,16,17,0
2_3976229,planet_vulcan,3976229,2,1,74,75,0
1_5895206,noop_fears_depression_learning,5895206,1,1,15,16,0
1_1685356,noop_craves_stimulation_beef,1685356,1,1,19,20,0
1_5442106,feast_entertainment_haroset_lobster_bavaria_manitoba,5442106,1,7,44,51,0
1_1843106,overcome_angina_lubricity_ham_saturn_earth,1843106,1,9,22,31,0
2_2249450,fears_angina_lubricity,2249450,2,1,6,7,0
2_6505494,craves_angina_ham,6505494,2,1,8,9,0
1_1189107,noop_fears_hangover_expectation,1189107,1,0,14,14,0
0_478591,fears_hangover_expectation,478591,0,0,1,1,0
1_7341957,noop_craves_lubricity_cantelope,7341957,1,0,19,19,0
0_6631441,craves_lubricity_cantelope,6631441,0,0,0,0,0
2_3933873,province_bavaria,3933873,2,1,1,2,0
2_4177969,food_cantelope,4177969,2,1,13,14,0
2_6133837,food_okra,6133837,2,1,22,23,0
2_6406031,planet_saturn,6406031,2,1,108,109,0
2_1013998,pleasure_aesthetics,1013998,2,1,62,63,0
2_4362134,eats_flounder_ham,4362134,2,1,12,13,0
2_3933582,pain_jealousy,3933582,2,1,41,42,0
2_1767281,food_lemon,1767281,2,1,46,47,0
2_20256,province_oregon,20256,2,1,1,2,0
1_5182809,succumb_grief_entertainment_lobster_vulcan_uranus,5182809,1,6,23,29,0
0_5021913,fears_grief_entertainment,5021913,0,0,1,1,0
2_4623385,province_manitoba,4623385,2,1,1,2,0
1_122360,feast_love_lamb_haroset_goias_bosnia,122360,1,6,43,49,0
0_3553209,craves_love_lamb,3553209,0,0,5,5,0
1_3676811,noop_harmony_expectation_uranus,3676811,1,0,14,14,0
0_2966295,harmony_expectation_uranus,2966295,0,0,1,1,0
2_4022794,attacks_bavaria_manitoba,4022794,2,1,69,70,0
1_1568911,noop_harmony_love_vulcan,1568911,1,0,22,22,0
0_7424527,harmony_love_vulcan,7424527,0,0,1,1,0
1_5919561,feast_stimulation_beef_lamb_pennsylvania_oregon,5919561,1,7,27,34,0
2_601332,pleasure_achievement,601332,2,1,9,10,0
2_6456524,eats_lamb_beef,6456524,2,1,19,20,0
2_3715801,orbits_saturn_earth,3715801,2,1,101,102,0
1_5483812,succumb_hangover_expectation_okra_uranus_saturn,5483812,1,7,20,27,0
1_5888813,noop_harmony_learning_uranus,5888813,1,1,15,16,0
1_4744463,feast_entertainment_bacon_lobster_bavaria_manitoba,4744463,1,6,32,38,0
0_132955,craves_entertainment_bacon,132955,0,0,3,3,0
1_5546013,feast_entertainment_bacon_wonderbread_bavaria_manitoba,5546013,1,7,32,39,0
2_7423494,craves_entertainment_wonderbread,7423494,2,1,24,25,0
2_4615811,locale_onion_bavaria,4615811,2,1,1,2,0
1_2910864,noop_locale_okra_bavaria,2910864,1,0,11,11,0
0_765503,locale_okra_bavaria,765503,0,0,0,0,0
2_5711881,pain_prostatitis,5711881,2,1,8,9,0
2_7420512,orbits_vulcan_uranus,7420512,2,1,125,126,0
1_6725965,succumb_laceration_stimulation_lamb_saturn_earth,6725965,1,5,25,30,0
0_218314,harmony_stimulation_saturn,218314,0,0,1,1,0
0_2883160,fears_laceration_stimulation,2883160,0,0,1,1,0
2_1243086,pleasure_entertainment,1243086,2,1,65,66,0
1_1221666,succumb_sciatica_aesthetics_bacon_saturn_earth,1221666,1,6,19,25,0
0_2814490,harmony_aesthetics_saturn,2814490,0,0,1,1,0
1_1053216,overcome_jealousy_entertainment_haroset_vulcan_uranus,1053216,1,9,30,39,0
2_6863696,fears_jealousy_entertainment,6863696,2,1,19,20,0
1_1192067,noop_harmony_aesthetics_saturn,1192067,1,1,13,14,0
2_2380884,food_haroset,2380884,2,1,82,83,0
1_7040767,feast_love_lobster_haroset_bavaria_manitoba,7040767,1,7,44,51,0
1_1551368,noop_craves_lubricity_beef,1551368,1,1,18,19,0
1_7722518,noop_craves_love_flounder,7722518,1,1,28,29,0
2_6052830,eats_lobster_bacon,6052830,2,1,5,6,0
2_3135358,eats_snickers_onion,3135358,2,1,3,4,0
1_6230769,noop_locale_snickers_bavaria,6230769,1,0,13,13,0
0_2639657,locale_snickers_bavaria,2639657,0,0,0,0,0
2_7434994,eats_lemon_beef,7434994,2,1,4,5,0
2_7012217,locale_flounder_oregon,7012217,2,3,13,16,0
2_3163114,planet_earth,3163114,2,1,56,57,0
1_4019620,succumb_jealousy_love_haroset_vulcan_uranus,4019620,1,6,29,35,0
0_4484680,fears_jealousy_love,4484680,0,0,1,1,0
1_6501770,feast_stimulation_beef_marzipan_pennsylvania_oregon,6501770,1,7,27,34,0
2_3796608,craves_stimulation_marzipan,3796608,2,1,22,23,0
1_7292320,feast_stimulation_haroset_flounder_bavaria_manitoba,7292320,1,7,43,50,0
2_2314717,craves_stimulation_flounder,2314717,2,1,35,36,0
1_6749570,feast_love_flounder_haroset_pennsylvania_oregon,6749570,1,7,33,40,0
2_3597041,locale_flounder_pennsylvania,3597041,2,2,28,30,0
2_5601736,eats_cantelope_marzipan,5601736,2,1,1,2,0
2_1830183,province_goias,1830183,2,1,1,2,0
1_843471,noop_craves_entertainment_bacon,843471,1,1,20,21,0
2_5991737,eats_marzipan_cantelope,5991737,2,1,7,8,0
1_405072,noop_craves_stimulation_haroset,405072,1,1,19,20,0
1_5087272,succumb_boils_lubricity_lemon_saturn_earth,5087272,1,5,23,28,0
0_6292230,harmony_lubricity_saturn,6292230,0,0,1,1,0
0_5022204,fears_boils_lubricity,5022204,0,0,1,1,0
1_4424872,overcome_abrasion_stimulation_beef_saturn_earth,4424872,1,9,24,33,0
2_3765875,fears_abrasion_stimulation,3765875,2,1,18,19,0
2_1803361,craves_abrasion_beef,1803361,2,2,11,13,0
1_3471673,feast_learning_okra_snickers_bavaria_manitoba,3471673,1,7,31,38,0
1_3042773,feast_stimulation_haroset_lamb_bavaria_manitoba,3042773,1,7,43,50,0
2_1626822,province_pennsylvania,1626822,2,1,1,2,0
1_6282974,overcome_dread_aesthetics_wonderbread_saturn_earth,6282974,1,8,26,34,0
0_658980,craves_aesthetics_wonderbread,658980,0,0,1,1,0
2_2102130,fears_dread_aesthetics,2102130,2,1,16,17,0
1_5497475,noop_locale_haroset_bavaria,5497475,1,0,16,16,0
0_7733722,locale_haroset_bavaria,7733722,0,0,0,0,0
1_5842625,overcome_grief_love_lobster_vulcan_uranus,5842625,1,9,38,47,0
2_5019078,fears_grief_love,5019078,2,1,24,25,0
2_696593,food_lobster,696593,2,1,47,48,0
2_6444638,eats_beef_lamb,6444638,2,1,13,14,0
2_7283739,eats_tofu_marzipan,7283739,2,1,3,4,0
2_5583426,food_bacon,5583426,2,1,32,33,0
2_6905224,attacks_oregon_goias,6905224,2,1,19,20,0
2_4569802,eats_haroset_lamb,4569802,2,1,6,7,0
2_1366298,attacks_goias_bosnia,1366298,2,1,19,20,0
2_2114526,locale_ham_bosnia,2114526,2,3,11,14,0
1_7044628,noop_craves_expectation_wonderbread,7044628,1,0,16,16,0
0_4150653,craves_expectation_wonderbread,4150653,0,0,1,1,0
2_918250,pain_boils,918250,2,1,30,31,0
1_3736378,overcome_sciatica_entertainment_bacon_vulcan_uranus,3736378,1,9,29,38,0
2_7153580,fears_sciatica_entertainment,7153580,2,1,17,18,0
1_2622029,noop_craves_entertainment_haroset,2622029,1,1,20,21,0
2_2046441,eats_lemon_ham,2046441,2,1,4,5,0
1_6343879,noop_craves_learning_onion,6343879,1,0,19,19,0
0_1133227,craves_learning_onion,1133227,0,0,1,1,0
1_2540679,noop_locale_bacon_bavaria,2540679,1,0,11,11,0
0_5395676,locale_bacon_bavaria,5395676,0,0,0,0,0
2_778475,pain_hangover,778475,2,1,33,34,0
2_1840068,food_wonderbread,1840068,2,1,80,81,0
1_2231879,noop_fears_boils_lubricity,2231879,1,1,16,17,0
1_4205329,feast_love_lobster_bacon_bavaria_manitoba,4205329,1,7,44,51,0
2_4430757,craves_love_bacon,4430757,2,1,29,30,0
2_522536,locale_cantelope_bavaria,522536,2,1,1,2,0
1_1451630,noop_craves_aesthetics_wonderbread,1451630,1,1,15,16,0
1_928830,noop_harmony_stimulation_saturn,928830,1,1,19,20,0
2_4138703,eats_wonderbread_marzipan,4138703,2,1,1,2,0
2_2200903,pleasure_love,2200903,2,1,86,87,0
1_6997780,feast_entertainment_haroset_flounder_bavaria_manitoba,6997780,1,7,44,51,0
2_6864294,craves_entertainment_flounder,6864294,2,1,34,35,0
2_6588915,locale_wonderbread_bavaria,6588915,2,1,1,2,0
1_8131,noop_craves_learning_wonderbread,8131,1,0,19,19,0
0_2138506,craves_learning_wonderbread,2138506,0,0,1,1,0
2_6425404,eats_marzipan_wonderbread,6425404,2,1,7,8,0
2_3412554,food_marzipan,3412554,2,1,50,51,0
2_2289801,eats_haroset_lobster,2289801,2,1,6,7,0
2_677729,eats_tofu_onion,677729,2,1,3,4,0
2_7318845,eats_snickers_okra,7318845,2,1,3,4,0
2_7865332,pain_dread,7865332,2,1,21,22,0
2_473381,eats_ham_flounder,473381,2,1,10,11,0
2_6322230,eats_wonderbread_bacon,6322230,2,1,1,2,0
2_3151412,food_lamb,3151412,2,1,82,83,0
2_2268262,food_tofu,2268262,2,1,13,14,0
1_2384133,feast_lubricity_beef_lemon_pennsylvania_oregon,2384133,1,7,26,33,0
1_4769684,noop_harmony_achievement_uranus,4769684,1,0,8,8,0
0_4059168,harmony_achievement_uranus,4059168,0,0,1,1,0
1_4910584,overcome_abrasion_lubricity_beef_saturn_earth,4910584,1,9,24,33,0
2_1790580,fears_abrasion_lubricity,1790580,2,1,20,21,0
2_6088560,attacks_pennsylvania_oregon,6088560,2,1,47,48,0
1_1498085,noop_locale_lamb_goias,1498085,1,0,13,13,0
0_4451660,locale_lamb_goias,4451660,0,0,2,2,0
1_5016585,feast_love_lamb_beef_oregon_goias,5016585,1,7,41,48,0
2_7037277,locale_lamb_oregon,7037277,2,2,29,31,0
2_4061666,craves_love_beef,4061666,2,2,34,36,0
2_1742084,eats_haroset_flounder,1742084,2,1,6,7,0
2_2922283,pleasure_stimulation,2922283,2,1,111,112,0
2_4985459,pain_sciatica,4985459,2,1,32,33,0
1_7478636,feast_love_lamb_beef_goias_bosnia,7478636,1,7,43,50,0
1_5661286,feast_love_lamb_haroset_oregon_goias,5661286,1,7,41,48,0
1_139886,overcome_laceration_love_lamb_vulcan_uranus,139886,1,9,37,46,0
2_3246453,fears_laceration_love,3246453,2,1,6,7,0
2_6440549,pleasure_lubricity,6440549,2,1,101,102,0
2_3810436,food_onion,3810436,2,1,17,18,0
2_2278622,eats_okra_snickers,2278622,2,1,3,4,0
2_5075412,craves_achievement_wonderbread,5075412,2,1,9,10,0
1_2198537,feast_aesthetics_lobster_bacon_bavaria_manitoba,2198537,1,7,32,39,0
1_3164387,overcome_dread_expectation_wonderbread_uranus_saturn,3164387,1,9,27,36,0
2_688965,fears_dread_expectation,688965,2,1,15,16,0
1_5285237,overcome_dread_learning_wonderbread_uranus_saturn,5285237,1,9,30,39,0
2_150287,fears_dread_learning,150287,2,1,17,18,0
2_511036,eats_wonderbread_okra,511036,2,1,1,2,0
2_2289523,eats_beef_marzipan,2289523,2,1,13,14,0
2_1486223,pain_angina,1486223,2,1,13,14,0
2_6188452,food_ham,6188452,2,1,50,51,0
2_137551,eats_ham_lemon,137551,2,1,10,11,0
1_168939,overcome_grief_aesthetics_lobster_saturn_earth,168939,1,9,25,34,0
2_3557753,fears_grief_aesthetics,3557753,2,1,8,9,0
2_895075,eats_marzipan_tofu,895075,2,1,7,8,0
2_3659869,food_beef,3659869,2,1,95,96,0
2_1930663,food_flounder,1930663,2,1,58,59,0
1_3399490,noop_fears_grief_entertainment,3399490,1,1,17,18,0
2_6634256,eats_onion_snickers,6634256,2,1,1,2,0
1_4770690,feast_love_flounder_ham_pennsylvania_oregon,4770690,1,7,33,40,0
2_2533325,craves_love_ham,2533325,2,1,27,28,0
1_6630041,noop_fears_jealousy_love,6630041,1,1,22,23,0
1_2720041,noop_fears_dread_achievement,2720041,1,0,8,8,0
0_7129906,fears_dread_achievement,7129906,0,0,1,1,0
2_1180739,pain_laceration,1180739,2,1,36,37,0
1_5596192,feast_lubricity_ham_lemon_goias_bosnia,5596192,1,7,23,30,0
2_157616,locale_ham_goias,157616,2,2,19,21,0
2_3590140,orbits_uranus_saturn,3590140,2,1,93,94,0
2_3048718,craves_prostatitis_marzipan,3048718,2,1,6,7,0
2_1484863,eats_lobster_haroset,1484863,2,1,5,6,0
2_1370260,pain_anxiety,1370260,2,1,8,9,0
1_1260143,noop_craves_love_lamb,1260143,1,1,28,29,0
2_3456443,pain_grief,3456443,2,1,33,34,0
2_5631791,pain_loneliness,5631791,2,1,3,4,0
1_321444,overcome_anxiety_learning_onion_uranus_saturn,321444,1,9,23,32,0
2_4769340,fears_anxiety_learning,4769340,2,1,12,13,0
2_3837243,craves_anxiety_onion,3837243,2,1,6,7,0
2_6616492,eats_lemon_cantelope,6616492,2,1,4,5,0
2_4889270,eats_flounder_haroset,4889270,2,1,12,13,0
1_3008246,noop_locale_lobster_bavaria,3008246,1,0,13,13,0
0_5244493,locale_lobster_bavaria,5244493,0,0,0,0,0
1_1573596,noop_fears_laceration_stimulation,1573596,1,1,19,20,0
1_7859946,feast_lubricity_ham_flounder_goias_bosnia,7859946,1,7,23,30,0
2_2940369,craves_lubricity_flounder,2940369,2,1,24,25,0
1_5868596,overcome_depression_expectation_snickers_uranus_saturn,5868596,1,9,25,34,0
2_3536464,fears_depression_expectation,3536464,2,1,14,15,0
2_6857847,attacks_manitoba_pennsylvania,6857847,2,1,41,42,0
2_2286682,eats_marzipan_beef,2286682,2,1,7,8,0
1_5504547,noop_harmony_lubricity_saturn,5504547,1,1,16,17,0
2_7813070,pain_abrasion,7813070,2,1,22,23,0
1_7618197,feast_expectation_snickers_wonderbread_bavaria_manitoba,7618197,1,7,31,38,0
1_3592548,noop_locale_lemon_bavaria,3592548,1,0,10,10,0
0_6447545,locale_lemon_bavaria,6447545,0,0,0,0,0
2_560444,eats_wonderbread_snickers,560444,2,1,1,2,0
2_2161368,pleasure_expectation,2161368,2,1,39,40,0
1_3353748,succumb_dread_achievement_wonderbread_uranus_saturn,3353748,1,7,12,19,0
2_6870746,locale_marzipan_oregon,6870746,2,1,13,14,0
2_7159023,pain_depression,7159023,2,1,36,37,0
2_7480922,planet_uranus,7480922,2,1,126,127,0
2_7835272,food_snickers,7835272,2,1,24,25,0
1_6245149,feast_expectation_snickers_onion_bavaria_manitoba,6245149,1,7,31,38,0
2_4128492,craves_expectation_onion,4128492,2,1,21,22,0
1_1990299,feast_lubricity_beef_lamb_pennsylvania_oregon,1990299,1,7,26,33,0
2_3833236,craves_lubricity_lamb,3833236,2,1,31,32,0
3_13203,noop_fears_angina_lubricity,13203,3,57,125,182,0
3_1684381,succumb_angina_lubricity_ham_saturn_earth,1684381,3,66,149,215,0
3_6505494,craves_angina_ham,6505494,3,5,11,16,0
3_4341693,craves_lubricity_beef,4341693,3,20,50,70,0
3_6631441,craves_lubricity_cantelope,6631441,3,12,28,40,0
3_4944137,harmony_lubricity_earth,4944137,3,16,54,70,0
3_3833236,craves_lubricity_lamb,3833236,3,23,52,75,0
3_292731,craves_lubricity_lemon,292731,3,14,40,54,0
3_44280,locale_lemon_manitoba,44280,3,16,32,48,0
3_1790580,fears_abrasion_lubricity,1790580,3,16,36,52,0
3_2940369,craves_lubricity_flounder,2940369,3,17,48,65,0
3_157616,locale_ham_goias,157616,3,17,13,30,0
3_4422260,craves_lubricity_marzipan,4422260,3,21,49,70,0
3_5022204,fears_boils_lubricity,5022204,3,14,34,48,0
3_191203,noop_locale_tofu_manitoba,191203,3,1,5,6,0
3_6427428,noop_pain_boils,6427428,3,1,1,2,0
3_5087272,succumb_boils_lubricity_lemon_saturn_earth,5087272,3,62,140,202,0
3_5209032,succumb_boils_lubricity_cantelope_saturn_earth,5209032,3,66,150,216,0
3_5301639,succumb_boils_lubricity_beef_saturn_earth,5301639,3,66,149,215,0
3_7541173,succumb_boils_lubricity_ham_saturn_earth,7541173,3,66,148,214,0
3_157892,overcome_boils_stimulation_lemon_saturn_earth,157892,3,94,191,285,0
3_3575228,overcome_boils_lubricity_lemon_uranus_saturn,3575228,3,64,140,204,0
3_5715987,overcome_boils_lubricity_lemon_saturn_earth,5715987,3,61,142,203,0
3_5861162,noop_orbits_saturn_earth,5861162,3,1,1,2,0
3_839449,succumb_grief_aesthetics_lobster_saturn_earth,839449,3,50,134,184,0
3_6725965,succumb_laceration_stimulation_lamb_saturn_earth,6725965,3,67,158,225,0
3_6655370,succumb_laceration_stimulation_beef_saturn_earth,6655370,3,74,168,242,0
3_2605711,succumb_laceration_stimulation_haroset_saturn_earth,2605711,3,74,168,242,0
3_53938,succumb_abrasion_stimulation_beef_saturn_earth,53938,3,71,169,240,0
3_1221666,succumb_sciatica_aesthetics_bacon_saturn_earth,1221666,3,38,99,137,0
3_1865662,succumb_sciatica_aesthetics_lobster_saturn_earth,1865662,3,45,117,162,0
3_3313713,succumb_sciatica_aesthetics_wonderbread_saturn_earth,3313713,3,45,117,162,0
3_888220,succumb_jealousy_stimulation_haroset_saturn_earth,888220,3,76,189,265,0
3_6475894,succumb_abrasion_lubricity_beef_saturn_earth,6475894,3,70,158,228,0
3_1032191,succumb_dread_aesthetics_wonderbread_saturn_earth,1032191,3,53,127,180,0
3_5592600,overcome_sciatica_aesthetics_bacon_saturn_earth,5592600,3,40,100,140,0
3_4424872,overcome_abrasion_stimulation_beef_saturn_earth,4424872,3,73,164,237,0
3_4910584,overcome_abrasion_lubricity_beef_saturn_earth,4910584,3,72,153,225,0
3_1843106,overcome_angina_lubricity_ham_saturn_earth,1843106,3,68,142,210,0
3_1826954,overcome_anger_stimulation_flounder_saturn_earth,1826954,3,132,332,464,0
3_5923165,overcome_anger_lubricity_flounder_saturn_earth,5923165,3,72,164,236,0
3_5733459,overcome_prostatitis_stimulation_marzipan_saturn_earth,5733459,3,87,171,258,0
3_4087311,overcome_prostatitis_lubricity_marzipan_saturn_earth,4087311,3,82,160,242,0
3_6139003,overcome_jealousy_stimulation_haroset_saturn_earth,6139003,3,78,184,262,0
3_1221343,overcome_jealousy_aesthetics_haroset_saturn_earth,1221343,3,85,225,310,0
3_6282974,overcome_dread_aesthetics_wonderbread_saturn_earth,6282974,3,55,120,175,0
3_1277058,overcome_laceration_stimulation_lamb_saturn_earth,1277058,3,66,160,226,0
3_561767,overcome_laceration_lubricity_lamb_saturn_earth,561767,3,92,188,280,0
3_5726568,overcome_grief_stimulation_lobster_saturn_earth,5726568,3,140,352,492,0
3_168939,overcome_grief_aesthetics_lobster_saturn_earth,168939,3,52,130,182,0
3_7435781,noop_eats_haroset_lobster,7435781,3,1,1,2,0
3_7068455,feast_stimulation_haroset_lobster_bavaria_manitoba,7068455,3,126,318,444,0
3_7135015,feast_love_haroset_lobster_bavaria_manitoba,7135015,3,90,223,313,0
3_2073452,feast_aesthetics_haroset_lobster_bavaria_manitoba,2073452,3,129,314,443,0
3_5442106,feast_entertainment_haroset_lobster_bavaria_manitoba,5442106,3,110,264,374,0
3_923989,noop_eats_ham_lemon,923989,3,1,1,2,0
3_4932716,feast_love_ham_lemon_oregon_goias,4932716,3,138,232,370,0
3_7394767,feast_love_ham_lemon_goias_bosnia,7394767,3,99,242,341,0
3_5596192,feast_lubricity_ham_lemon_goias_bosnia,5596192,3,64,150,214,0
3_4708754,noop_eats_cantelope_lemon,4708754,3,1,1,2,0
3_1108354,noop_craves_loneliness_tofu,1108354,3,1,3,4,0
3_5888813,noop_harmony_learning_uranus,5888813,3,17,54,71,0
3_1683363,succumb_hangover_learning_okra_uranus_saturn,1683363,3,48,102,150,0
3_7142696,succumb_depression_learning_wonderbread_uranus_saturn,7142696,3,46,88,134,0
3_5020674,succumb_depression_learning_okra_uranus_saturn,5020674,3,46,89,135,0
3_1421700,succumb_depression_learning_onion_uranus_saturn,1421700,3,46,89,135,0
3_2660153,succumb_depression_learning_snickers_uranus_saturn,2660153,3,40,79,119,0
3_2733167,succumb_dread_learning_wonderbread_uranus_saturn,2733167,3,55,103,158,0
3_1886754,succumb_anxiety_learning_onion_uranus_saturn,1886754,3,42,80,122,0
3_4151816,overcome_anxiety_learning_onion_vulcan_uranus,4151816,3,43,80,123,0
3_6526837,overcome_depression_learning_snickers_vulcan_uranus,6526837,3,42,79,121,0
3_3948425,overcome_hangover_learning_okra_vulcan_uranus,3948425,3,49,102,151,0
3_1114632,overcome_dread_learning_wonderbread_vulcan_uranus,1114632,3,56,102,158,0
3_1222810,harmony_learning_saturn,1222810,3,16,27,43,0
3_937738,noop_craves_entertainment_lobster,937738,3,30,79,109,0
3_5182809,succumb_grief_entertainment_lobster_vulcan_uranus,5182809,3,49,111,160,0
3_5347858,feast_entertainment_lobster_haroset_bavaria_manitoba,5347858,3,55,140,195,0
3_7467054,feast_entertainment_lobster_bacon_bavaria_manitoba,7467054,3,55,140,195,0
3_2432615,overcome_grief_entertainment_lobster_vulcan_uranus,2432615,3,51,111,162,0
3_6863696,fears_jealousy_entertainment,6863696,3,16,34,50,0
3_6864294,craves_entertainment_flounder,6864294,3,28,59,87,0
3_7423494,craves_entertainment_wonderbread,7423494,3,18,39,57,0
3_4849081,craves_entertainment_lamb,4849081,3,30,61,91,0
3_7153580,fears_sciatica_entertainment,7153580,3,15,30,45,0
3_132955,craves_entertainment_bacon,132955,3,12,28,40,0
3_3931593,craves_entertainment_haroset,3931593,3,16,33,49,0
3_1616227,noop_eats_haroset_lamb,1616227,3,1,1,2,0
3_3042773,feast_stimulation_haroset_lamb_bavaria_manitoba,3042773,3,126,318,444,0
3_5112850,feast_love_haroset_lamb_bavaria_manitoba,5112850,3,90,223,313,0
3_1354553,feast_aesthetics_haroset_lamb_bavaria_manitoba,1354553,3,129,314,443,0
3_718803,feast_entertainment_haroset_lamb_bavaria_manitoba,718803,3,110,264,374,0
3_6034255,noop_eats_beef_lemon,6034255,3,1,1,2,0
3_2785080,feast_love_beef_lemon_manitoba_pennsylvania,2785080,3,105,241,346,0
3_2027333,feast_love_beef_lemon_pennsylvania_oregon,2027333,3,128,315,443,0
3_2718520,feast_stimulation_beef_lemon_manitoba_pennsylvania,2718520,3,76,175,251,0
3_152103,feast_stimulation_beef_lemon_pennsylvania_oregon,152103,3,88,225,313,0
3_7175086,feast_lubricity_beef_lemon_manitoba_pennsylvania,7175086,3,75,164,239,0
3_2384133,feast_lubricity_beef_lemon_pennsylvania_oregon,2384133,3,83,207,290,0
3_1903589,noop_food_ham,1903589,3,1,1,2,0
3_4704130,feast_stimulation_flounder_ham_pennsylvania_oregon,4704130,3,131,329,460,0
3_1159719,feast_lubricity_flounder_ham_pennsylvania_oregon,1159719,3,76,177,253,0
3_5777515,feast_lubricity_flounder_ham_manitoba_pennsylvania,5777515,3,138,164,302,0
3_1982870,feast_love_ham_flounder_oregon_goias,1982870,3,138,232,370,0
3_4444921,feast_love_ham_flounder_goias_bosnia,4444921,3,99,242,341,0
3_6955647,feast_lubricity_lemon_ham_bavaria_manitoba,6955647,3,63,142,205,0
3_4295251,feast_stimulation_lemon_ham_bavaria_manitoba,4295251,3,117,277,394,0
3_4770690,feast_love_flounder_ham_pennsylvania_oregon,4770690,3,91,224,315,0
3_3077781,feast_entertainment_flounder_ham_pennsylvania_oregon,3077781,3,115,274,389,0
3_7859946,feast_lubricity_ham_flounder_goias_bosnia,7859946,3,64,150,214,0
3_7529475,overcome_angina_love_ham_vulcan_uranus,7529475,3,98,237,335,0
3_4238840,overcome_angina_lubricity_ham_uranus_saturn,4238840,3,67,148,215,0
3_456128,noop_fears_laceration_love,456128,3,88,231,319,0
3_7512148,succumb_laceration_love_lamb_vulcan_uranus,7512148,3,99,252,351,0
3_4605843,craves_love_lobster,4605843,3,19,42,61,0
3_2928243,harmony_love_uranus,2928243,3,19,51,70,0
3_6011242,craves_stimulation_lobster,6011242,3,28,70,98,0
3_3597041,locale_flounder_pennsylvania,3597041,3,27,13,40,0
3_809839,fears_anger_love,809839,3,20,41,61,0
3_2576538,craves_love_flounder,2576538,3,20,45,65,0
3_1265535,locale_haroset_manitoba,1265535,3,28,50,78,0
3_6290134,craves_love_haroset,6290134,3,16,29,45,0
3_4484680,fears_jealousy_love,4484680,3,17,29,46,0
3_5019078,fears_grief_love,5019078,3,22,44,66,0
3_7037277,locale_lamb_oregon,7037277,3,31,13,44,0
3_2533325,craves_love_ham,2533325,3,23,50,73,0
3_496271,craves_laceration_lamb,496271,3,9,17,26,0
3_2314717,craves_stimulation_flounder,2314717,3,28,78,106,0
3_4061666,craves_love_beef,4061666,3,26,51,77,0
3_2883160,fears_laceration_stimulation,2883160,3,15,39,54,0
3_4430757,craves_love_bacon,4430757,3,28,53,81,0
3_1321506,noop_fears_grief_aesthetics,1321506,3,41,111,152,0
3_908042,craves_aesthetics_haroset,908042,3,21,54,75,0
3_2799034,locale_bacon_manitoba,2799034,3,13,22,35,0
3_658980,craves_aesthetics_wonderbread,658980,3,7,37,44,0
3_2102130,fears_dread_aesthetics,2102130,3,16,23,39,0
3_5951675,fears_sciatica_aesthetics,5951675,3,11,23,34,0
3_6305720,harmony_aesthetics_earth,6305720,3,13,34,47,0
3_4244617,craves_aesthetics_bacon,4244617,3,8,27,35,0
3_5021913,fears_grief_entertainment,5021913,3,13,22,35,0
3_5474563,craves_grief_lobster,5474563,3,11,16,27,0
3_4671628,noop_craves_anger_flounder,4671628,3,7,18,25,0
3_2734050,overcome_anger_love_flounder_vulcan_uranus,2734050,3,95,222,317,0
3_817593,overcome_anger_entertainment_flounder_vulcan_uranus,817593,3,116,277,393,0
3_2516280,noop_eats_wonderbread_marzipan,2516280,3,1,1,2,0
3_1016330,noop_pleasure_love,1016330,3,1,1,2,0
3_5498213,succumb_grief_love_lobster_vulcan_uranus,5498213,3,101,251,352,0
3_1906499,succumb_jealousy_love_lamb_vulcan_uranus,1906499,3,100,237,337,0
3_4019620,succumb_jealousy_love_haroset_vulcan_uranus,4019620,3,72,145,217,0
3_6556479,succumb_jealousy_love_flounder_vulcan_uranus,6556479,3,100,241,341,0
3_7783389,succumb_jealousy_love_lobster_vulcan_uranus,7783389,3,100,242,342,0
3_2575325,succumb_anger_love_flounder_vulcan_uranus,2575325,3,93,229,322,0
3_1482738,feast_love_bacon_lobster_bavaria_manitoba,1482738,3,128,311,439,0
3_2482178,feast_love_bacon_wonderbread_bavaria_manitoba,2482178,3,128,311,439,0
3_5016585,feast_love_lamb_beef_oregon_goias,5016585,3,98,230,328,0
3_7478636,feast_love_lamb_beef_goias_bosnia,7478636,3,127,321,448,0
3_5661286,feast_love_lamb_haroset_oregon_goias,5661286,3,98,230,328,0
3_122360,feast_love_lamb_haroset_goias_bosnia,122360,3,127,321,448,0
3_6819309,feast_love_beef_marzipan_manitoba_pennsylvania,6819309,3,105,241,346,0
3_7539176,feast_love_beef_marzipan_pennsylvania_oregon,7539176,3,128,315,443,0
3_4691811,feast_love_beef_lamb_manitoba_pennsylvania,4691811,3,105,241,346,0
3_7989638,feast_love_beef_lamb_pennsylvania_oregon,7989638,3,128,315,443,0
3_328749,feast_love_haroset_flounder_bavaria_manitoba,328749,3,90,223,313,0
3_6749570,feast_love_flounder_haroset_pennsylvania_oregon,6749570,3,91,224,315,0
3_7040767,feast_love_lobster_haroset_bavaria_manitoba,7040767,3,110,265,375,0
3_4205329,feast_love_lobster_bacon_bavaria_manitoba,4205329,3,110,265,375,0
3_975261,overcome_sciatica_love_bacon_vulcan_uranus,975261,3,121,296,417,0
3_480240,overcome_abrasion_love_beef_vulcan_uranus,480240,3,102,245,347,0
3_4951120,overcome_jealousy_love_haroset_vulcan_uranus,4951120,3,66,145,211,0
3_139886,overcome_laceration_love_lamb_vulcan_uranus,139886,3,101,241,342,0
3_5842625,overcome_grief_love_lobster_vulcan_uranus,5842625,3,103,246,349,0
3_7044628,noop_craves_expectation_wonderbread,7044628,3,21,36,57,0
3_1869492,succumb_dread_expectation_wonderbread_uranus_saturn,1869492,3,48,92,140,0
3_1984569,succumb_hangover_expectation_wonderbread_uranus_saturn,1984569,3,39,77,116,0
3_3164387,overcome_dread_expectation_wonderbread_uranus_saturn,3164387,3,50,82,132,0
3_6994759,overcome_dread_expectation_wonderbread_vulcan_uranus,6994759,3,49,91,140,0
3_4128492,craves_expectation_onion,4128492,3,16,32,48,0
3_3536464,fears_depression_expectation,3536464,3,12,23,35,0
3_6885171,craves_expectation_okra,6885171,3,8,19,27,0
3_2455781,craves_expectation_snickers,2455781,3,9,21,30,0
3_1619342,locale_okra_manitoba,1619342,3,10,13,23,0
3_2910864,noop_locale_okra_bavaria,2910864,3,6,6,12,0
3_4802981,noop_eats_marzipan_wonderbread,4802981,3,1,1,2,0
3_7061695,feast_stimulation_marzipan_wonderbread_pennsylvania_oregon,7061695,3,85,188,273,0
3_6454858,feast_lubricity_marzipan_wonderbread_pennsylvania_oregon,6454858,3,80,177,257,0
3_2601920,noop_harmony_expectation_saturn,2601920,3,17,40,57,0
3_4815849,overcome_anxiety_expectation_onion_uranus_saturn,4815849,3,59,119,178,0
3_5868596,overcome_depression_expectation_snickers_uranus_saturn,5868596,3,44,93,137,0
3_4306136,overcome_hangover_expectation_okra_uranus_saturn,4306136,3,38,76,114,0
3_688965,fears_dread_expectation,688965,3,15,19,34,0
3_478591,fears_hangover_expectation,478591,3,11,19,30,0
3_2966295,harmony_expectation_uranus,2966295,3,14,27,41,0
3_2227981,noop_food_marzipan,2227981,3,1,1,2,0
3_3873239,feast_stimulation_marzipan_tofu_pennsylvania_oregon,3873239,3,85,188,273,0
3_1404488,feast_stimulation_marzipan_beef_pennsylvania_oregon,1404488,3,85,188,273,0
3_3573257,feast_stimulation_marzipan_cantelope_pennsylvania_oregon,3573257,3,85,188,273,0
3_614424,feast_lubricity_marzipan_tofu_pennsylvania_oregon,614424,3,80,177,257,0
3_6146650,feast_lubricity_marzipan_beef_pennsylvania_oregon,6146650,3,80,177,257,0
3_3304294,feast_lubricity_marzipan_cantelope_pennsylvania_oregon,3304294,3,80,177,257,0
3_3681262,feast_stimulation_beef_marzipan_manitoba_pennsylvania,3681262,3,76,175,251,0
3_6501770,feast_stimulation_beef_marzipan_pennsylvania_oregon,6501770,3,88,225,313,0
3_4060483,feast_lubricity_beef_marzipan_manitoba_pennsylvania,4060483,3,75,164,239,0
3_3242955,feast_lubricity_beef_marzipan_pennsylvania_oregon,3242955,3,83,207,290,0
3_2231879,noop_fears_boils_lubricity,2231879,3,39,69,108,0
3_4536909,craves_boils_lemon,4536909,3,5,14,19,0
3_2249450,fears_angina_lubricity,2249450,3,15,25,40,0
3_843471,noop_craves_entertainment_bacon,843471,3,44,127,171,0
3_6017560,succumb_grief_entertainment_bacon_vulcan_uranus,6017560,3,65,158,223,0
3_3700066,succumb_sciatica_entertainment_bacon_vulcan_uranus,3700066,3,63,167,230,0
3_4744463,feast_entertainment_bacon_lobster_bavaria_manitoba,4744463,3,69,182,251,0
3_5546013,feast_entertainment_bacon_wonderbread_bavaria_manitoba,5546013,3,69,182,251,0
3_3736378,overcome_sciatica_entertainment_bacon_vulcan_uranus,3736378,3,65,163,228,0
3_4101071,locale_lobster_manitoba,4101071,3,18,33,51,0
3_2247302,craves_entertainment_lobster,2247302,3,11,22,33,0
3_778640,noop_eats_onion_snickers,778640,3,1,1,2,0
3_1323959,noop_province_oregon,1323959,3,1,1,2,0
3_2720041,noop_fears_dread_achievement,2720041,3,18,30,48,0
3_3353748,succumb_dread_achievement_wonderbread_uranus_saturn,3353748,3,25,37,62,0
3_150287,fears_dread_learning,150287,3,17,22,39,0
3_7952859,craves_dread_wonderbread,7952859,3,17,20,37,0
3_2984277,harmony_achievement_saturn,2984277,3,4,8,12,0
3_8131,noop_craves_learning_wonderbread,8131,3,28,47,75,0
3_5285237,overcome_dread_learning_wonderbread_uranus_saturn,5285237,3,57,93,150,0
3_4769340,fears_anxiety_learning,4769340,3,13,16,29,0
3_2802576,fears_hangover_learning,2802576,3,14,24,38,0
3_2404175,craves_learning_okra,2404175,3,10,23,33,0
3_1133227,craves_learning_onion,1133227,3,8,21,29,0
3_2875084,craves_learning_snickers,2875084,3,10,22,32,0
3_1344146,locale_snickers_manitoba,1344146,3,14,18,32,0
3_1477182,noop_craves_love_bacon,1477182,3,105,261,366,0
3_7424527,harmony_love_vulcan,7424527,3,20,49,69,0
3_3553209,craves_love_lamb,3553209,3,22,50,72,0
3_3246453,fears_laceration_love,3246453,3,21,42,63,0
3_7779537,noop_craves_hangover_okra,7779537,3,11,37,48,0
3_135531,overcome_hangover_expectation_okra_vulcan_uranus,135531,3,38,75,113,0
3_118053,overcome_hangover_learning_okra_uranus_saturn,118053,3,50,100,150,0
3_7173461,noop_harmony_stimulation_earth,7173461,3,20,75,95,0
3_5363829,fears_jealousy_stimulation,5363829,3,16,40,56,0
3_3765875,fears_abrasion_stimulation,3765875,3,15,38,53,0
3_218314,harmony_stimulation_saturn,218314,3,20,102,122,0
3_6230769,noop_locale_snickers_bavaria,6230769,3,8,8,16,0
3_1666233,noop_craves_stimulation_marzipan,1666233,3,77,153,230,0
3_2339897,locale_beef_oregon,2339897,3,14,33,47,0
3_5255941,locale_lamb_bosnia,5255941,3,19,37,56,0
3_1141187,craves_stimulation_lemon,1141187,3,19,40,59,0
3_7695533,craves_stimulation_haroset,7695533,3,16,51,67,0
3_6095221,craves_stimulation_beef,6095221,3,19,54,73,0
3_5586764,craves_stimulation_lamb,5586764,3,17,52,69,0
3_5280719,noop_eats_snickers_onion,5280719,3,1,1,2,0
3_6245149,feast_expectation_snickers_onion_bavaria_manitoba,6245149,3,54,112,166,0
3_2466891,feast_learning_snickers_onion_bavaria_manitoba,2466891,3,40,78,118,0
3_513547,noop_craves_boils_lemon,513547,3,9,35,44,0
3_7165176,noop_craves_dread_wonderbread,7165176,3,18,30,48,0
3_4648643,overcome_dread_achievement_wonderbread_uranus_saturn,4648643,3,27,37,64,0
3_3630267,overcome_dread_entertainment_wonderbread_vulcan_uranus,3630267,3,86,207,293,0
3_4706314,overcome_dread_aesthetics_wonderbread_uranus_saturn,4706314,3,54,127,181,0
3_4059168,harmony_achievement_uranus,4059168,3,7,16,23,0
3_7129906,fears_dread_achievement,7129906,3,7,7,14,0
3_3800886,noop_pain_sciatica,3800886,3,1,1,2,0
3_3992064,overcome_sciatica_aesthetics_bacon_uranus_saturn,3992064,3,40,99,139,0
3_1260143,noop_craves_love_lamb,1260143,3,79,203,282,0
3_2799837,noop_craves_lubricity_marzipan,2799837,3,72,142,214,0
3_3190749,craves_lubricity_ham,3190749,3,14,42,56,0
3_6292230,harmony_lubricity_saturn,6292230,3,20,86,106,0
3_3796608,craves_stimulation_marzipan,3796608,3,20,48,68,0
3_4813922,noop_harmony_learning_saturn,4813922,3,21,42,63,0
3_321444,overcome_anxiety_learning_onion_uranus_saturn,321444,3,44,80,124,0
3_2696465,overcome_depression_learning_snickers_uranus_saturn,2696465,3,42,80,122,0
3_7517629,fears_depression_learning,7517629,3,12,19,31,0
3_2297701,harmony_learning_uranus,2297701,3,16,22,38,0
3_3958185,noop_attacks_pennsylvania_oregon,3958185,3,1,1,2,0
3_4906729,feast_stimulation_lamb_beef_pennsylvania_oregon,4906729,3,125,173,298,0
3_3499158,feast_stimulation_lamb_haroset_pennsylvania_oregon,3499158,3,125,173,298,0
3_3507238,feast_stimulation_flounder_haroset_pennsylvania_oregon,3507238,3,131,329,460,0
3_4576090,feast_lubricity_flounder_haroset_pennsylvania_oregon,4576090,3,76,177,253,0
3_5919561,feast_stimulation_beef_lamb_pennsylvania_oregon,5919561,3,88,225,313,0
3_977467,feast_lubricity_lamb_beef_pennsylvania_oregon,977467,3,158,182,340,0
3_7955724,feast_lubricity_lamb_haroset_pennsylvania_oregon,7955724,3,158,182,340,0
3_1990299,feast_lubricity_beef_lamb_pennsylvania_oregon,1990299,3,83,207,290,0
3_5721338,feast_entertainment_flounder_haroset_pennsylvania_oregon,5721338,3,115,274,389,0
3_6772543,noop_pain_anxiety,6772543,3,1,1,2,0
3_1573596,noop_fears_laceration_stimulation,1573596,3,43,83,126,0
3_794907,harmony_stimulation_earth,794907,3,16,58,74,0
3_1498085,noop_locale_lamb_goias,1498085,3,23,40,63,0
3_2708932,feast_stimulation_lamb_beef_oregon_goias,2708932,3,73,173,246,0
3_4440354,feast_stimulation_lamb_haroset_oregon_goias,4440354,3,73,173,246,0
3_1685627,feast_entertainment_lamb_beef_oregon_goias,1685627,3,122,283,405,0
3_3832902,feast_entertainment_lamb_haroset_oregon_goias,3832902,3,122,283,405,0
3_3218010,feast_lubricity_lamb_beef_oregon_goias,3218010,3,96,182,278,0
3_1075334,feast_lubricity_lamb_haroset_oregon_goias,1075334,3,96,182,278,0
3_6949341,noop_craves_abrasion_beef,6949341,3,10,25,35,0
3_1089845,overcome_abrasion_stimulation_beef_uranus_saturn,1089845,3,72,169,241,0
3_5417462,overcome_abrasion_lubricity_beef_uranus_saturn,5417462,3,71,158,229,0
3_1760814,noop_locale_onion_bavaria,1760814,3,1,1,2,0
3_7969387,noop_craves_achievement_wonderbread,7969387,3,1,1,2,0
3_4565515,noop_orbits_vulcan_uranus,4565515,3,1,1,2,0
3_1419040,succumb_grief_entertainment_haroset_vulcan_uranus,1419040,3,65,158,223,0
3_5601130,succumb_jealousy_entertainment_haroset_vulcan_uranus,5601130,3,67,177,244,0
3_1697991,overcome_depression_expectation_snickers_vulcan_uranus,1697991,3,43,95,138,0
3_1053216,overcome_jealousy_entertainment_haroset_vulcan_uranus,1053216,3,69,171,240,0
3_104711,overcome_laceration_entertainment_lamb_vulcan_uranus,104711,3,122,298,420,0
3_2360333,noop_food_lamb,2360333,3,1,1,2,0
3_5170983,feast_stimulation_lamb_beef_goias_bosnia,5170983,3,81,213,294,0
3_6902405,feast_stimulation_lamb_haroset_goias_bosnia,6902405,3,81,213,294,0
3_4691551,feast_stimulation_beef_lamb_manitoba_pennsylvania,4691551,3,76,175,251,0
3_4147678,feast_entertainment_lamb_beef_goias_bosnia,4147678,3,151,369,520,0
3_6294953,feast_entertainment_lamb_haroset_goias_bosnia,6294953,3,151,369,520,0
3_5680061,feast_lubricity_lamb_beef_goias_bosnia,5680061,3,127,320,447,0
3_3537385,feast_lubricity_lamb_haroset_goias_bosnia,3537385,3,127,320,447,0
3_20887,feast_lubricity_beef_lamb_manitoba_pennsylvania,20887,3,75,164,239,0
3_3348138,overcome_laceration_stimulation_lamb_uranus_saturn,3348138,3,66,158,224,0
3_1477183,noop_food_tofu,1477183,3,1,1,2,0
3_2619566,noop_craves_grief_lobster,2619566,3,14,39,53,0
3_7704846,overcome_grief_aesthetics_lobster_uranus_saturn,7704846,3,51,134,185,0
3_3557753,fears_grief_aesthetics,3557753,3,14,26,40,0
3_6630843,noop_eats_lobster_haroset,6630843,3,1,1,2,0
3_1979204,feast_aesthetics_lobster_haroset_bavaria_manitoba,1979204,3,70,183,253,0
3_6974207,feast_stimulation_lobster_haroset_bavaria_manitoba,6974207,3,150,367,517,0
3_746090,noop_food_flounder,746090,3,1,1,2,0
3_1727003,feast_lubricity_flounder_haroset_manitoba_pennsylvania,1727003,3,138,164,302,0
3_7292320,feast_stimulation_haroset_flounder_bavaria_manitoba,7292320,3,126,318,444,0
3_726895,feast_aesthetics_haroset_flounder_bavaria_manitoba,726895,3,129,314,443,0
3_6997780,feast_entertainment_haroset_flounder_bavaria_manitoba,6997780,3,110,264,374,0
3_3399490,noop_fears_grief_entertainment,3399490,3,33,85,118,0
3_3477531,harmony_entertainment_uranus,3477531,3,15,46,61,0
3_2226900,noop_fears_depression_expectation,2226900,3,32,73,105,0
3_1991938,succumb_depression_expectation_snickers_uranus_saturn,1991938,3,42,95,137,0
3_4700324,craves_depression_snickers,4700324,3,8,10,18,0
3_1891404,harmony_expectation_saturn,1891404,3,13,23,36,0
3_4150653,craves_expectation_wonderbread,4150653,3,7,23,30,0
3_1176899,noop_craves_stimulation_lamb,1176899,3,47,126,173,0
3_564420,noop_planet_earth,564420,3,1,1,2,0
3_928830,noop_harmony_stimulation_saturn,928830,3,32,93,125,0
3_7854623,overcome_jealousy_stimulation_haroset_uranus_saturn,7854623,3,77,189,266,0
3_4280077,noop_fears_dread_expectation,4280077,3,41,83,124,0
3_7299431,noop_locale_wonderbread_bavaria,7299431,3,1,1,2,0
3_6664251,noop_harmony_entertainment_vulcan,6664251,3,22,61,83,0
3_1768600,noop_craves_love_beef,1768600,3,84,211,295,0
3_5865527,noop_locale_ham_goias,5865527,3,53,21,74,0
3_2114526,locale_ham_bosnia,2114526,3,6,16,22,0
3_184342,noop_craves_stimulation_flounder,184342,3,121,315,436,0
3_7835729,noop_craves_aesthetics_bacon,7835729,3,22,73,95,0
3_7476923,feast_aesthetics_bacon_lobster_bavaria_manitoba,7476923,3,39,107,146,0
3_394853,feast_aesthetics_bacon_wonderbread_bavaria_manitoba,394853,3,39,107,146,0
3_7224728,craves_aesthetics_lobster,7224728,3,10,36,46,0
3_4775970,noop_locale_flounder_oregon,4775970,3,18,46,64,0
3_918343,noop_craves_prostatitis_marzipan,918343,3,3,10,13,0
3_7307348,noop_pleasure_expectation,7307348,3,1,1,2,0
3_5483812,succumb_hangover_expectation_okra_uranus_saturn,5483812,3,36,75,111,0
3_5381035,succumb_hangover_expectation_snickers_uranus_saturn,5381035,3,39,78,117,0
3_1923741,feast_expectation_okra_snickers_bavaria_manitoba,1923741,3,33,67,100,0
3_2186495,feast_expectation_okra_wonderbread_bavaria_manitoba,2186495,3,33,67,100,0
3_7618197,feast_expectation_snickers_wonderbread_bavaria_manitoba,7618197,3,54,112,166,0
3_7665601,feast_expectation_snickers_okra_bavaria_manitoba,7665601,3,54,112,166,0
3_7547979,noop_food_wonderbread,7547979,3,1,1,2,0
3_4506403,feast_learning_okra_wonderbread_bavaria_manitoba,4506403,3,54,112,166,0
3_5107816,feast_learning_snickers_wonderbread_bavaria_manitoba,5107816,3,40,78,118,0
3_4769684,noop_harmony_achievement_uranus,4769684,3,18,33,51,0
3_1317946,noop_craves_lubricity_flounder,1317946,3,57,136,193,0
3_4964407,noop_food_cantelope,4964407,3,1,1,2,0
3_5457751,feast_lubricity_lemon_cantelope_bavaria_manitoba,5457751,3,63,142,205,0
3_1001185,feast_stimulation_lemon_cantelope_bavaria_manitoba,1001185,3,117,277,394,0
3_2868790,noop_food_beef,2868790,3,1,1,2,0
3_2330190,feast_lubricity_lemon_beef_bavaria_manitoba,2330190,3,63,142,205,0
3_1351859,feast_stimulation_lemon_beef_bavaria_manitoba,1351859,3,117,277,394,0
3_2098945,noop_eats_flounder_haroset,2098945,3,1,1,2,0
3_5518037,noop_harmony_aesthetics_earth,5518037,3,17,51,68,0
3_2814490,harmony_aesthetics_saturn,2814490,3,14,50,64,0
3_6628497,noop_pain_abrasion,6628497,3,1,1,2,0
3_2475306,noop_craves_expectation_okra,2475306,3,20,51,71,0
3_7692183,noop_locale_lobster_manitoba,7692183,3,46,132,178,0
3_2198537,feast_aesthetics_lobster_bacon_bavaria_manitoba,2198537,3,70,183,253,0
3_2330099,feast_stimulation_lobster_bacon_bavaria_manitoba,2330099,3,150,367,517,0
3_5244493,locale_lobster_bavaria,5244493,3,9,2,11,0
3_6261001,noop_craves_laceration_lamb,6261001,3,12,42,54,0
3_1685356,noop_craves_stimulation_beef,1685356,3,52,131,183,0
3_6256237,noop_eats_okra_snickers,6256237,3,1,1,2,0
3_3471673,feast_learning_okra_snickers_bavaria_manitoba,3471673,3,54,112,166,0
3_6296349,noop_planet_uranus,6296349,3,1,1,2,0
3_6837474,noop_province_pennsylvania,6837474,3,1,1,2,0
3_6650699,noop_food_snickers,6650699,3,1,1,2,0
3_1212556,feast_learning_snickers_okra_bavaria_manitoba,1212556,3,40,78,118,0
3_5497475,noop_locale_haroset_bavaria,5497475,3,14,17,31,0
3_6267138,noop_eats_beef_marzipan,6267138,3,1,1,2,0
3_1640807,noop_province_bavaria,1640807,3,1,1,2,0
3_3663839,noop_pain_angina,3663839,3,1,1,2,0
3_461749,noop_pain_depression,461749,3,1,1,2,0
3_4050227,noop_attacks_oregon_goias,4050227,3,1,1,2,0
3_5410840,noop_craves_depression_snickers,5410840,3,12,41,53,0
3_7242962,noop_eats_lamb_beef,7242962,3,1,1,2,0
3_953650,noop_eats_onion_tofu,953650,3,1,1,2,0
3_3837028,noop_craves_love_ham,3837028,3,84,214,298,0
3_7012217,locale_flounder_oregon,7012217,3,10,17,27,0
3_4476391,noop_fears_abrasion_stimulation,4476391,3,58,121,179,0
3_1803361,craves_abrasion_beef,1803361,3,9,13,22,0
3_4872690,noop_eats_marzipan_tofu,4872690,3,1,1,2,0
3_7594879,noop_pain_hangover,7594879,3,1,1,2,0
3_4329252,noop_fears_sciatica_aesthetics,4329252,3,23,62,85,0
3_3121428,craves_sciatica_bacon,3121428,3,8,13,21,0
3_7550155,noop_craves_learning_okra,7550155,3,28,63,91,0
3_2138506,craves_learning_wonderbread,2138506,3,9,30,39,0
3_6393688,noop_fears_hangover_learning,6393688,3,39,84,123,0
3_2633557,craves_hangover_okra,2633557,3,8,8,16,0
3_7161928,noop_locale_ham_bosnia,7161928,3,14,37,51,0
3_3024551,noop_eats_lamb_haroset,3024551,3,1,1,2,0
3_7076654,noop_pain_anger,7076654,3,1,1,2,0
3_3091627,noop_food_bacon,3091627,3,1,1,2,0
3_2540679,noop_locale_bacon_bavaria,2540679,3,8,10,18,0
3_3013915,noop_locale_lamb_oregon,3013915,3,89,40,129,0
3_4451660,locale_lamb_goias,4451660,3,18,13,31,0
3_1490852,noop_eats_okra_wonderbread,1490852,3,1,1,2,0
3_3694793,noop_harmony_achievement_saturn,3694793,3,5,11,16,0
3_1568911,noop_harmony_love_vulcan,1568911,3,39,73,112,0
3_6343879,noop_craves_learning_onion,6343879,3,28,65,93,0
3_2726012,noop_fears_grief_love,2726012,3,92,241,333,0
3_5659255,noop_eats_snickers_wonderbread,5659255,3,1,1,2,0
3_331103,noop_craves_sciatica_bacon,331103,3,11,37,48,0
3_5602305,noop_craves_aesthetics_lobster,5602305,3,27,86,113,0
3_6074345,noop_fears_jealousy_stimulation,6074345,3,66,153,219,0
3_222734,craves_jealousy_haroset,222734,3,11,18,29,0
3_1981432,noop_eats_tofu_onion,1981432,3,1,1,2,0
3_2791656,noop_planet_vulcan,2791656,3,1,1,2,0
3_2174354,noop_pleasure_learning,2174354,3,1,1,2,0
3_5895206,noop_fears_depression_learning,5895206,3,22,48,70,0
3_5844016,noop_fears_sciatica_entertainment,5844016,3,54,159,213,0
3_1002897,noop_fears_abrasion_lubricity,1002897,3,57,112,169,0
3_7866860,noop_fears_dread_aesthetics,7866860,3,46,116,162,0
3_5254932,noop_locale_lemon_manitoba,5254932,3,53,133,186,0
3_6447545,locale_lemon_bavaria,6447545,3,7,2,9,0
3_4085983,noop_eats_wonderbread_bacon,4085983,3,1,1,2,0
3_2029468,noop_eats_lobster_bacon,2029468,3,1,1,2,0
3_6630041,noop_fears_jealousy_love,6630041,3,51,101,152,0
3_5504547,noop_harmony_lubricity_saturn,5504547,3,37,83,120,0
3_1451630,noop_craves_aesthetics_wonderbread,1451630,3,27,79,106,0
3_3226658,noop_craves_entertainment_lamb,3226658,3,105,261,366,0
3_7973815,harmony_entertainment_vulcan,7973815,3,15,36,51,0
3_5520783,noop_eats_ham_flounder,5520783,3,1,1,2,0
3_2167967,noop_harmony_entertainment_uranus,2167967,3,16,42,58,0
3_6057461,noop_craves_lubricity_lemon,6057461,3,46,119,165,0
3_5221458,noop_planet_saturn,5221458,3,1,1,2,0
3_3418815,noop_pain_prostatitis,3418815,3,1,1,2,0
3_7276459,noop_food_lemon,7276459,3,1,1,2,0
3_325406,noop_craves_expectation_snickers,325406,3,21,52,73,0
3_6264297,noop_eats_marzipan_beef,6264297,3,1,1,2,0
3_2749009,noop_pain_jealousy,2749009,3,1,1,2,0
3_5373533,noop_pain_dread,5373533,3,1,1,2,0
3_5747312,noop_pleasure_achievement,5747312,3,1,1,2,0
3_2616621,noop_province_goias,2616621,3,1,1,2,0
3_67286,noop_pleasure_stimulation,67286,3,1,1,2,0
3_405072,noop_craves_stimulation_haroset,405072,3,52,131,183,0
3_2087401,noop_craves_learning_snickers,2087401,3,24,54,78,0
3_1408559,noop_eats_flounder_ham,1408559,3,1,1,2,0
3_8709,noop_locale_bacon_manitoba,8709,3,29,95,124,0
3_5395676,locale_bacon_bavaria,5395676,3,7,2,9,0
3_6952736,noop_eats_haroset_flounder,6952736,3,1,1,2,0
3_434518,noop_craves_love_haroset,434518,3,45,108,153,0
3_3813846,noop_craves_jealousy_haroset,3813846,3,15,48,63,0
3_7783167,noop_food_haroset,7783167,3,1,1,2,0
3_4856647,noop_locale_haroset_manitoba,4856647,3,81,215,296,0
3_7733722,locale_haroset_bavaria,7733722,3,13,2,15,0
3_1669810,noop_province_manitoba,1669810,3,1,1,2,0
3_1042911,noop_craves_lubricity_lamb,1042911,3,72,140,212,0
3_1191871,noop_eats_cantelope_marzipan,1191871,3,1,1,2,0
3_5199351,noop_eats_bacon_lobster,5199351,3,1,1,2,0
3_5721688,noop_eats_wonderbread_okra,5721688,3,1,1,2,0
3_7735830,noop_locale_cantelope_bavaria,7735830,3,1,1,2,0
3_7007816,noop_pleasure_entertainment,7007816,3,1,1,2,0
3_1318637,noop_food_onion,1318637,3,1,1,2,0
3_353504,noop_craves_stimulation_lemon,353504,3,77,153,230,0
3_5296267,noop_fears_dread_learning,5296267,3,48,94,142,0
3_1581872,noop_eats_marzipan_cantelope,1581872,3,1,1,2,0
3_534272,noop_harmony_lubricity_earth,534272,3,20,66,86,0
3_5342758,noop_food_okra,5342758,3,1,1,2,0
3_7231076,noop_eats_beef_lamb,7231076,3,1,1,2,0
3_7722518,noop_craves_love_flounder,7722518,3,79,207,286,0
3_6517750,noop_fears_anger_love,6517750,3,84,215,299,0
3_7461953,craves_anger_flounder,7461953,3,6,14,20,0
3_3260377,noop_eats_tofu_marzipan,3260377,3,1,1,2,0
3_2484442,noop_pain_laceration,2484442,3,1,1,2,0
3_2533093,noop_fears_anxiety_learning,2533093,3,35,73,108,0
3_3837243,craves_anxiety_onion,3837243,3,5,9,14,0
3_735143,noop_orbits_uranus_saturn,735143,3,1,1,2,0
3_1192067,noop_harmony_aesthetics_saturn,1192067,3,18,73,91,0
3_2287477,noop_locale_flounder_pennsylvania,2287477,3,80,25,105,0
3_6227808,noop_locale_beef_pennsylvania,6227808,3,20,39,59,0
3_1232579,noop_locale_lamb_bosnia,1232579,3,71,201,272,0
3_2832879,noop_eats_lemon_ham,2832879,3,1,1,2,0
3_6935494,noop_pain_loneliness,6935494,3,1,1,2,0
3_1189107,noop_fears_hangover_expectation,1189107,3,20,46,66,0
3_7341957,noop_craves_lubricity_cantelope,7341957,3,55,135,190,0
3_7286596,noop_craves_aesthetics_haroset,7286596,3,65,177,242,0
3_3340809,noop_craves_expectation_onion,3340809,3,49,106,155,0
3_6721758,noop_craves_stimulation_lobster,6721758,3,121,313,434,0
3_6765322,noop_locale_okra_manitoba,6765322,3,23,57,80,0
3_765503,locale_okra_bavaria,765503,3,5,1,6,0
3_3761495,noop_eats_lemon_cantelope,3761495,3,1,1,2,0
3_982246,noop_craves_anxiety_onion,982246,3,6,10,16,0
3_5073604,noop_harmony_love_uranus,5073604,3,20,49,69,0
3_964644,noop_pain_grief,964644,3,1,1,2,0
3_6098876,noop_food_lobster,6098876,3,1,1,2,0
3_6751204,noop_craves_love_lobster,6751204,3,79,208,287,0
3_1551368,noop_craves_lubricity_beef,1551368,3,51,120,171,0
3_3008246,noop_locale_lobster_bavaria,3008246,3,10,10,20,0
3_2622029,noop_craves_entertainment_haroset,2622029,3,44,124,168,0
3_3809309,noop_craves_entertainment_wonderbread,3809309,3,64,175,239,0
3_7656944,noop_craves_entertainment_flounder,7656944,3,105,261,366,0
3_6938998,noop_eats_wonderbread_snickers,6938998,3,1,1,2,0
3_3235111,noop_attacks_bavaria_manitoba,3235111,3,1,1,2,0
3_3551919,noop_craves_angina_ham,3551919,3,6,15,21,0
3_737720,noop_eats_lemon_beef,737720,3,1,1,2,0
3_3295483,noop_eats_snickers_okra,3295483,3,1,1,2,0
3_3676811,noop_harmony_expectation_uranus,3676811,3,15,51,66,0
3_3592548,noop_locale_lemon_bavaria,3592548,3,8,11,19,0
3_5554132,noop_fears_jealousy_entertainment,5554132,3,57,157,214,0
3_556463,noop_locale_snickers_manitoba,556463,3,30,68,98,0
3_2639657,locale_snickers_bavaria,2639657,3,7,2,9,0
3_4634499,noop_locale_marzipan_oregon,4634499,3,9,44,53,0
3_6317512,noop_locale_beef_oregon,6317512,3,45,127,172,0
3_7015491,locale_beef_pennsylvania,7015491,3,19,17,36,0
3_7650497,noop_attacks_manitoba_pennsylvania,7650497,3,1,1,2,0
3_7543600,noop_province_bosnia,7543600,3,1,1,2,0
3_6512278,noop_attacks_goias_bosnia,6512278,3,1,1,2,0
3_2443351,noop_eats_bacon_wonderbread,2443351,3,1,1,2,0
3_3159359,noop_pleasure_aesthetics,3159359,3,1,1,2,0
3_2417187,noop_pleasure_lubricity,2417187,3,1,1,2,0
3_335752,noop_craves_lubricity_ham,335752,3,51,121,172,0
3_6239897,province_bosnia,6239897,3,1,1,2,0
2_6517750,noop_fears_anger_love,6517750,2,0,84,84,0
1_809839,fears_anger_love,809839,1,0,1,1,0
3_7650924,eats_onion_tofu,7650924,3,1,1,2,0
2_1768600,noop_craves_love_beef,1768600,2,0,84,84,0
1_4061666,craves_love_beef,4061666,1,0,7,7,0
2_2226900,noop_fears_depression_expectation,2226900,2,0,32,32,0
1_3536464,fears_depression_expectation,3536464,1,0,1,1,0
2_1421700,succumb_depression_learning_onion_uranus_saturn,1421700,2,7,43,50,0
3_3032587,craves_depression_onion,3032587,3,1,23,24,0
2_6146650,feast_lubricity_marzipan_beef_pennsylvania_oregon,6146650,2,6,76,82,0
1_4422260,craves_lubricity_marzipan,4422260,1,0,5,5,0
3_3534048,locale_marzipan_pennsylvania,3534048,3,8,23,31,0
3_6870746,locale_marzipan_oregon,6870746,3,8,22,30,0
3_4679598,eats_bacon_wonderbread,4679598,3,1,5,6,0
3_1221736,eats_bacon_lobster,1221736,3,1,5,6,0
3_5978126,eats_lamb_haroset,5978126,3,1,24,25,0
2_4691551,feast_stimulation_beef_lamb_manitoba_pennsylvania,4691551,2,6,73,79,0
1_7015491,locale_beef_pennsylvania,7015491,1,0,9,9,0
3_6052961,locale_beef_manitoba,6052961,3,9,17,26,0
2_4295251,feast_stimulation_lemon_ham_bavaria_manitoba,4295251,2,6,114,120,0
1_1141187,craves_stimulation_lemon,1141187,1,0,4,4,0
3_1447385,craves_stimulation_ham,1447385,3,2,47,49,0
3_4281177,eats_okra_wonderbread,4281177,3,1,3,4,0
2_3832902,feast_entertainment_lamb_haroset_oregon_goias,3832902,2,6,119,125,0
1_4849081,craves_entertainment_lamb,4849081,1,0,5,5,0
2_2073452,feast_aesthetics_haroset_lobster_bavaria_manitoba,2073452,2,6,126,132,0
1_908042,craves_aesthetics_haroset,908042,1,0,4,4,0
3_3046200,locale_tofu_manitoba,3046200,3,1,7,8,0
2_13203,noop_fears_angina_lubricity,13203,2,0,57,57,0
1_2249450,fears_angina_lubricity,2249450,1,0,1,1,0
2_1727003,feast_lubricity_flounder_haroset_manitoba_pennsylvania,1727003,2,5,135,140,0
1_3597041,locale_flounder_pennsylvania,3597041,1,0,2,2,0
1_2940369,craves_lubricity_flounder,2940369,1,0,5,5,0
3_5825714,locale_flounder_manitoba,5825714,3,2,63,65,0
3_2072290,craves_lubricity_haroset,2072290,3,5,42,47,0
2_6294953,feast_entertainment_lamb_haroset_goias_bosnia,6294953,2,7,148,155,0
2_1354553,feast_aesthetics_haroset_lamb_bavaria_manitoba,1354553,2,7,126,133,0
3_6427833,craves_aesthetics_lamb,6427833,3,1,77,78,0
2_353504,noop_craves_stimulation_lemon,353504,2,1,77,78,0
3_5127929,pleasure_learning,5127929,3,1,57,58,0
3_1567476,pain_anger,1567476,3,1,45,46,0
3_3344601,craves_loneliness_tofu,3344601,3,1,6,7,0
3_7563751,eats_cantelope_lemon,7563751,3,1,1,2,0
2_1886754,succumb_anxiety_learning_onion_uranus_saturn,1886754,2,6,39,45,0
1_4769340,fears_anxiety_learning,4769340,1,0,1,1,0
2_4440354,feast_stimulation_lamb_haroset_oregon_goias,4440354,2,7,70,77,0
2_1826954,overcome_anger_stimulation_flounder_saturn_earth,1826954,2,8,127,135,0
1_2314717,craves_stimulation_flounder,2314717,1,0,3,3,0
3_6654103,fears_anger_stimulation,6654103,3,1,27,28,0
3_7281678,eats_snickers_wonderbread,7281678,3,1,3,4,0
3_4730552,eats_beef_lemon,4730552,3,1,16,17,0
3_3976229,planet_vulcan,3976229,3,1,171,172,0
2_1321506,noop_fears_grief_aesthetics,1321506,2,0,41,41,0
1_3557753,fears_grief_aesthetics,3557753,1,0,1,1,0
3_3933873,province_bavaria,3933873,3,1,1,2,0
3_4177969,food_cantelope,4177969,3,1,31,32,0
2_3573257,feast_stimulation_marzipan_cantelope_pennsylvania_oregon,3573257,2,6,82,88,0
1_3796608,craves_stimulation_marzipan,3796608,1,0,5,5,0
3_6484069,craves_stimulation_cantelope,6484069,3,2,36,38,0
2_6974207,feast_stimulation_lobster_haroset_bavaria_manitoba,6974207,2,6,147,153,0
1_6011242,craves_stimulation_lobster,6011242,1,0,3,3,0
2_6721758,noop_craves_stimulation_lobster,6721758,2,1,121,122,0
2_6227808,noop_locale_beef_pennsylvania,6227808,2,1,20,21,0
3_6133837,food_okra,6133837,3,1,27,28,0
3_6406031,planet_saturn,6406031,3,1,247,248,0
2_3226658,noop_craves_entertainment_lamb,3226658,2,1,105,106,0
2_6454858,feast_lubricity_marzipan_wonderbread_pennsylvania_oregon,6454858,2,7,77,84,0
3_4947268,craves_lubricity_wonderbread,4947268,3,1,48,49,0
2_3499158,feast_stimulation_lamb_haroset_pennsylvania_oregon,3499158,2,6,122,128,0
1_7037277,locale_lamb_oregon,7037277,1,0,4,4,0
3_7086086,locale_lamb_pennsylvania,7086086,3,4,51,55,0
3_1013998,pleasure_aesthetics,1013998,3,1,145,146,0
2_3809309,noop_craves_entertainment_wonderbread,3809309,2,0,64,64,0
1_7423494,craves_entertainment_wonderbread,7423494,1,0,1,1,0
2_3340809,noop_craves_expectation_onion,3340809,2,0,49,49,0
1_4128492,craves_expectation_onion,4128492,1,0,1,1,0
3_4362134,eats_flounder_ham,4362134,3,1,16,17,0
3_3933582,pain_jealousy,3933582,3,1,98,99,0
3_1767281,food_lemon,1767281,3,1,94,95,0
3_20256,province_oregon,20256,3,1,1,2,0
2_6819309,feast_love_beef_marzipan_manitoba_pennsylvania,6819309,2,7,102,109,0
3_4058429,craves_love_marzipan,4058429,3,2,59,61,0
2_1351859,feast_stimulation_lemon_beef_bavaria_manitoba,1351859,2,7,114,121,0
2_5733459,overcome_prostatitis_stimulation_marzipan_saturn_earth,5733459,2,9,81,90,0
3_5866392,fears_prostatitis_stimulation,5866392,3,1,38,39,0
3_3048718,craves_prostatitis_marzipan,3048718,3,2,11,13,0
2_6994759,overcome_dread_expectation_wonderbread_vulcan_uranus,6994759,2,9,44,53,0
3_7462579,harmony_expectation_vulcan,7462579,3,3,18,21,0
3_4623385,province_manitoba,4623385,3,1,1,2,0
2_7866860,noop_fears_dread_aesthetics,7866860,2,0,46,46,0
1_2102130,fears_dread_aesthetics,2102130,1,0,1,1,0
2_6017560,succumb_grief_entertainment_bacon_vulcan_uranus,6017560,2,7,62,69,0
3_5729757,craves_grief_bacon,5729757,3,1,36,37,0
2_3218010,feast_lubricity_lamb_beef_oregon_goias,3218010,2,6,93,99,0
1_3833236,craves_lubricity_lamb,3833236,1,0,7,7,0
3_4022794,attacks_bavaria_manitoba,4022794,3,1,109,110,0
2_1042911,noop_craves_lubricity_lamb,1042911,2,1,72,73,0
2_2605711,succumb_laceration_stimulation_haroset_saturn_earth,2605711,2,7,71,78,0
3_7814663,craves_laceration_haroset,7814663,3,1,38,39,0
2_4691811,feast_love_beef_lamb_manitoba_pennsylvania,4691811,2,7,102,109,0
2_5680061,feast_lubricity_lamb_beef_goias_bosnia,5680061,2,7,124,131,0
2_975261,overcome_sciatica_love_bacon_vulcan_uranus,975261,2,8,116,124,0
1_4430757,craves_love_bacon,4430757,1,0,3,3,0
3_7954321,fears_sciatica_love,7954321,3,1,54,55,0
2_4087311,overcome_prostatitis_lubricity_marzipan_saturn_earth,4087311,2,9,77,86,0
3_3194470,fears_prostatitis_lubricity,3194470,3,1,37,38,0
2_104711,overcome_laceration_entertainment_lamb_vulcan_uranus,104711,2,9,117,126,0
3_5591775,fears_laceration_entertainment,5591775,3,1,56,57,0
3_601332,pleasure_achievement,601332,3,1,19,20,0
2_2726012,noop_fears_grief_love,2726012,2,0,92,92,0
1_5019078,fears_grief_love,5019078,1,0,1,1,0
3_6456524,eats_lamb_beef,6456524,3,1,24,25,0
3_3715801,orbits_saturn_earth,3715801,3,1,254,255,0
2_1865662,succumb_sciatica_aesthetics_lobster_saturn_earth,1865662,2,7,42,49,0
3_6898824,craves_sciatica_lobster,6898824,3,1,29,30,0
2_3681262,feast_stimulation_beef_marzipan_manitoba_pennsylvania,3681262,2,7,73,80,0
2_5417462,overcome_abrasion_lubricity_beef_uranus_saturn,5417462,2,9,66,75,0
3_7367121,harmony_lubricity_uranus,7367121,3,3,62,65,0
2_3313713,succumb_sciatica_aesthetics_wonderbread_saturn_earth,3313713,2,7,42,49,0
3_6255097,craves_sciatica_wonderbread,6255097,3,1,35,36,0
2_1683363,succumb_hangover_learning_okra_uranus_saturn,1683363,2,6,45,51,0
1_2802576,fears_hangover_learning,2802576,1,0,1,1,0
2_5498213,succumb_grief_love_lobster_vulcan_uranus,5498213,2,7,98,105,0
3_4615811,locale_onion_bavaria,4615811,3,1,1,2,0
2_3992064,overcome_sciatica_aesthetics_bacon_uranus_saturn,3992064,2,9,35,44,0
3_3889381,harmony_aesthetics_uranus,3889381,3,3,37,40,0
2_4706314,overcome_dread_aesthetics_wonderbread_uranus_saturn,4706314,2,9,49,58,0
3_5711881,pain_prostatitis,5711881,3,1,25,26,0
2_3013915,noop_locale_lamb_oregon,3013915,2,1,89,90,0
3_7420512,orbits_vulcan_uranus,7420512,3,1,294,295,0
2_5777515,feast_lubricity_flounder_ham_manitoba_pennsylvania,5777515,2,7,135,142,0
2_5923165,overcome_anger_lubricity_flounder_saturn_earth,5923165,2,9,67,76,0
3_6638384,fears_anger_lubricity,6638384,3,1,32,33,0
3_1243086,pleasure_entertainment,1243086,3,1,120,121,0
2_5844016,noop_fears_sciatica_entertainment,5844016,2,0,54,54,0
1_7153580,fears_sciatica_entertainment,7153580,1,0,1,1,0
2_3700066,succumb_sciatica_entertainment_bacon_vulcan_uranus,3700066,2,7,60,67,0
2_4932716,feast_love_ham_lemon_oregon_goias,4932716,2,5,135,140,0
1_157616,locale_ham_goias,157616,1,0,2,2,0
1_2533325,craves_love_ham,2533325,1,0,5,5,0
3_3895862,locale_ham_oregon,3895862,3,2,61,63,0
3_614612,craves_love_lemon,614612,3,4,48,52,0
2_4151816,overcome_anxiety_learning_onion_vulcan_uranus,4151816,2,9,38,47,0
3_6793985,harmony_learning_vulcan,6793985,3,4,16,20,0
2_5296267,noop_fears_dread_learning,5296267,2,0,48,48,0
1_150287,fears_dread_learning,150287,1,0,1,1,0
3_2380884,food_haroset,2380884,3,1,143,144,0
2_2733167,succumb_dread_learning_wonderbread_uranus_saturn,2733167,2,7,52,59,0
2_7394767,feast_love_ham_lemon_goias_bosnia,7394767,2,7,96,103,0
2_977467,feast_lubricity_lamb_beef_pennsylvania_oregon,977467,2,7,155,162,0
2_3630267,overcome_dread_entertainment_wonderbread_vulcan_uranus,3630267,2,9,81,90,0
3_5623675,fears_dread_entertainment,5623675,3,1,38,39,0
2_561767,overcome_laceration_lubricity_lamb_saturn_earth,561767,2,9,87,96,0
3_5233736,fears_laceration_lubricity,5233736,3,1,42,43,0
3_6052830,eats_lobster_bacon,6052830,3,1,6,7,0
2_5726568,overcome_grief_stimulation_lobster_saturn_earth,5726568,2,9,135,144,0
3_6044426,fears_grief_stimulation,6044426,3,1,64,65,0
3_3135358,eats_snickers_onion,3135358,3,1,3,4,0
2_1984569,succumb_hangover_expectation_wonderbread_uranus_saturn,1984569,2,7,36,43,0
3_4681374,craves_hangover_wonderbread,4681374,3,1,28,29,0
2_1159719,feast_lubricity_flounder_ham_pennsylvania_oregon,1159719,2,7,73,80,0
3_7434994,eats_lemon_beef,7434994,3,1,5,6,0
3_3163114,planet_earth,3163114,3,1,122,123,0
2_6655370,succumb_laceration_stimulation_beef_saturn_earth,6655370,2,7,71,78,0
3_1004728,craves_laceration_beef,1004728,3,1,37,38,0
2_888220,succumb_jealousy_stimulation_haroset_saturn_earth,888220,2,6,73,79,0
1_5363829,fears_jealousy_stimulation,5363829,1,0,1,1,0
2_2718520,feast_stimulation_beef_lemon_manitoba_pennsylvania,2718520,2,7,73,80,0
2_1982870,feast_love_ham_flounder_oregon_goias,1982870,2,7,135,142,0
3_5601736,eats_cantelope_marzipan,5601736,3,1,1,2,0
3_1830183,province_goias,1830183,3,1,1,2,0
2_4444921,feast_love_ham_flounder_goias_bosnia,4444921,2,7,96,103,0
3_5991737,eats_marzipan_cantelope,5991737,3,1,13,14,0
2_7541173,succumb_boils_lubricity_ham_saturn_earth,7541173,2,7,63,70,0
3_7185198,craves_boils_ham,7185198,3,1,32,33,0
2_7854623,overcome_jealousy_stimulation_haroset_uranus_saturn,7854623,2,9,72,81,0
3_1293205,harmony_stimulation_uranus,1293205,3,3,71,74,0
3_1626822,province_pennsylvania,1626822,3,1,1,2,0
2_5020674,succumb_depression_learning_okra_uranus_saturn,5020674,2,7,43,50,0
3_7412205,craves_depression_okra,7412205,3,1,11,12,0
2_614424,feast_lubricity_marzipan_tofu_pennsylvania_oregon,614424,2,7,77,84,0
3_2950086,craves_lubricity_tofu,2950086,3,1,39,40,0
2_7955724,feast_lubricity_lamb_haroset_pennsylvania_oregon,7955724,2,7,155,162,0
2_2575325,succumb_anger_love_flounder_vulcan_uranus,2575325,2,7,90,97,0
2_7529475,overcome_angina_love_ham_vulcan_uranus,7529475,2,9,93,102,0
3_7699444,fears_angina_love,7699444,3,1,42,43,0
2_3948425,overcome_hangover_learning_okra_vulcan_uranus,3948425,2,9,44,53,0
3_696593,food_lobster,696593,3,1,75,76,0
3_6444638,eats_beef_lamb,6444638,3,1,16,17,0
2_7539176,feast_love_beef_marzipan_pennsylvania_oregon,7539176,2,7,125,132,0
2_2287477,noop_locale_flounder_pennsylvania,2287477,2,1,80,81,0
3_7283739,eats_tofu_marzipan,7283739,3,1,4,5,0
3_5583426,food_bacon,5583426,3,1,47,48,0
3_6905224,attacks_oregon_goias,6905224,3,1,21,22,0
2_5865527,noop_locale_ham_goias,5865527,2,1,53,54,0
2_4280077,noop_fears_dread_expectation,4280077,2,0,41,41,0
1_688965,fears_dread_expectation,688965,1,0,1,1,0
3_4569802,eats_haroset_lamb,4569802,3,1,6,7,0
2_1685627,feast_entertainment_lamb_beef_oregon_goias,1685627,2,7,119,126,0
3_5357538,craves_entertainment_beef,5357538,3,2,67,69,0
3_1366298,attacks_goias_bosnia,1366298,3,1,21,22,0
2_3837028,noop_craves_love_ham,3837028,2,1,84,85,0
2_456128,noop_fears_laceration_love,456128,2,0,88,88,0
1_3246453,fears_laceration_love,3246453,1,0,1,1,0
3_918250,pain_boils,918250,3,1,82,83,0
2_2482178,feast_love_bacon_wonderbread_bavaria_manitoba,2482178,2,7,125,132,0
3_7041704,craves_love_wonderbread,7041704,3,1,65,66,0
2_4147678,feast_entertainment_lamb_beef_goias_bosnia,4147678,2,7,148,155,0
2_3575228,overcome_boils_lubricity_lemon_uranus_saturn,3575228,2,9,59,68,0
3_2046441,eats_lemon_ham,2046441,3,1,5,6,0
3_778475,pain_hangover,778475,3,1,57,58,0
3_1840068,food_wonderbread,1840068,3,1,160,161,0
2_6556479,succumb_jealousy_love_flounder_vulcan_uranus,6556479,2,7,97,104,0
3_1511676,craves_jealousy_flounder,1511676,3,1,49,50,0
2_4906729,feast_stimulation_lamb_beef_pennsylvania_oregon,4906729,2,7,122,129,0
3_522536,locale_cantelope_bavaria,522536,3,1,1,2,0
3_2200903,pleasure_love,2200903,3,1,140,141,0
3_4138703,eats_wonderbread_marzipan,4138703,3,1,1,2,0
2_5601130,succumb_jealousy_entertainment_haroset_vulcan_uranus,5601130,2,6,64,70,0
1_6863696,fears_jealousy_entertainment,6863696,1,0,1,1,0
2_2785080,feast_love_beef_lemon_manitoba_pennsylvania,2785080,2,7,102,109,0
2_4704130,feast_stimulation_flounder_ham_pennsylvania_oregon,4704130,2,7,128,135,0
3_6588915,locale_wonderbread_bavaria,6588915,3,1,1,2,0
3_3412554,food_marzipan,3412554,3,1,111,112,0
3_6425404,eats_marzipan_wonderbread,6425404,3,1,13,14,0
3_2289801,eats_haroset_lobster,2289801,3,1,6,7,0
2_1684381,succumb_angina_lubricity_ham_saturn_earth,1684381,2,7,63,70,0
2_3077781,feast_entertainment_flounder_ham_pennsylvania_oregon,3077781,2,6,112,118,0
1_6864294,craves_entertainment_flounder,6864294,1,0,3,3,0
3_2538387,craves_entertainment_ham,2538387,3,1,63,64,0
2_135531,overcome_hangover_expectation_okra_vulcan_uranus,135531,2,9,33,42,0
2_5554132,noop_fears_jealousy_entertainment,5554132,2,1,57,58,0
3_677729,eats_tofu_onion,677729,3,1,4,5,0
2_1477182,noop_craves_love_bacon,1477182,2,1,105,106,0
2_5209032,succumb_boils_lubricity_cantelope_saturn_earth,5209032,2,7,63,70,0
3_2399100,craves_boils_cantelope,2399100,3,1,5,6,0
2_2708932,feast_stimulation_lamb_beef_oregon_goias,2708932,2,7,70,77,0
2_1114632,overcome_dread_learning_wonderbread_vulcan_uranus,1114632,2,9,51,60,0
3_7318845,eats_snickers_okra,7318845,3,1,3,4,0
3_7865332,pain_dread,7865332,3,1,31,32,0
3_473381,eats_ham_flounder,473381,3,1,17,18,0
3_6322230,eats_wonderbread_bacon,6322230,3,1,1,2,0
3_2268262,food_tofu,2268262,3,1,32,33,0
3_3151412,food_lamb,3151412,3,1,139,140,0
2_1666233,noop_craves_stimulation_marzipan,1666233,2,1,77,78,0
2_2027333,feast_love_beef_lemon_pennsylvania_oregon,2027333,2,7,125,132,0
2_4060483,feast_lubricity_beef_marzipan_manitoba_pennsylvania,4060483,2,7,72,79,0
2_1075334,feast_lubricity_lamb_haroset_oregon_goias,1075334,2,7,93,100,0
3_6088560,attacks_pennsylvania_oregon,6088560,3,1,62,63,0
2_5381035,succumb_hangover_expectation_snickers_uranus_saturn,5381035,2,7,36,43,0
3_1750334,craves_hangover_snickers,1750334,3,1,18,19,0
2_3537385,feast_lubricity_lamb_haroset_goias_bosnia,3537385,2,7,124,131,0
2_1001185,feast_stimulation_lemon_cantelope_bavaria_manitoba,1001185,2,7,114,121,0
3_1742084,eats_haroset_flounder,1742084,3,1,6,7,0
3_2922283,pleasure_stimulation,2922283,3,1,261,262,0
3_4985459,pain_sciatica,4985459,3,1,69,70,0
2_7175086,feast_lubricity_beef_lemon_manitoba_pennsylvania,7175086,2,7,72,79,0
3_6440549,pleasure_lubricity,6440549,3,1,227,228,0
3_3810436,food_onion,3810436,3,1,35,36,0
3_2278622,eats_okra_snickers,2278622,3,1,3,4,0
3_5075412,craves_achievement_wonderbread,5075412,3,1,19,20,0
2_2799837,noop_craves_lubricity_marzipan,2799837,2,1,72,73,0
2_20887,feast_lubricity_beef_lamb_manitoba_pennsylvania,20887,2,7,72,79,0
2_6526837,overcome_depression_learning_snickers_vulcan_uranus,6526837,2,9,37,46,0
3_511036,eats_wonderbread_okra,511036,3,1,1,2,0
2_6393688,noop_fears_hangover_learning,6393688,2,1,39,40,0
3_2289523,eats_beef_marzipan,2289523,3,1,16,17,0
2_1991938,succumb_depression_expectation_snickers_uranus_saturn,1991938,2,7,39,46,0
2_53938,succumb_abrasion_stimulation_beef_saturn_earth,53938,2,6,68,74,0
1_3765875,fears_abrasion_stimulation,3765875,1,0,1,1,0
2_1482738,feast_love_bacon_lobster_bavaria_manitoba,1482738,2,7,125,132,0
2_1404488,feast_stimulation_marzipan_beef_pennsylvania_oregon,1404488,2,7,82,89,0
2_7989638,feast_love_beef_lamb_pennsylvania_oregon,7989638,2,7,125,132,0
2_3507238,feast_stimulation_flounder_haroset_pennsylvania_oregon,3507238,2,7,128,135,0
2_5721338,feast_entertainment_flounder_haroset_pennsylvania_oregon,5721338,2,7,112,119,0
2_3348138,overcome_laceration_stimulation_lamb_uranus_saturn,3348138,2,9,61,70,0
3_1486223,pain_angina,1486223,3,1,38,39,0
3_6188452,food_ham,6188452,3,1,102,103,0
3_137551,eats_ham_lemon,137551,3,1,17,18,0
2_5301639,succumb_boils_lubricity_beef_saturn_earth,5301639,2,7,63,70,0
3_2795581,craves_boils_beef,2795581,3,1,33,34,0
2_7783389,succumb_jealousy_love_lobster_vulcan_uranus,7783389,2,7,97,104,0
3_6539420,craves_jealousy_lobster,6539420,3,1,50,51,0
2_3873239,feast_stimulation_marzipan_tofu_pennsylvania_oregon,3873239,2,7,82,89,0
3_4703614,craves_stimulation_tofu,4703614,3,1,38,39,0
3_895075,eats_marzipan_tofu,895075,3,1,13,14,0
3_3659869,food_beef,3659869,3,1,152,153,0
3_1930663,food_flounder,1930663,3,1,121,122,0
3_6634256,eats_onion_snickers,6634256,3,1,1,2,0
2_1419040,succumb_grief_entertainment_haroset_vulcan_uranus,1419040,2,7,62,69,0
3_7158854,craves_grief_haroset,7158854,3,1,36,37,0
2_4576090,feast_lubricity_flounder_haroset_pennsylvania_oregon,4576090,2,7,73,80,0
2_480240,overcome_abrasion_love_beef_vulcan_uranus,480240,2,9,97,106,0
3_7670121,fears_abrasion_love,7670121,3,1,43,44,0
2_4238840,overcome_angina_lubricity_ham_uranus_saturn,4238840,2,9,62,71,0
2_4476391,noop_fears_abrasion_stimulation,4476391,2,1,58,59,0
2_1032191,succumb_dread_aesthetics_wonderbread_saturn_earth,1032191,2,7,50,57,0
2_1697991,overcome_depression_expectation_snickers_vulcan_uranus,1697991,2,9,38,47,0
3_1180739,pain_laceration,1180739,3,1,90,91,0
2_184342,noop_craves_stimulation_flounder,184342,2,1,121,122,0
2_1869492,succumb_dread_expectation_wonderbread_uranus_saturn,1869492,2,7,45,52,0
2_157892,overcome_boils_stimulation_lemon_saturn_earth,157892,2,9,89,98,0
3_5615149,fears_boils_stimulation,5615149,3,1,42,43,0
3_3590140,orbits_uranus_saturn,3590140,3,1,214,215,0
2_2533093,noop_fears_anxiety_learning,2533093,2,1,35,36,0
3_1484863,eats_lobster_haroset,1484863,3,1,6,7,0
3_1370260,pain_anxiety,1370260,3,1,12,13,0
2_817593,overcome_anger_entertainment_flounder_vulcan_uranus,817593,2,9,111,120,0
3_3934647,fears_anger_entertainment,3934647,3,1,53,54,0
2_1221343,overcome_jealousy_aesthetics_haroset_saturn_earth,1221343,2,9,80,89,0
3_7711852,fears_jealousy_aesthetics,7711852,3,1,8,9,0
2_7656944,noop_craves_entertainment_flounder,7656944,2,1,105,106,0
3_3456443,pain_grief,3456443,3,1,82,83,0
3_5631791,pain_loneliness,5631791,3,1,8,9,0
2_6475894,succumb_abrasion_lubricity_beef_saturn_earth,6475894,2,6,67,73,0
1_1790580,fears_abrasion_lubricity,1790580,1,0,1,1,0
2_3304294,feast_lubricity_marzipan_cantelope_pennsylvania_oregon,3304294,2,7,77,84,0
3_6616492,eats_lemon_cantelope,6616492,3,1,5,6,0
2_6074345,noop_fears_jealousy_stimulation,6074345,2,1,66,67,0
3_4889270,eats_flounder_haroset,4889270,3,1,16,17,0
2_7061695,feast_stimulation_marzipan_wonderbread_pennsylvania_oregon,7061695,2,7,82,89,0
3_3955115,craves_stimulation_wonderbread,3955115,3,1,48,49,0
2_726895,feast_aesthetics_haroset_flounder_bavaria_manitoba,726895,2,7,126,133,0
3_929030,craves_aesthetics_flounder,929030,3,1,73,74,0
2_1089845,overcome_abrasion_stimulation_beef_uranus_saturn,1089845,2,9,67,76,0
2_7286596,noop_craves_aesthetics_haroset,7286596,2,1,65,66,0
2_1317946,noop_craves_lubricity_flounder,1317946,2,1,57,58,0
2_7142696,succumb_depression_learning_wonderbread_uranus_saturn,7142696,2,7,43,50,0
3_4561120,craves_depression_wonderbread,4561120,3,1,32,33,0
2_7704846,overcome_grief_aesthetics_lobster_uranus_saturn,7704846,2,9,46,55,0
3_6857847,attacks_manitoba_pennsylvania,6857847,3,1,54,55,0
3_2286682,eats_marzipan_beef,2286682,3,1,13,14,0
2_1002897,noop_fears_abrasion_lubricity,1002897,2,1,57,58,0
3_7813070,pain_abrasion,7813070,3,1,73,74,0
3_560444,eats_wonderbread_snickers,560444,3,1,1,2,0
3_2161368,pleasure_expectation,2161368,3,1,60,61,0
2_7512148,succumb_laceration_love_lamb_vulcan_uranus,7512148,2,7,96,103,0
3_7159023,pain_depression,7159023,3,1,63,64,0
3_7835272,food_snickers,7835272,3,1,29,30,0
3_7480922,planet_uranus,7480922,3,1,296,297,0
2_839449,succumb_grief_aesthetics_lobster_saturn_earth,839449,2,7,47,54,0
2_1906499,succumb_jealousy_love_lamb_vulcan_uranus,1906499,2,7,97,104,0
3_6110440,craves_jealousy_lamb,6110440,3,1,51,52,0
2_2330099,feast_stimulation_lobster_bacon_bavaria_manitoba,2330099,2,7,147,154,0
3_4957332,craves_stimulation_bacon,4957332,3,1,75,76,0
2_4815849,overcome_anxiety_expectation_onion_uranus_saturn,4815849,2,9,54,63,0
3_3682892,fears_anxiety_expectation,3682892,3,1,25,26,0
4_162853,noop_craves_boils_cantelope,162853,4,146,341,487,0
4_4527235,overcome_boils_stimulation_cantelope_saturn_earth,4527235,4,298,624,922,0
4_1578989,overcome_boils_lubricity_cantelope_saturn_earth,1578989,4,155,345,500,0
4_3190749,craves_lubricity_ham,3190749,4,25,74,99,0
4_5615149,fears_boils_stimulation,5615149,4,42,55,97,0
4_7185198,craves_boils_ham,7185198,4,30,48,78,0
4_4341693,craves_lubricity_beef,4341693,4,34,73,107,0
4_2072290,craves_lubricity_haroset,2072290,4,30,70,100,0
4_3833236,craves_lubricity_lamb,3833236,4,32,82,114,0
4_5233736,fears_laceration_lubricity,5233736,4,42,58,100,0
4_2950086,craves_lubricity_tofu,2950086,4,34,60,94,0
4_6638384,fears_anger_lubricity,6638384,4,29,56,85,0
4_292731,craves_lubricity_lemon,292731,4,25,66,91,0
4_2795581,craves_boils_beef,2795581,4,32,46,78,0
4_1790580,fears_abrasion_lubricity,1790580,4,29,54,83,0
4_44280,locale_lemon_manitoba,44280,4,29,50,79,0
4_6292230,harmony_lubricity_saturn,6292230,4,62,150,212,0
4_7367121,harmony_lubricity_uranus,7367121,4,37,141,178,0
4_3194470,fears_prostatitis_lubricity,3194470,4,33,55,88,0
4_2940369,craves_lubricity_flounder,2940369,4,27,75,102,0
4_4947268,craves_lubricity_wonderbread,4947268,4,32,78,110,0
4_5825714,locale_flounder_manitoba,5825714,4,65,15,80,0
4_3895862,locale_ham_oregon,3895862,4,63,12,75,0
4_4422260,craves_lubricity_marzipan,4422260,4,32,73,105,0
4_4536909,craves_boils_lemon,4536909,4,14,20,34,0
4_5022204,fears_boils_lubricity,5022204,4,29,49,78,0
4_2249450,fears_angina_lubricity,2249450,4,28,17,45,0
4_6427428,noop_pain_boils,6427428,4,1,1,2,0
4_1029536,succumb_boils_lubricity_marzipan_saturn_earth,1029536,4,162,356,518,0
4_1092529,succumb_boils_lubricity_flounder_saturn_earth,1092529,4,158,339,497,0
4_2643728,succumb_boils_lubricity_lemon_uranus_saturn,2643728,4,144,333,477,0
4_5087272,succumb_boils_lubricity_lemon_saturn_earth,5087272,4,143,324,467,0
4_5372234,succumb_boils_lubricity_lamb_saturn_earth,5372234,4,162,342,504,0
4_5209032,succumb_boils_lubricity_cantelope_saturn_earth,5209032,4,153,343,496,0
4_1514841,succumb_boils_lubricity_beef_uranus_saturn,1514841,4,152,342,494,0
4_5301639,succumb_boils_lubricity_beef_saturn_earth,5301639,4,152,342,494,0
4_6766178,succumb_boils_lubricity_ham_uranus_saturn,6766178,4,152,343,495,0
4_7541173,succumb_boils_lubricity_ham_saturn_earth,7541173,4,151,343,494,0
4_1723202,succumb_boils_stimulation_lemon_saturn_earth,1723202,4,221,385,606,0
4_5027470,overcome_boils_love_lemon_vulcan_uranus,5027470,4,250,510,760,0
4_5527085,overcome_boils_love_beef_vulcan_uranus,5527085,4,341,642,983,0
4_7096833,overcome_boils_love_ham_vulcan_uranus,7096833,4,348,668,1016,0
4_157892,overcome_boils_stimulation_lemon_saturn_earth,157892,4,196,379,575,0
4_4876814,overcome_boils_stimulation_lemon_uranus_saturn,4876814,4,194,385,579,0
4_415833,overcome_boils_stimulation_beef_vulcan_uranus,415833,4,276,551,827,0
4_6407521,overcome_boils_stimulation_beef_saturn_earth,6407521,4,274,552,826,0
4_4586438,overcome_boils_stimulation_beef_uranus_saturn,4586438,4,276,551,827,0
4_1732283,overcome_boils_stimulation_ham_saturn_earth,1732283,4,286,580,866,0
4_291644,overcome_boils_entertainment_beef_vulcan_uranus,291644,4,391,744,1135,0
4_106781,overcome_boils_entertainment_ham_vulcan_uranus,106781,4,395,778,1173,0
4_7405600,overcome_boils_lubricity_lemon_vulcan_uranus,7405600,4,146,333,479,0
4_3575228,overcome_boils_lubricity_lemon_uranus_saturn,3575228,4,145,323,468,0
4_5715987,overcome_boils_lubricity_lemon_saturn_earth,5715987,4,147,323,470,0
4_5460364,overcome_boils_lubricity_beef_saturn_earth,5460364,4,155,344,499,0
4_7885585,overcome_boils_lubricity_ham_saturn_earth,7885585,4,155,344,499,0
4_191203,noop_locale_tofu_manitoba,191203,4,5,16,21,0
4_3834623,feast_stimulation_tofu_onion_bavaria_manitoba,3834623,4,196,353,549,0
4_7592181,feast_stimulation_tofu_marzipan_bavaria_manitoba,7592181,4,196,353,549,0
4_4812954,feast_lubricity_tofu_onion_bavaria_manitoba,4812954,4,181,358,539,0
4_1823234,feast_lubricity_tofu_marzipan_bavaria_manitoba,1823234,4,181,358,539,0
4_13203,noop_fears_angina_lubricity,13203,4,125,238,363,0
4_1518391,succumb_angina_lubricity_flounder_saturn_earth,1518391,4,159,328,487,0
4_810747,succumb_angina_lubricity_lemon_uranus_saturn,810747,4,152,340,492,0
4_5236381,succumb_angina_lubricity_lemon_saturn_earth,5236381,4,152,330,482,0
4_3610125,succumb_angina_lubricity_ham_uranus_saturn,3610125,4,152,339,491,0
4_1684381,succumb_angina_lubricity_ham_saturn_earth,1684381,4,152,329,481,0
4_7699444,fears_angina_love,7699444,4,40,67,107,0
4_4944137,harmony_lubricity_earth,4944137,4,45,86,131,0
4_6631441,craves_lubricity_cantelope,6631441,4,23,55,78,0
4_6505494,craves_angina_ham,6505494,4,11,17,28,0
4_2399100,craves_boils_cantelope,2399100,4,27,32,59,0
4_5888813,noop_harmony_learning_uranus,5888813,4,54,54,108,0
4_2530816,succumb_hangover_learning_wonderbread_uranus_saturn,2530816,4,105,137,242,0
4_1683363,succumb_hangover_learning_okra_uranus_saturn,1683363,4,105,154,259,0
4_3306552,succumb_hangover_learning_snickers_uranus_saturn,3306552,4,105,144,249,0
4_7142696,succumb_depression_learning_wonderbread_uranus_saturn,7142696,4,91,137,228,0
4_5020674,succumb_depression_learning_okra_uranus_saturn,5020674,4,92,139,231,0
4_1421700,succumb_depression_learning_onion_uranus_saturn,1421700,4,92,139,231,0
4_2660153,succumb_depression_learning_snickers_uranus_saturn,2660153,4,82,122,204,0
4_2733167,succumb_dread_learning_wonderbread_uranus_saturn,2733167,4,106,129,235,0
4_1886754,succumb_anxiety_learning_onion_uranus_saturn,1886754,4,83,109,192,0
4_3304289,overcome_sciatica_learning_wonderbread_vulcan_uranus,3304289,4,187,308,495,0
4_4151816,overcome_anxiety_learning_onion_vulcan_uranus,4151816,4,85,109,194,0
4_6526837,overcome_depression_learning_snickers_vulcan_uranus,6526837,4,84,122,206,0
4_3948425,overcome_hangover_learning_okra_vulcan_uranus,3948425,4,107,154,261,0
4_7656083,overcome_hangover_learning_wonderbread_vulcan_uranus,7656083,4,127,137,264,0
4_1688017,overcome_hangover_learning_snickers_vulcan_uranus,1688017,4,125,139,264,0
4_1114632,overcome_dread_learning_wonderbread_vulcan_uranus,1114632,4,107,129,236,0
4_3032587,craves_depression_onion,3032587,4,20,31,51,0
4_6793985,harmony_learning_vulcan,6793985,4,21,21,42,0
4_4561120,craves_depression_wonderbread,4561120,4,32,34,66,0
4_7412205,craves_depression_okra,7412205,4,23,21,44,0
4_1222810,harmony_learning_saturn,1222810,4,25,30,55,0
4_1108354,noop_craves_loneliness_tofu,1108354,4,3,10,13,0
4_5218222,overcome_loneliness_stimulation_tofu_saturn_earth,5218222,4,198,352,550,0
4_4467745,overcome_loneliness_lubricity_tofu_saturn_earth,4467745,4,183,357,540,0
4_4708754,noop_eats_cantelope_lemon,4708754,4,1,1,2,0
4_923989,noop_eats_ham_lemon,923989,4,1,1,2,0
4_4932716,feast_love_ham_lemon_oregon_goias,4932716,4,235,435,670,0
4_7394767,feast_love_ham_lemon_goias_bosnia,7394767,4,245,452,697,0
4_2625063,feast_stimulation_ham_lemon_oregon_goias,2625063,4,183,346,529,0
4_5087114,feast_stimulation_ham_lemon_goias_bosnia,5087114,4,196,364,560,0
4_1601758,feast_entertainment_ham_lemon_oregon_goias,1601758,4,288,558,846,0
4_4063809,feast_entertainment_ham_lemon_goias_bosnia,4063809,4,297,574,871,0
4_1110459,feast_lubricity_ham_lemon_pennsylvania_oregon,1110459,4,344,338,682,0
4_3134141,feast_lubricity_ham_lemon_oregon_goias,3134141,4,150,338,488,0
4_5596192,feast_lubricity_ham_lemon_goias_bosnia,5596192,4,153,340,493,0
4_7435781,noop_eats_haroset_lobster,7435781,4,1,1,2,0
4_7068455,feast_stimulation_haroset_lobster_bavaria_manitoba,7068455,4,321,668,989,0
4_7135015,feast_love_haroset_lobster_bavaria_manitoba,7135015,4,226,447,673,0
4_3524044,feast_lubricity_haroset_lobster_bavaria_manitoba,3524044,4,340,684,1024,0
4_2073452,feast_aesthetics_haroset_lobster_bavaria_manitoba,2073452,4,317,592,909,0
4_5442106,feast_entertainment_haroset_lobster_bavaria_manitoba,5442106,4,267,518,785,0
4_5861162,noop_orbits_saturn_earth,5861162,4,1,1,2,0
4_6670250,succumb_jealousy_aesthetics_haroset_saturn_earth,6670250,4,228,468,696,0
4_3004630,succumb_anger_stimulation_flounder_saturn_earth,3004630,4,335,705,1040,0
4_1927425,succumb_grief_aesthetics_bacon_saturn_earth,1927425,4,137,280,417,0
4_839449,succumb_grief_aesthetics_lobster_saturn_earth,839449,4,137,291,428,0
4_105909,succumb_grief_aesthetics_haroset_saturn_earth,105909,4,205,412,617,0
4_5433039,succumb_laceration_stimulation_marzipan_saturn_earth,5433039,4,181,377,558,0
4_6725965,succumb_laceration_stimulation_lamb_saturn_earth,6725965,4,161,355,516,0
4_5496032,succumb_laceration_stimulation_flounder_saturn_earth,5496032,4,334,373,707,0
4_6655370,succumb_laceration_stimulation_beef_saturn_earth,6655370,4,171,362,533,0
4_2605711,succumb_laceration_stimulation_haroset_saturn_earth,2605711,4,171,362,533,0
4_7600397,succumb_laceration_stimulation_lemon_saturn_earth,7600397,4,181,364,545,0
4_3339251,succumb_laceration_stimulation_lobster_saturn_earth,3339251,4,334,705,1039,0
4_2792416,succumb_prostatitis_lubricity_marzipan_saturn_earth,2792416,4,184,354,538,0
4_1221666,succumb_sciatica_aesthetics_bacon_saturn_earth,1221666,4,102,221,323,0
4_1865662,succumb_sciatica_aesthetics_lobster_saturn_earth,1865662,4,120,257,377,0
4_3313713,succumb_sciatica_aesthetics_wonderbread_saturn_earth,3313713,4,120,256,376,0
4_1132122,succumb_sciatica_aesthetics_haroset_saturn_earth,1132122,4,194,403,597,0
4_5978109,succumb_abrasion_stimulation_marzipan_saturn_earth,5978109,4,182,383,565,0
4_124533,succumb_abrasion_stimulation_lamb_saturn_earth,124533,4,172,370,542,0
4_53938,succumb_abrasion_stimulation_beef_saturn_earth,53938,4,172,368,540,0
4_5839952,succumb_abrasion_stimulation_lemon_saturn_earth,5839952,4,182,370,552,0
4_1355634,succumb_grief_stimulation_lobster_saturn_earth,1355634,4,355,728,1083,0
4_7354400,succumb_jealousy_stimulation_lamb_saturn_earth,7354400,4,192,387,579,0
4_5872071,succumb_jealousy_stimulation_flounder_saturn_earth,5872071,4,342,405,747,0
4_888220,succumb_jealousy_stimulation_haroset_saturn_earth,888220,4,192,394,586,0
4_1621760,succumb_jealousy_stimulation_lobster_saturn_earth,1621760,4,342,709,1051,0
4_1032191,succumb_dread_aesthetics_wonderbread_saturn_earth,1032191,4,130,240,370,0
4_6789549,succumb_abrasion_lubricity_marzipan_saturn_earth,6789549,4,171,380,551,0
4_1659426,succumb_abrasion_lubricity_lemon_saturn_earth,1659426,4,161,368,529,0
4_6546489,succumb_abrasion_lubricity_lamb_saturn_earth,6546489,4,171,366,537,0
4_6475894,succumb_abrasion_lubricity_beef_saturn_earth,6475894,4,161,366,527,0
4_6593675,succumb_anger_lubricity_flounder_saturn_earth,6593675,4,167,371,538,0
4_4191810,succumb_laceration_lubricity_lamb_saturn_earth,4191810,4,214,391,605,0
4_1856801,succumb_prostatitis_stimulation_marzipan_saturn_earth,1856801,4,199,350,549,0
4_5284704,overcome_sciatica_stimulation_lobster_saturn_earth,5284704,4,405,754,1159,0
4_1221474,overcome_sciatica_stimulation_bacon_saturn_earth,1221474,4,398,816,1214,0
4_6192364,overcome_sciatica_stimulation_wonderbread_saturn_earth,6192364,4,297,519,816,0
4_4417732,overcome_sciatica_aesthetics_lobster_saturn_earth,4417732,4,123,258,381,0
4_5592600,overcome_sciatica_aesthetics_bacon_saturn_earth,5592600,4,105,221,326,0
4_6766776,overcome_sciatica_aesthetics_wonderbread_saturn_earth,6766776,4,123,258,381,0
4_1650517,overcome_sciatica_lubricity_wonderbread_saturn_earth,1650517,4,291,554,845,0
4_4424872,overcome_abrasion_stimulation_beef_saturn_earth,4424872,4,169,370,539,0
4_4910584,overcome_abrasion_lubricity_beef_saturn_earth,4910584,4,158,368,526,0
4_3557683,overcome_depression_stimulation_wonderbread_saturn_earth,3557683,4,278,401,679,0
4_2037158,overcome_depression_aesthetics_wonderbread_saturn_earth,2037158,4,183,285,468,0
4_5194977,overcome_depression_lubricity_wonderbread_saturn_earth,5194977,4,263,432,695,0
4_2184177,overcome_angina_stimulation_ham_saturn_earth,2184177,4,185,357,542,0
4_1843106,overcome_angina_lubricity_ham_saturn_earth,1843106,4,147,330,477,0
4_2537806,overcome_hangover_stimulation_wonderbread_saturn_earth,2537806,4,267,394,661,0
4_689260,overcome_hangover_aesthetics_wonderbread_saturn_earth,689260,4,172,277,449,0
4_6002311,overcome_hangover_lubricity_wonderbread_saturn_earth,6002311,4,252,425,677,0
4_1826954,overcome_anger_stimulation_flounder_saturn_earth,1826954,4,337,363,700,0
4_3281138,overcome_anger_aesthetics_flounder_saturn_earth,3281138,4,327,638,965,0
4_5923165,overcome_anger_lubricity_flounder_saturn_earth,5923165,4,169,334,503,0
4_5733459,overcome_prostatitis_stimulation_marzipan_saturn_earth,5733459,4,176,344,520,0
4_4087311,overcome_prostatitis_lubricity_marzipan_saturn_earth,4087311,4,165,338,503,0
4_2353707,overcome_dread_stimulation_wonderbread_saturn_earth,2353707,4,225,359,584,0
4_6282974,overcome_dread_aesthetics_wonderbread_saturn_earth,6282974,4,125,242,367,0
4_7461837,overcome_dread_lubricity_wonderbread_saturn_earth,7461837,4,210,390,600,0
4_6139003,overcome_jealousy_stimulation_haroset_saturn_earth,6139003,4,189,396,585,0
4_3724357,overcome_jealousy_stimulation_lamb_saturn_earth,3724357,4,337,387,724,0
4_1954883,overcome_jealousy_aesthetics_lobster_saturn_earth,1954883,4,311,433,744,0
4_1221343,overcome_jealousy_aesthetics_haroset_saturn_earth,1221343,4,230,458,688,0
4_109407,overcome_jealousy_lubricity_flounder_saturn_earth,109407,4,362,687,1049,0
4_115618,overcome_jealousy_lubricity_haroset_saturn_earth,115618,4,188,411,599,0
4_6896196,overcome_jealousy_lubricity_lamb_saturn_earth,6896196,4,361,434,795,0
4_3900606,overcome_laceration_stimulation_haroset_saturn_earth,3900606,4,179,364,543,0
4_1277058,overcome_laceration_stimulation_lamb_saturn_earth,1277058,4,165,355,520,0
4_1206463,overcome_laceration_stimulation_beef_saturn_earth,1206463,4,179,364,543,0
4_2619021,overcome_laceration_aesthetics_haroset_saturn_earth,2619021,4,338,464,802,0
4_6689142,overcome_laceration_aesthetics_lamb_saturn_earth,6689142,4,348,685,1033,0
4_5684257,overcome_laceration_lubricity_haroset_saturn_earth,5684257,4,290,416,706,0
4_561767,overcome_laceration_lubricity_lamb_saturn_earth,561767,4,193,384,577,0
4_491172,overcome_laceration_lubricity_beef_saturn_earth,491172,4,285,435,720,0
4_4993028,overcome_grief_stimulation_haroset_saturn_earth,4993028,4,285,521,806,0
4_5726568,overcome_grief_stimulation_lobster_saturn_earth,5726568,4,357,721,1078,0
4_2858925,overcome_grief_aesthetics_bacon_saturn_earth,2858925,4,206,267,473,0
4_168939,overcome_grief_aesthetics_lobster_saturn_earth,168939,4,135,292,427,0
4_6859466,overcome_grief_lubricity_haroset_saturn_earth,6859466,4,291,529,820,0
4_6089429,noop_fears_jealousy_aesthetics,6089429,4,217,373,590,0
4_3934647,fears_anger_entertainment,3934647,4,51,79,130,0
4_6255097,craves_sciatica_wonderbread,6255097,4,31,50,81,0
4_6863696,fears_jealousy_entertainment,6863696,4,33,48,81,0
4_7423494,craves_entertainment_wonderbread,7423494,4,29,63,92,0
4_6864294,craves_entertainment_flounder,6864294,4,51,84,135,0
4_3931593,craves_entertainment_haroset,3931593,4,30,50,80,0
4_6110440,craves_jealousy_lamb,6110440,4,50,28,78,0
4_5357538,craves_entertainment_beef,5357538,4,61,91,152,0
4_2538387,craves_entertainment_ham,2538387,4,55,91,146,0
4_2799034,locale_bacon_manitoba,2799034,4,22,38,60,0
4_222734,craves_jealousy_haroset,222734,4,20,23,43,0
4_6427833,craves_aesthetics_lamb,6427833,4,63,126,189,0
4_4957332,craves_stimulation_bacon,4957332,4,67,119,186,0
4_4849081,craves_entertainment_lamb,4849081,4,54,87,141,0
4_3889381,harmony_aesthetics_uranus,3889381,4,30,80,110,0
4_7153580,fears_sciatica_entertainment,7153580,4,31,47,78,0
4_2102130,fears_dread_aesthetics,2102130,4,24,32,56,0
4_4484680,fears_jealousy_love,4484680,4,29,41,70,0
4_658980,craves_aesthetics_wonderbread,658980,4,13,67,80,0
4_929030,craves_aesthetics_flounder,929030,4,61,127,188,0
4_5363829,fears_jealousy_stimulation,5363829,4,36,54,90,0
4_7224728,craves_aesthetics_lobster,7224728,4,16,54,70,0
4_1511676,craves_jealousy_flounder,1511676,4,46,68,114,0
4_5951675,fears_sciatica_aesthetics,5951675,4,21,33,54,0
4_5591775,fears_laceration_entertainment,5591775,4,56,56,112,0
4_5623675,fears_dread_entertainment,5623675,4,38,65,103,0
4_6898824,craves_sciatica_lobster,6898824,4,27,36,63,0
4_4101071,locale_lobster_manitoba,4101071,4,31,46,77,0
4_7954321,fears_sciatica_love,7954321,4,54,76,130,0
4_6305720,harmony_aesthetics_earth,6305720,4,28,67,95,0
4_6539420,craves_jealousy_lobster,6539420,4,48,43,91,0
4_4244617,craves_aesthetics_bacon,4244617,4,12,42,54,0
4_4430757,craves_love_bacon,4430757,4,47,76,123,0
4_5729757,craves_grief_bacon,5729757,4,36,34,70,0
4_132955,craves_entertainment_bacon,132955,4,24,45,69,0
4_7041704,craves_love_wonderbread,7041704,4,58,69,127,0
4_7158854,craves_grief_haroset,7158854,4,37,41,78,0
4_3557753,fears_grief_aesthetics,3557753,4,29,47,76,0
4_1903589,noop_food_ham,1903589,4,1,1,2,0
4_5324389,succumb_jealousy_love_ham_vulcan_uranus,5324389,4,247,494,741,0
4_1978464,succumb_anger_love_ham_vulcan_uranus,1978464,4,235,455,690,0
4_5531991,succumb_angina_love_ham_vulcan_uranus,5531991,4,240,483,723,0
4_4815740,feast_love_lemon_ham_bavaria_manitoba,4815740,4,335,677,1012,0
4_4704130,feast_stimulation_flounder_ham_pennsylvania_oregon,4704130,4,332,386,718,0
4_7932547,feast_stimulation_flounder_ham_manitoba_pennsylvania,7932547,4,332,348,680,0
4_1159719,feast_lubricity_flounder_ham_pennsylvania_oregon,1159719,4,180,358,538,0
4_5777515,feast_lubricity_flounder_ham_manitoba_pennsylvania,5777515,4,167,319,486,0
4_1982870,feast_love_ham_flounder_oregon_goias,1982870,4,235,435,670,0
4_4444921,feast_love_ham_flounder_goias_bosnia,4444921,4,245,452,697,0
4_7710104,feast_aesthetics_flounder_ham_pennsylvania_oregon,7710104,4,326,637,963,0
4_7388917,feast_aesthetics_flounder_ham_manitoba_pennsylvania,7388917,4,326,637,963,0
4_6955647,feast_lubricity_lemon_ham_bavaria_manitoba,6955647,4,145,324,469,0
4_761938,feast_stimulation_ham_flounder_oregon_goias,761938,4,183,346,529,0
4_3223989,feast_stimulation_ham_flounder_goias_bosnia,3223989,4,196,364,560,0
4_154486,feast_entertainment_ham_flounder_oregon_goias,154486,4,288,558,846,0
4_2616537,feast_entertainment_ham_flounder_goias_bosnia,2616537,4,297,574,871,0
4_4295251,feast_stimulation_lemon_ham_bavaria_manitoba,4295251,4,280,586,866,0
4_7097700,feast_love_flounder_ham_bavaria_manitoba,7097700,4,342,453,795,0
4_4770690,feast_love_flounder_ham_pennsylvania_oregon,4770690,4,227,455,682,0
4_1475265,feast_love_flounder_ham_manitoba_pennsylvania,1475265,4,224,453,677,0
4_3077781,feast_entertainment_flounder_ham_pennsylvania_oregon,3077781,4,277,526,803,0
4_4539100,feast_entertainment_flounder_ham_manitoba_pennsylvania,4539100,4,277,526,803,0
4_3806225,feast_lubricity_ham_flounder_pennsylvania_oregon,3806225,4,344,338,682,0
4_5397895,feast_lubricity_ham_flounder_oregon_goias,5397895,4,150,338,488,0
4_7859946,feast_lubricity_ham_flounder_goias_bosnia,7859946,4,153,340,493,0
4_7529475,overcome_angina_love_ham_vulcan_uranus,7529475,4,242,452,694,0
4_5574087,overcome_angina_entertainment_ham_vulcan_uranus,5574087,4,291,577,868,0
4_68235,overcome_angina_lubricity_ham_vulcan_uranus,68235,4,154,339,493,0
4_4238840,overcome_angina_lubricity_ham_uranus_saturn,4238840,4,153,329,482,0
4_6034255,noop_eats_beef_lemon,6034255,4,1,1,2,0
4_6870948,feast_love_beef_lemon_bavaria_manitoba,6870948,4,244,455,699,0
4_2785080,feast_love_beef_lemon_manitoba_pennsylvania,2785080,4,244,455,699,0
4_2027333,feast_love_beef_lemon_pennsylvania_oregon,2027333,4,318,601,919,0
4_1641396,feast_stimulation_beef_lemon_bavaria_manitoba,1641396,4,178,354,532,0
4_2718520,feast_stimulation_beef_lemon_manitoba_pennsylvania,2718520,4,178,354,532,0
4_152103,feast_stimulation_beef_lemon_pennsylvania_oregon,152103,4,228,474,702,0
4_4528676,feast_entertainment_beef_lemon_bavaria_manitoba,4528676,4,301,565,866,0
4_1092171,feast_entertainment_beef_lemon_manitoba_pennsylvania,1092171,4,301,565,866,0
4_5289058,feast_entertainment_beef_lemon_pennsylvania_oregon,5289058,4,373,709,1082,0
4_2619727,feast_lubricity_beef_lemon_bavaria_manitoba,2619727,4,167,350,517,0
4_7175086,feast_lubricity_beef_lemon_manitoba_pennsylvania,7175086,4,167,350,517,0
4_2384133,feast_lubricity_beef_lemon_pennsylvania_oregon,2384133,4,210,456,666,0
4_1616227,noop_eats_haroset_lamb,1616227,4,1,1,2,0
4_3042773,feast_stimulation_haroset_lamb_bavaria_manitoba,3042773,4,321,668,989,0
4_5112850,feast_love_haroset_lamb_bavaria_manitoba,5112850,4,226,447,673,0
4_7114488,feast_lubricity_haroset_lamb_bavaria_manitoba,7114488,4,340,684,1024,0
4_1354553,feast_aesthetics_haroset_lamb_bavaria_manitoba,1354553,4,317,592,909,0
4_718803,feast_entertainment_haroset_lamb_bavaria_manitoba,718803,4,267,518,785,0
4_937738,noop_craves_entertainment_lobster,937738,4,79,156,235,0
4_5182809,succumb_grief_entertainment_lobster_vulcan_uranus,5182809,4,114,221,335,0
4_441439,succumb_sciatica_entertainment_lobster_vulcan_uranus,441439,4,170,313,483,0
4_1363922,succumb_jealousy_entertainment_lobster_vulcan_uranus,1363922,4,180,341,521,0
4_5347858,feast_entertainment_lobster_haroset_bavaria_manitoba,5347858,4,143,302,445,0
4_7467054,feast_entertainment_lobster_bacon_bavaria_manitoba,7467054,4,143,302,445,0
4_3894502,overcome_sciatica_entertainment_lobster_vulcan_uranus,3894502,4,189,311,500,0
4_4816985,overcome_jealousy_entertainment_lobster_vulcan_uranus,4816985,4,280,341,621,0
4_2432615,overcome_grief_entertainment_lobster_vulcan_uranus,2432615,4,116,221,337,0
4_2244238,noop_fears_anger_stimulation,2244238,4,324,664,988,0
4_4605843,craves_love_lobster,4605843,4,37,63,100,0
4_6011242,craves_stimulation_lobster,6011242,4,53,105,158,0
4_5866392,fears_prostatitis_stimulation,5866392,4,33,49,82,0
4_5255941,locale_lamb_bosnia,5255941,4,36,52,88,0
4_809839,fears_anger_love,809839,4,40,60,100,0
4_2576538,craves_love_flounder,2576538,4,40,69,109,0
4_1141187,craves_stimulation_lemon,1141187,4,28,70,98,0
4_7086086,locale_lamb_pennsylvania,7086086,4,56,15,71,0
4_1265535,locale_haroset_manitoba,1265535,4,50,68,118,0
4_1447385,craves_stimulation_ham,1447385,4,33,66,99,0
4_7695533,craves_stimulation_haroset,7695533,4,28,71,99,0
4_4058429,craves_love_marzipan,4058429,4,49,76,125,0
4_5019078,fears_grief_love,5019078,4,44,58,102,0
4_1004728,craves_laceration_beef,1004728,4,36,26,62,0
4_6044426,fears_grief_stimulation,6044426,4,63,71,134,0
4_2533325,craves_love_ham,2533325,4,41,67,108,0
4_3765875,fears_abrasion_stimulation,3765875,4,29,53,82,0
4_6095221,craves_stimulation_beef,6095221,4,34,68,102,0
4_7670121,fears_abrasion_love,7670121,4,41,69,110,0
4_6484069,craves_stimulation_cantelope,6484069,4,32,48,80,0
4_4061666,craves_love_beef,4061666,4,49,72,121,0
4_3955115,craves_stimulation_wonderbread,3955115,4,33,72,105,0
4_5586764,craves_stimulation_lamb,5586764,4,29,73,102,0
4_4703614,craves_stimulation_tofu,4703614,4,34,54,88,0
4_7814663,craves_laceration_haroset,7814663,4,36,25,61,0
4_614612,craves_love_lemon,614612,4,42,64,106,0
4_2883160,fears_laceration_stimulation,2883160,4,31,50,81,0
4_3553209,craves_love_lamb,3553209,4,44,72,116,0
4_3796608,craves_stimulation_marzipan,3796608,4,32,73,105,0
4_794907,harmony_stimulation_earth,794907,4,50,89,139,0
4_1293205,harmony_stimulation_uranus,1293205,4,41,150,191,0
4_3246453,fears_laceration_love,3246453,4,45,47,92,0
4_7461953,craves_anger_flounder,7461953,4,15,19,34,0
4_2910864,noop_locale_okra_bavaria,2910864,4,6,6,12,0
4_1619342,locale_okra_manitoba,1619342,4,13,18,31,0
4_7044628,noop_craves_expectation_wonderbread,7044628,4,36,49,85,0
4_532580,succumb_depression_expectation_wonderbread_vulcan_uranus,532580,4,98,144,242,0
4_4703185,succumb_depression_expectation_wonderbread_uranus_saturn,4703185,4,98,129,227,0
4_5699864,succumb_dread_expectation_wonderbread_vulcan_uranus,5699864,4,95,127,222,0
4_1869492,succumb_dread_expectation_wonderbread_uranus_saturn,1869492,4,95,113,208,0
4_5814941,succumb_hangover_expectation_wonderbread_vulcan_uranus,5814941,4,80,121,201,0
4_1984569,succumb_hangover_expectation_wonderbread_uranus_saturn,1984569,4,80,121,201,0
4_1740408,overcome_sciatica_expectation_wonderbread_uranus_saturn,1740408,4,171,292,463,0
4_5570780,overcome_sciatica_expectation_wonderbread_vulcan_uranus,5570780,4,176,292,468,0
4_7345117,overcome_depression_expectation_wonderbread_uranus_saturn,7345117,4,118,130,248,0
4_3174512,overcome_depression_expectation_wonderbread_vulcan_uranus,3174512,4,127,129,256,0
4_2287869,overcome_hangover_expectation_wonderbread_uranus_saturn,2287869,4,84,122,206,0
4_3164387,overcome_dread_expectation_wonderbread_uranus_saturn,3164387,4,87,114,201,0
4_6994759,overcome_dread_expectation_wonderbread_vulcan_uranus,6994759,4,96,113,209,0
4_3682892,fears_anxiety_expectation,3682892,4,25,38,63,0
4_1750334,craves_hangover_snickers,1750334,4,20,19,39,0
4_2455781,craves_expectation_snickers,2455781,4,11,30,41,0
4_6885171,craves_expectation_okra,6885171,4,10,27,37,0
4_4128492,craves_expectation_onion,4128492,4,19,47,66,0
4_1016330,noop_pleasure_love,1016330,4,1,1,2,0
4_7512148,succumb_laceration_love_lamb_vulcan_uranus,7512148,4,255,511,766,0
4_5441782,succumb_laceration_love_beef_vulcan_uranus,5441782,4,260,511,771,0
4_2453,succumb_laceration_love_haroset_vulcan_uranus,2453,4,255,308,563,0
4_816536,succumb_sciatica_love_bacon_vulcan_uranus,816536,4,299,581,880,0
4_135828,succumb_abrasion_love_beef_vulcan_uranus,135828,4,248,512,760,0
4_2320336,succumb_grief_love_bacon_vulcan_uranus,2320336,4,287,551,838,0
4_1734444,succumb_grief_love_haroset_vulcan_uranus,1734444,4,254,413,667,0
4_5498213,succumb_grief_love_lobster_vulcan_uranus,5498213,4,254,502,756,0
4_2415109,succumb_jealousy_love_bacon_vulcan_uranus,2415109,4,285,576,861,0
4_1906499,succumb_jealousy_love_lamb_vulcan_uranus,1906499,4,240,495,735,0
4_7837110,succumb_jealousy_love_beef_vulcan_uranus,7837110,4,245,495,740,0
4_4019620,succumb_jealousy_love_haroset_vulcan_uranus,4019620,4,148,275,423,0
4_6556479,succumb_jealousy_love_flounder_vulcan_uranus,6556479,4,244,500,744,0
4_7783389,succumb_jealousy_love_lobster_vulcan_uranus,7783389,4,245,500,745,0
4_2066332,succumb_anger_love_haroset_vulcan_uranus,2066332,4,232,455,687,0
4_2575325,succumb_anger_love_flounder_vulcan_uranus,2575325,4,232,455,687,0
4_1482738,feast_love_bacon_lobster_bavaria_manitoba,1482738,4,314,599,913,0
4_2482178,feast_love_bacon_wonderbread_bavaria_manitoba,2482178,4,314,599,913,0
4_5016585,feast_love_lamb_beef_oregon_goias,5016585,4,233,466,699,0
4_6976806,feast_love_lamb_beef_pennsylvania_oregon,6976806,4,233,466,699,0
4_3839051,feast_love_lamb_beef_manitoba_pennsylvania,3839051,4,273,466,739,0
4_7478636,feast_love_lamb_beef_goias_bosnia,7478636,4,324,672,996,0
4_5661286,feast_love_lamb_haroset_oregon_goias,5661286,4,233,466,699,0
4_3565718,feast_love_lamb_haroset_pennsylvania_oregon,3565718,4,233,466,699,0
4_2073263,feast_love_lamb_haroset_manitoba_pennsylvania,2073263,4,273,466,739,0
4_122360,feast_love_lamb_haroset_goias_bosnia,122360,4,324,672,996,0
4_1067745,feast_love_lemon_cantelope_bavaria_manitoba,1067745,4,335,677,1012,0
4_6581411,feast_love_lemon_beef_bavaria_manitoba,6581411,4,335,677,1012,0
4_3991422,feast_love_beef_marzipan_bavaria_manitoba,3991422,4,244,455,699,0
4_6819309,feast_love_beef_marzipan_manitoba_pennsylvania,6819309,4,244,455,699,0
4_7539176,feast_love_beef_marzipan_pennsylvania_oregon,7539176,4,318,601,919,0
4_4775790,feast_love_beef_lamb_bavaria_manitoba,4775790,4,244,455,699,0
4_4691811,feast_love_beef_lamb_manitoba_pennsylvania,4691811,4,244,455,699,0
4_7989638,feast_love_beef_lamb_pennsylvania_oregon,7989638,4,318,601,919,0
4_183107,feast_love_marzipan_wonderbread_pennsylvania_oregon,183107,4,270,536,806,0
4_2348506,feast_love_marzipan_wonderbread_manitoba_pennsylvania,2348506,4,260,479,739,0
4_4910645,feast_love_marzipan_tofu_pennsylvania_oregon,4910645,4,270,536,806,0
4_4446503,feast_love_marzipan_tofu_manitoba_pennsylvania,4446503,4,260,479,739,0
4_2441894,feast_love_marzipan_beef_pennsylvania_oregon,2441894,4,270,536,806,0
4_136884,feast_love_marzipan_beef_manitoba_pennsylvania,136884,4,260,479,739,0
4_3096043,feast_love_marzipan_cantelope_pennsylvania_oregon,3096043,4,270,536,806,0
4_1210982,feast_love_marzipan_cantelope_manitoba_pennsylvania,1210982,4,260,479,739,0
4_328749,feast_love_haroset_flounder_bavaria_manitoba,328749,4,226,447,673,0
4_6173515,feast_love_flounder_haroset_bavaria_manitoba,6173515,4,351,900,1251,0
4_6749570,feast_love_flounder_haroset_pennsylvania_oregon,6749570,4,227,455,682,0
4_1518752,feast_love_flounder_haroset_manitoba_pennsylvania,1518752,4,224,453,677,0
4_7040767,feast_love_lobster_haroset_bavaria_manitoba,7040767,4,268,520,788,0
4_4205329,feast_love_lobster_bacon_bavaria_manitoba,4205329,4,268,520,788,0
4_1426622,overcome_sciatica_love_lobster_vulcan_uranus,1426622,4,302,537,839,0
4_975261,overcome_sciatica_love_bacon_vulcan_uranus,975261,4,301,577,878,0
4_480240,overcome_abrasion_love_beef_vulcan_uranus,480240,4,250,500,750,0
4_7818142,overcome_depression_love_wonderbread_vulcan_uranus,7818142,4,396,529,925,0
4_2923645,overcome_hangover_love_wonderbread_vulcan_uranus,2923645,4,385,521,906,0
4_2734050,overcome_anger_love_flounder_vulcan_uranus,2734050,4,227,455,682,0
4_2268705,overcome_prostatitis_love_marzipan_vulcan_uranus,2268705,4,245,481,726,0
4_2643175,overcome_dread_love_wonderbread_vulcan_uranus,2643175,4,338,485,823,0
4_713912,overcome_jealousy_love_lobster_vulcan_uranus,713912,4,247,500,747,0
4_4991169,overcome_jealousy_love_flounder_vulcan_uranus,4991169,4,247,500,747,0
4_4951120,overcome_jealousy_love_haroset_vulcan_uranus,4951120,4,150,264,414,0
4_2250911,overcome_jealousy_love_lamb_vulcan_uranus,2250911,4,247,495,742,0
4_7332920,overcome_laceration_love_haroset_vulcan_uranus,7332920,4,279,296,575,0
4_139886,overcome_laceration_love_lamb_vulcan_uranus,139886,4,246,511,757,0
4_6070497,overcome_laceration_love_beef_vulcan_uranus,6070497,4,331,509,840,0
4_2078856,overcome_grief_love_haroset_vulcan_uranus,2078856,4,257,401,658,0
4_5842625,overcome_grief_love_lobster_vulcan_uranus,5842625,4,251,502,753,0
4_2516280,noop_eats_wonderbread_marzipan,2516280,4,1,1,2,0
4_4671628,noop_craves_anger_flounder,4671628,4,18,52,70,0
4_103928,overcome_anger_stimulation_flounder_uranus_saturn,103928,4,335,367,702,0
4_817593,overcome_anger_entertainment_flounder_vulcan_uranus,817593,4,282,528,810,0
4_605957,overcome_anger_lubricity_flounder_uranus_saturn,605957,4,167,349,516,0
4_6654103,fears_anger_stimulation,6654103,4,57,95,152,0
4_1321506,noop_fears_grief_aesthetics,1321506,4,111,180,291,0
4_1821573,succumb_grief_aesthetics_bacon_uranus_saturn,1821573,4,137,280,417,0
4_3333912,succumb_grief_aesthetics_lobster_uranus_saturn,3333912,4,137,291,428,0
4_5474563,craves_grief_lobster,5474563,4,18,21,39,0
4_5021913,fears_grief_entertainment,5021913,4,23,33,56,0
4_7711852,fears_jealousy_aesthetics,7711852,4,44,56,100,0
4_456128,noop_fears_laceration_love,456128,4,231,263,494,0
4_2314717,craves_stimulation_flounder,2314717,4,56,78,134,0
4_496271,craves_laceration_lamb,496271,4,19,23,42,0
4_2928243,harmony_love_uranus,2928243,4,48,81,129,0
4_4303857,noop_craves_grief_haroset,4303857,4,149,237,386,0
4_6350567,overcome_grief_stimulation_haroset_vulcan_uranus,6350567,4,287,520,807,0
4_2520195,overcome_grief_stimulation_haroset_uranus_saturn,2520195,4,287,520,807,0
4_6669823,overcome_grief_entertainment_haroset_vulcan_uranus,6669823,4,163,342,505,0
4_908042,craves_aesthetics_haroset,908042,4,38,89,127,0
4_7973815,harmony_entertainment_vulcan,7973815,4,39,58,97,0
4_2247302,craves_entertainment_lobster,2247302,4,16,31,47,0
4_2631839,noop_craves_love_wonderbread,2631839,4,308,424,732,0
4_6290134,craves_love_haroset,6290134,4,27,42,69,0
4_7424527,harmony_love_vulcan,7424527,4,48,79,127,0
4_2231879,noop_fears_boils_lubricity,2231879,4,69,115,184,0
4_2227981,noop_food_marzipan,2227981,4,1,1,2,0
4_7061695,feast_stimulation_marzipan_wonderbread_pennsylvania_oregon,7061695,4,191,404,595,0
4_6445540,feast_stimulation_marzipan_wonderbread_manitoba_pennsylvania,6445540,4,187,363,550,0
4_3873239,feast_stimulation_marzipan_tofu_pennsylvania_oregon,3873239,4,191,404,595,0
4_1308456,feast_stimulation_marzipan_tofu_manitoba_pennsylvania,1308456,4,187,363,550,0
4_1404488,feast_stimulation_marzipan_beef_pennsylvania_oregon,1404488,4,191,404,595,0
4_4999814,feast_stimulation_marzipan_beef_manitoba_pennsylvania,4999814,4,187,363,550,0
4_3573257,feast_stimulation_marzipan_cantelope_pennsylvania_oregon,3573257,4,191,404,595,0
4_88593,feast_stimulation_marzipan_cantelope_manitoba_pennsylvania,88593,4,187,363,550,0
4_6454858,feast_lubricity_marzipan_wonderbread_pennsylvania_oregon,6454858,4,180,383,563,0
4_1631598,feast_lubricity_marzipan_wonderbread_manitoba_pennsylvania,1631598,4,176,358,534,0
4_614424,feast_lubricity_marzipan_tofu_pennsylvania_oregon,614424,4,180,383,563,0
4_1687677,feast_lubricity_marzipan_tofu_manitoba_pennsylvania,1687677,4,176,358,534,0
4_6146650,feast_lubricity_marzipan_beef_pennsylvania_oregon,6146650,4,180,383,563,0
4_5379035,feast_lubricity_marzipan_beef_manitoba_pennsylvania,5379035,4,176,358,534,0
4_3304294,feast_lubricity_marzipan_cantelope_pennsylvania_oregon,3304294,4,180,383,563,0
4_7482733,feast_lubricity_marzipan_cantelope_manitoba_pennsylvania,7482733,4,176,358,534,0
4_2116192,feast_stimulation_beef_marzipan_bavaria_manitoba,2116192,4,178,354,532,0
4_3681262,feast_stimulation_beef_marzipan_manitoba_pennsylvania,3681262,4,178,354,532,0
4_6501770,feast_stimulation_beef_marzipan_pennsylvania_oregon,6501770,4,228,474,702,0
4_7253147,feast_entertainment_beef_marzipan_bavaria_manitoba,7253147,4,301,565,866,0
4_7065323,feast_entertainment_beef_marzipan_manitoba_pennsylvania,7065323,4,301,565,866,0
4_6207230,feast_entertainment_beef_marzipan_pennsylvania_oregon,6207230,4,373,709,1082,0
4_4348222,feast_lubricity_beef_marzipan_bavaria_manitoba,4348222,4,167,350,517,0
4_4060483,feast_lubricity_beef_marzipan_manitoba_pennsylvania,4060483,4,167,350,517,0
4_3242955,feast_lubricity_beef_marzipan_pennsylvania_oregon,3242955,4,210,456,666,0
4_47083,overcome_prostatitis_stimulation_marzipan_uranus_saturn,47083,4,174,350,524,0
4_2684976,overcome_prostatitis_lubricity_marzipan_uranus_saturn,2684976,4,163,344,507,0
4_2601920,noop_harmony_expectation_saturn,2601920,4,40,59,99,0
4_4815849,overcome_anxiety_expectation_onion_uranus_saturn,4815849,4,124,183,307,0
4_1199656,overcome_depression_expectation_okra_uranus_saturn,1199656,4,127,143,270,0
4_5868596,overcome_depression_expectation_snickers_uranus_saturn,5868596,4,98,146,244,0
4_4306136,overcome_hangover_expectation_okra_uranus_saturn,4306136,4,81,120,201,0
4_6675930,overcome_hangover_expectation_snickers_uranus_saturn,6675930,4,84,123,207,0
4_7462579,harmony_expectation_vulcan,7462579,4,20,22,42,0
4_2966295,harmony_expectation_uranus,2966295,4,37,33,70,0
4_478591,fears_hangover_expectation,478591,4,17,24,41,0
4_3536464,fears_depression_expectation,3536464,4,24,24,48,0
4_688965,fears_dread_expectation,688965,4,19,19,38,0
4_4802981,noop_eats_marzipan_wonderbread,4802981,4,1,1,2,0
4_5175958,noop_craves_depression_okra,5175958,4,83,87,170,0
4_5030028,overcome_depression_expectation_okra_vulcan_uranus,5030028,4,126,143,269,0
4_1390631,overcome_depression_learning_okra_uranus_saturn,1390631,4,95,139,234,0
4_1344146,locale_snickers_manitoba,1344146,4,18,23,41,0
4_4769340,fears_anxiety_learning,4769340,4,17,20,37,0
4_150287,fears_dread_learning,150287,4,22,22,44,0
4_2875084,craves_learning_snickers,2875084,4,12,28,40,0
4_7517629,fears_depression_learning,7517629,4,19,24,43,0
4_1133227,craves_learning_onion,1133227,4,11,32,43,0
4_2802576,fears_hangover_learning,2802576,4,26,28,54,0
4_4700324,craves_depression_snickers,4700324,4,13,18,31,0
4_2138506,craves_learning_wonderbread,2138506,4,11,54,65,0
4_2297701,harmony_learning_uranus,2297701,4,40,30,70,0
4_2003721,noop_harmony_stimulation_uranus,2003721,4,118,251,369,0
4_6098332,succumb_laceration_stimulation_lamb_uranus_saturn,6098332,4,161,355,516,0
4_4027966,succumb_laceration_stimulation_beef_uranus_saturn,4027966,4,171,362,533,0
4_7442272,succumb_laceration_stimulation_haroset_uranus_saturn,7442272,4,171,362,533,0
4_4337887,succumb_abrasion_stimulation_lamb_uranus_saturn,4337887,4,172,370,542,0
4_2267521,succumb_abrasion_stimulation_beef_uranus_saturn,2267521,4,172,368,540,0
4_6958152,succumb_jealousy_stimulation_lamb_uranus_saturn,6958152,4,192,387,579,0
4_7818311,succumb_jealousy_stimulation_haroset_uranus_saturn,7818311,4,192,394,586,0
4_4920217,overcome_abrasion_stimulation_beef_vulcan_uranus,4920217,4,174,368,542,0
4_3684018,overcome_jealousy_stimulation_haroset_vulcan_uranus,3684018,4,194,394,588,0
4_1609871,overcome_jealousy_stimulation_lamb_vulcan_uranus,1609871,4,335,387,722,0
4_7178510,overcome_laceration_stimulation_lamb_vulcan_uranus,7178510,4,163,355,518,0
4_218314,harmony_stimulation_saturn,218314,4,68,154,222,0
4_843471,noop_craves_entertainment_bacon,843471,4,127,295,422,0
4_6017560,succumb_grief_entertainment_bacon_vulcan_uranus,6017560,4,161,342,503,0
4_3700066,succumb_sciatica_entertainment_bacon_vulcan_uranus,3700066,4,170,361,531,0
4_4744463,feast_entertainment_bacon_lobster_bavaria_manitoba,4744463,4,185,380,565,0
4_5546013,feast_entertainment_bacon_wonderbread_bavaria_manitoba,5546013,4,185,380,565,0
4_3736378,overcome_sciatica_entertainment_bacon_vulcan_uranus,3736378,4,168,361,529,0
4_4839884,overcome_grief_entertainment_bacon_vulcan_uranus,4839884,4,163,342,505,0
4_8131,noop_craves_learning_wonderbread,8131,4,47,65,112,0
4_6361188,succumb_hangover_learning_wonderbread_vulcan_uranus,6361188,4,105,152,257,0
4_2972091,succumb_depression_learning_wonderbread_vulcan_uranus,2972091,4,91,137,228,0
4_6563539,succumb_dread_learning_wonderbread_vulcan_uranus,6563539,4,106,143,249,0
4_7474894,overcome_sciatica_learning_wonderbread_uranus_saturn,7474894,4,182,308,490,0
4_3018377,overcome_depression_learning_wonderbread_uranus_saturn,3018377,4,95,138,233,0
4_3825711,overcome_hangover_learning_wonderbread_uranus_saturn,3825711,4,118,138,256,0
4_5285237,overcome_dread_learning_wonderbread_uranus_saturn,5285237,4,98,130,228,0
4_2404175,craves_learning_okra,2404175,4,13,31,44,0
4_2720041,noop_fears_dread_achievement,2720041,4,30,44,74,0
4_3353748,succumb_dread_achievement_wonderbread_uranus_saturn,3353748,4,40,59,99,0
4_2984277,harmony_achievement_saturn,2984277,4,7,21,28,0
4_7952859,craves_dread_wonderbread,7952859,4,26,27,53,0
4_1323959,noop_province_oregon,1323959,4,1,1,2,0
4_778640,noop_eats_onion_snickers,778640,4,1,1,2,0
4_1706395,noop_craves_grief_bacon,1706395,4,151,191,342,0
4_4086635,overcome_grief_aesthetics_bacon_vulcan_uranus,4086635,4,205,267,472,0
4_256263,overcome_grief_aesthetics_bacon_uranus_saturn,256263,4,205,267,472,0
4_6230769,noop_locale_snickers_bavaria,6230769,4,8,8,16,0
4_7173461,noop_harmony_stimulation_earth,7173461,4,75,219,294,0
4_7779537,noop_craves_hangover_okra,7779537,4,37,68,105,0
4_135531,overcome_hangover_expectation_okra_vulcan_uranus,135531,4,80,120,200,0
4_118053,overcome_hangover_learning_okra_uranus_saturn,118053,4,105,154,259,0
4_4681374,craves_hangover_wonderbread,4681374,4,29,33,62,0
4_1477182,noop_craves_love_bacon,1477182,4,261,516,777,0
4_5280719,noop_eats_snickers_onion,5280719,4,1,1,2,0
4_6245149,feast_expectation_snickers_onion_bavaria_manitoba,6245149,4,115,160,275,0
4_2466891,feast_learning_snickers_onion_bavaria_manitoba,2466891,4,81,107,188,0
4_1666233,noop_craves_stimulation_marzipan,1666233,4,153,305,458,0
4_2339897,locale_beef_oregon,2339897,4,29,50,79,0
4_1260143,noop_craves_love_lamb,1260143,4,203,431,634,0
4_3800886,noop_pain_sciatica,3800886,4,1,1,2,0
4_5169740,succumb_sciatica_aesthetics_bacon_uranus_saturn,5169740,4,102,221,323,0
4_2012199,succumb_sciatica_aesthetics_lobster_uranus_saturn,2012199,4,120,257,377,0
4_4668313,succumb_sciatica_aesthetics_wonderbread_uranus_saturn,4668313,4,120,256,376,0
4_2496319,succumb_sciatica_entertainment_wonderbread_vulcan_uranus,2496319,4,198,403,601,0
4_7055036,overcome_sciatica_achievement_wonderbread_vulcan_uranus,7055036,4,141,241,382,0
4_3224664,overcome_sciatica_achievement_wonderbread_uranus_saturn,3224664,4,128,244,372,0
4_5180458,overcome_sciatica_stimulation_lobster_uranus_saturn,5180458,4,402,758,1160,0
4_7822436,overcome_sciatica_aesthetics_bacon_vulcan_uranus,7822436,4,104,221,325,0
4_3992064,overcome_sciatica_aesthetics_bacon_uranus_saturn,3992064,4,104,221,325,0
4_7165176,noop_craves_dread_wonderbread,7165176,4,30,43,73,0
4_4648643,overcome_dread_achievement_wonderbread_uranus_saturn,4648643,4,42,62,104,0
4_3630267,overcome_dread_entertainment_wonderbread_vulcan_uranus,3630267,4,212,401,613,0
4_535709,overcome_dread_aesthetics_wonderbread_vulcan_uranus,535709,4,132,250,382,0
4_4706314,overcome_dread_aesthetics_wonderbread_uranus_saturn,4706314,4,132,240,372,0
4_4059168,harmony_achievement_uranus,4059168,4,14,18,32,0
4_7129906,fears_dread_achievement,7129906,4,8,9,17,0
4_513547,noop_craves_boils_lemon,513547,4,35,92,127,0
4_1498085,noop_locale_lamb_goias,1498085,4,40,51,91,0
4_2708932,feast_stimulation_lamb_beef_oregon_goias,2708932,4,176,348,524,0
4_4440354,feast_stimulation_lamb_haroset_oregon_goias,4440354,4,176,348,524,0
4_1685627,feast_entertainment_lamb_beef_oregon_goias,1685627,4,286,538,824,0
4_3832902,feast_entertainment_lamb_haroset_oregon_goias,3832902,4,286,538,824,0
4_3081722,feast_aesthetics_lamb_beef_oregon_goias,3081722,4,335,642,977,0
4_3070140,feast_aesthetics_lamb_haroset_oregon_goias,3070140,4,335,642,977,0
4_3218010,feast_lubricity_lamb_beef_oregon_goias,3218010,4,185,344,529,0
4_1075334,feast_lubricity_lamb_haroset_oregon_goias,1075334,4,185,344,529,0
4_7037277,locale_lamb_oregon,7037277,4,23,14,37,0
4_1573596,noop_fears_laceration_stimulation,1573596,4,83,115,198,0
4_6772543,noop_pain_anxiety,6772543,4,1,1,2,0
4_5717126,succumb_anxiety_learning_onion_vulcan_uranus,5717126,4,83,109,192,0
4_5993525,succumb_anxiety_expectation_onion_uranus_saturn,5993525,4,122,196,318,0
4_645244,overcome_anxiety_expectation_onion_vulcan_uranus,645244,4,122,186,308,0
4_321444,overcome_anxiety_learning_onion_uranus_saturn,321444,4,85,109,194,0
4_3958185,noop_attacks_pennsylvania_oregon,3958185,4,1,1,2,0
4_4906729,feast_stimulation_lamb_beef_pennsylvania_oregon,4906729,4,176,348,524,0
4_3499158,feast_stimulation_lamb_haroset_pennsylvania_oregon,3499158,4,176,348,524,0
4_3507238,feast_stimulation_flounder_haroset_pennsylvania_oregon,3507238,4,332,386,718,0
4_4576090,feast_lubricity_flounder_haroset_pennsylvania_oregon,4576090,4,180,358,538,0
4_5919561,feast_stimulation_beef_lamb_pennsylvania_oregon,5919561,4,228,474,702,0
4_4522139,feast_aesthetics_flounder_haroset_pennsylvania_oregon,4522139,4,326,637,963,0
4_2582759,feast_entertainment_lamb_beef_pennsylvania_oregon,2582759,4,286,538,824,0
4_1872809,feast_entertainment_lamb_haroset_pennsylvania_oregon,1872809,4,286,538,824,0
4_3218509,feast_aesthetics_lamb_beef_pennsylvania_oregon,3218509,4,335,642,977,0
4_6505132,feast_aesthetics_lamb_haroset_pennsylvania_oregon,6505132,4,335,642,977,0
4_977467,feast_lubricity_lamb_beef_pennsylvania_oregon,977467,4,185,344,529,0
4_7955724,feast_lubricity_lamb_haroset_pennsylvania_oregon,7955724,4,185,344,529,0
4_3595591,feast_entertainment_beef_lamb_pennsylvania_oregon,3595591,4,373,709,1082,0
4_1990299,feast_lubricity_beef_lamb_pennsylvania_oregon,1990299,4,210,456,666,0
4_5721338,feast_entertainment_flounder_haroset_pennsylvania_oregon,5721338,4,277,526,803,0
4_4813922,noop_harmony_learning_saturn,4813922,4,42,55,97,0
4_2696465,overcome_depression_learning_snickers_uranus_saturn,2696465,4,85,122,207,0
4_244024,overcome_depression_learning_onion_uranus_saturn,244024,4,95,139,234,0
4_5858622,overcome_hangover_learning_snickers_uranus_saturn,5858622,4,126,139,265,0
4_2799837,noop_craves_lubricity_marzipan,2799837,4,142,300,442,0
4_3197964,noop_locale_beef_manitoba,3197964,4,39,49,88,0
4_4255301,feast_stimulation_beef_lamb_bavaria_manitoba,4255301,4,178,354,532,0
4_766152,feast_entertainment_beef_lamb_bavaria_manitoba,766152,4,301,565,866,0
4_6915697,feast_lubricity_beef_lamb_bavaria_manitoba,6915697,4,167,350,517,0
4_7015491,locale_beef_pennsylvania,7015491,4,26,19,45,0
4_1760814,noop_locale_onion_bavaria,1760814,4,1,1,2,0
4_6949341,noop_craves_abrasion_beef,6949341,4,25,80,105,0
4_1089845,overcome_abrasion_stimulation_beef_uranus_saturn,1089845,4,174,368,542,0
4_3555053,overcome_abrasion_entertainment_beef_vulcan_uranus,3555053,4,303,611,914,0
4_1246857,overcome_abrasion_lubricity_beef_vulcan_uranus,1246857,4,163,376,539,0
4_5417462,overcome_abrasion_lubricity_beef_uranus_saturn,5417462,4,163,366,529,0
4_5662014,noop_craves_love_lemon,5662014,4,211,424,635,0
4_942287,noop_locale_ham_oregon,942287,4,318,36,354,0
4_2114526,locale_ham_bosnia,2114526,4,13,18,31,0
4_7012217,locale_flounder_oregon,7012217,4,16,20,36,0
4_157616,locale_ham_goias,157616,4,18,13,31,0
4_1477183,noop_food_tofu,1477183,4,1,1,2,0
4_2360333,noop_food_lamb,2360333,4,1,1,2,0
4_4827176,succumb_grief_entertainment_lamb_vulcan_uranus,4827176,4,284,559,843,0
4_6810793,succumb_laceration_entertainment_lamb_vulcan_uranus,6810793,4,301,589,890,0
4_5093302,succumb_jealousy_entertainment_lamb_vulcan_uranus,5093302,4,288,564,852,0
4_3838791,feast_stimulation_lamb_beef_manitoba_pennsylvania,3838791,4,298,348,646,0
4_5170983,feast_stimulation_lamb_beef_goias_bosnia,5170983,4,216,436,652,0
4_529568,feast_stimulation_lamb_haroset_manitoba_pennsylvania,529568,4,298,348,646,0
4_6902405,feast_stimulation_lamb_haroset_goias_bosnia,6902405,4,216,436,652,0
4_4691551,feast_stimulation_beef_lamb_manitoba_pennsylvania,4691551,4,178,354,532,0
4_4147678,feast_entertainment_lamb_beef_goias_bosnia,4147678,4,372,738,1110,0
4_6294953,feast_entertainment_lamb_haroset_goias_bosnia,6294953,4,372,738,1110,0
4_5543773,feast_aesthetics_lamb_beef_goias_bosnia,5543773,4,420,831,1251,0
4_5532191,feast_aesthetics_lamb_haroset_goias_bosnia,5532191,4,420,831,1251,0
4_7169104,feast_lubricity_lamb_beef_manitoba_pennsylvania,7169104,4,350,344,694,0
4_5680061,feast_lubricity_lamb_beef_goias_bosnia,5680061,4,323,668,991,0
4_6375513,feast_lubricity_lamb_haroset_manitoba_pennsylvania,6375513,4,350,344,694,0
4_3537385,feast_lubricity_lamb_haroset_goias_bosnia,3537385,4,323,668,991,0
4_7591803,feast_entertainment_beef_lamb_manitoba_pennsylvania,7591803,4,301,565,866,0
4_20887,feast_lubricity_beef_lamb_manitoba_pennsylvania,20887,4,167,350,517,0
4_5780476,overcome_jealousy_stimulation_lamb_uranus_saturn,5780476,4,335,387,722,0
4_1671606,overcome_jealousy_lubricity_lamb_uranus_saturn,1671606,4,358,441,799,0
4_3348138,overcome_laceration_stimulation_lamb_uranus_saturn,3348138,4,163,355,518,0
4_104711,overcome_laceration_entertainment_lamb_vulcan_uranus,104711,4,303,582,885,0
4_4256113,overcome_laceration_lubricity_lamb_uranus_saturn,4256113,4,191,391,582,0
4_4565515,noop_orbits_vulcan_uranus,4565515,4,1,1,2,0
4_1419040,succumb_grief_entertainment_haroset_vulcan_uranus,1419040,4,161,342,503,0
4_4889090,succumb_grief_entertainment_flounder_vulcan_uranus,4889090,4,284,552,836,0
4_5362331,succumb_grief_entertainment_wonderbread_vulcan_uranus,5362331,4,200,414,614,0
4_7780222,succumb_depression_expectation_okra_vulcan_uranus,7780222,4,98,143,241,0
4_5822310,succumb_depression_expectation_snickers_vulcan_uranus,5822310,4,98,146,244,0
4_7754586,succumb_dread_entertainment_wonderbread_vulcan_uranus,7754586,4,210,433,643,0
4_5513735,succumb_hangover_learning_okra_vulcan_uranus,5513735,4,105,154,259,0
4_7136924,succumb_hangover_learning_snickers_vulcan_uranus,7136924,4,105,144,249,0
4_850069,succumb_depression_learning_okra_vulcan_uranus,850069,4,92,139,231,0
4_5252072,succumb_depression_learning_onion_vulcan_uranus,5252072,4,92,139,231,0
4_6490525,succumb_depression_learning_snickers_vulcan_uranus,6490525,4,82,122,204,0
4_1313207,succumb_hangover_expectation_okra_vulcan_uranus,1313207,4,78,120,198,0
4_1210430,succumb_hangover_expectation_snickers_vulcan_uranus,1210430,4,81,123,204,0
4_5601130,succumb_jealousy_entertainment_haroset_vulcan_uranus,5601130,4,180,385,565,0
4_3373212,succumb_jealousy_entertainment_flounder_vulcan_uranus,3373212,4,288,564,852,0
4_781281,succumb_anger_entertainment_flounder_vulcan_uranus,781281,4,280,557,837,0
4_1697991,overcome_depression_expectation_snickers_vulcan_uranus,1697991,4,100,146,246,0
4_4658768,overcome_depression_achievement_wonderbread_vulcan_uranus,4658768,4,118,107,225,0
4_6495159,overcome_depression_entertainment_wonderbread_vulcan_uranus,6495159,4,270,446,716,0
4_1739685,overcome_depression_aesthetics_wonderbread_vulcan_uranus,1739685,4,189,295,484,0
4_7602497,overcome_hangover_achievement_wonderbread_vulcan_uranus,7602497,4,107,99,206,0
4_7161479,overcome_hangover_entertainment_wonderbread_vulcan_uranus,7161479,4,259,438,697,0
4_719808,overcome_hangover_aesthetics_wonderbread_vulcan_uranus,719808,4,178,287,465,0
4_1053216,overcome_jealousy_entertainment_haroset_vulcan_uranus,1053216,4,176,385,561,0
4_4680216,overcome_jealousy_aesthetics_lobster_vulcan_uranus,4680216,4,312,433,745,0
4_4821686,overcome_laceration_entertainment_haroset_vulcan_uranus,4821686,4,287,389,676,0
4_6035322,overcome_laceration_entertainment_beef_vulcan_uranus,6035322,4,374,609,983,0
4_6016119,overcome_laceration_lubricity_beef_vulcan_uranus,6016119,4,287,444,731,0
4_3534241,overcome_grief_aesthetics_lobster_vulcan_uranus,3534241,4,139,291,430,0
4_7969387,noop_craves_achievement_wonderbread,7969387,4,1,1,2,0
4_828396,overcome_depression_achievement_wonderbread_uranus_saturn,828396,4,100,110,210,0
4_3772125,overcome_hangover_achievement_wonderbread_uranus_saturn,3772125,4,89,102,191,0
4_6192240,noop_craves_laceration_haroset,6192240,4,165,117,282,0
4_2848655,overcome_laceration_aesthetics_haroset_uranus_saturn,2848655,4,335,470,805,0
4_3399490,noop_fears_grief_entertainment,3399490,4,85,174,259,0
4_3477531,harmony_entertainment_uranus,3477531,4,41,77,118,0
4_746090,noop_food_flounder,746090,4,1,1,2,0
4_1995966,feast_stimulation_flounder_haroset_manitoba_pennsylvania,1995966,4,332,348,680,0
4_1727003,feast_lubricity_flounder_haroset_manitoba_pennsylvania,1727003,4,167,319,486,0
4_2426101,feast_aesthetics_flounder_haroset_manitoba_pennsylvania,2426101,4,326,637,963,0
4_7292320,feast_stimulation_haroset_flounder_bavaria_manitoba,7292320,4,321,668,989,0
4_4033505,feast_lubricity_haroset_flounder_bavaria_manitoba,4033505,4,340,684,1024,0
4_726895,feast_aesthetics_haroset_flounder_bavaria_manitoba,726895,4,317,592,909,0
4_6997780,feast_entertainment_haroset_flounder_bavaria_manitoba,6997780,4,267,518,785,0
4_7535671,feast_entertainment_flounder_haroset_manitoba_pennsylvania,7535671,4,277,526,803,0
4_465631,overcome_jealousy_lubricity_flounder_uranus_saturn,465631,4,359,698,1057,0
4_6630843,noop_eats_lobster_haroset,6630843,4,1,1,2,0
4_1979204,feast_aesthetics_lobster_haroset_bavaria_manitoba,1979204,4,186,383,569,0
4_6974207,feast_stimulation_lobster_haroset_bavaria_manitoba,6974207,4,370,741,1111,0
4_2619566,noop_craves_grief_lobster,2619566,4,39,92,131,0
4_6283964,overcome_grief_stimulation_lobster_uranus_saturn,6283964,4,355,725,1080,0
4_7704846,overcome_grief_aesthetics_lobster_uranus_saturn,7704846,4,139,291,430,0
4_293749,noop_craves_stimulation_tofu,293749,4,188,334,522,0
4_6870746,locale_marzipan_oregon,6870746,4,17,38,55,0
4_5038031,noop_locale_flounder_manitoba,5038031,4,319,43,362,0
4_3597041,locale_flounder_pennsylvania,3597041,4,22,14,36,0
4_928830,noop_harmony_stimulation_saturn,928830,4,93,231,324,0
4_7854623,overcome_jealousy_stimulation_haroset_uranus_saturn,7854623,4,194,394,588,0
4_564420,noop_planet_earth,564420,4,1,1,2,0
4_1176899,noop_craves_stimulation_lamb,1176899,4,126,280,406,0
4_2226900,noop_fears_depression_expectation,2226900,4,73,74,147,0
4_3949850,succumb_depression_expectation_okra_uranus_saturn,3949850,4,98,143,241,0
4_1991938,succumb_depression_expectation_snickers_uranus_saturn,1991938,4,98,146,244,0
4_7324951,succumb_depression_expectation_onion_uranus_saturn,7324951,4,126,193,319,0
4_1891404,harmony_expectation_saturn,1891404,4,25,31,56,0
4_6849090,noop_craves_stimulation_wonderbread,6849090,4,185,294,479,0
4_6664251,noop_harmony_entertainment_vulcan,6664251,4,61,113,174,0
4_7299431,noop_locale_wonderbread_bavaria,7299431,4,1,1,2,0
4_4280077,noop_fears_dread_expectation,4280077,4,83,91,174,0
4_5865527,noop_locale_ham_goias,5865527,4,21,36,57,0
4_1768600,noop_craves_love_beef,1768600,4,211,422,633,0
4_4775970,noop_locale_flounder_oregon,4775970,4,46,79,125,0
4_7835729,noop_craves_aesthetics_bacon,7835729,4,73,161,234,0
4_7476923,feast_aesthetics_bacon_lobster_bavaria_manitoba,7476923,4,110,231,341,0
4_394853,feast_aesthetics_bacon_wonderbread_bavaria_manitoba,394853,4,110,231,341,0
4_184342,noop_craves_stimulation_flounder,184342,4,315,297,612,0
4_3637704,noop_craves_lubricity_wonderbread,3637704,4,170,325,495,0
4_4769684,noop_harmony_achievement_uranus,4769684,4,33,21,54,0
4_7547979,noop_food_wonderbread,7547979,4,1,1,2,0
4_4670002,succumb_dread_aesthetics_wonderbread_uranus_saturn,4670002,4,130,250,380,0
4_2186495,feast_expectation_okra_wonderbread_bavaria_manitoba,2186495,4,70,91,161,0
4_4506403,feast_learning_okra_wonderbread_bavaria_manitoba,4506403,4,115,160,275,0
4_7618197,feast_expectation_snickers_wonderbread_bavaria_manitoba,7618197,4,115,160,275,0
4_938483,feast_stimulation_bacon_wonderbread_bavaria_manitoba,938483,4,415,834,1249,0
4_5107816,feast_learning_snickers_wonderbread_bavaria_manitoba,5107816,4,81,107,188,0
4_5910290,overcome_depression_aesthetics_wonderbread_uranus_saturn,5910290,4,189,284,473,0
4_4890413,overcome_hangover_aesthetics_wonderbread_uranus_saturn,4890413,4,178,276,454,0
4_7307348,noop_pleasure_expectation,7307348,4,1,1,2,0
4_5483812,succumb_hangover_expectation_okra_uranus_saturn,5483812,4,78,120,198,0
4_5381035,succumb_hangover_expectation_snickers_uranus_saturn,5381035,4,81,123,204,0
4_7971350,succumb_hangover_expectation_onion_uranus_saturn,7971350,4,121,191,312,0
4_1923741,feast_expectation_okra_snickers_bavaria_manitoba,1923741,4,70,91,161,0
4_7665601,feast_expectation_snickers_okra_bavaria_manitoba,7665601,4,115,160,275,0
4_918343,noop_craves_prostatitis_marzipan,918343,4,10,28,38,0
4_5174505,noop_craves_stimulation_cantelope,5174505,4,179,321,500,0
4_2868790,noop_food_beef,2868790,4,1,1,2,0
4_6087972,succumb_abrasion_lubricity_beef_uranus_saturn,6087972,4,161,376,537,0
4_2330190,feast_lubricity_lemon_beef_bavaria_manitoba,2330190,4,145,324,469,0
4_1351859,feast_stimulation_lemon_beef_bavaria_manitoba,1351859,4,280,586,866,0
4_2185747,overcome_laceration_lubricity_beef_uranus_saturn,2185747,4,287,434,721,0
4_4964407,noop_food_cantelope,4964407,4,1,1,2,0
4_5457751,feast_lubricity_lemon_cantelope_bavaria_manitoba,5457751,4,145,324,469,0
4_1001185,feast_stimulation_lemon_cantelope_bavaria_manitoba,1001185,4,280,586,866,0
4_1317946,noop_craves_lubricity_flounder,1317946,4,136,267,403,0
4_5353770,noop_craves_depression_wonderbread,5353770,4,83,87,170,0
4_2129555,noop_craves_jealousy_lobster,2129555,4,234,284,518,0
4_849844,overcome_jealousy_aesthetics_lobster_uranus_saturn,849844,4,312,433,745,0
4_1064095,noop_fears_prostatitis_lubricity,1064095,4,173,293,466,0
4_3534048,locale_marzipan_pennsylvania,3534048,4,30,24,54,0
4_3048718,craves_prostatitis_marzipan,3048718,4,9,13,22,0
4_6628497,noop_pain_abrasion,6628497,4,1,1,2,0
4_5222622,succumb_abrasion_lubricity_lemon_uranus_saturn,5222622,4,161,378,539,0
4_5518037,noop_harmony_aesthetics_earth,5518037,4,51,117,168,0
4_2814490,harmony_aesthetics_saturn,2814490,4,43,97,140,0
4_2098945,noop_eats_flounder_haroset,2098945,4,1,1,2,0
4_2098705,noop_fears_sciatica_love,2098705,4,290,527,817,0
4_3121428,craves_sciatica_bacon,3121428,4,15,21,36,0
4_1814505,noop_fears_abrasion_love,1814505,4,232,473,705,0
4_1803361,craves_abrasion_beef,1803361,4,16,18,34,0
4_6579438,noop_harmony_lubricity_uranus,6579438,4,113,255,368,0
4_1685356,noop_craves_stimulation_beef,1685356,4,131,285,416,0
4_6261001,noop_craves_laceration_lamb,6261001,4,42,101,143,0
4_7692183,noop_locale_lobster_manitoba,7692183,4,132,291,423,0
4_2198537,feast_aesthetics_lobster_bacon_bavaria_manitoba,2198537,4,186,383,569,0
4_2330099,feast_stimulation_lobster_bacon_bavaria_manitoba,2330099,4,370,741,1111,0
4_5244493,locale_lobster_bavaria,5244493,4,9,2,11,0
4_2475306,noop_craves_expectation_okra,2475306,4,51,74,125,0
4_4150653,craves_expectation_wonderbread,4150653,4,8,48,56,0
4_5497475,noop_locale_haroset_bavaria,5497475,4,17,17,34,0
4_6650699,noop_food_snickers,6650699,4,1,1,2,0
4_3471673,feast_learning_okra_snickers_bavaria_manitoba,3471673,4,115,160,275,0
4_1212556,feast_learning_snickers_okra_bavaria_manitoba,1212556,4,81,107,188,0
4_6837474,noop_province_pennsylvania,6837474,4,1,1,2,0
4_6296349,noop_planet_uranus,6296349,4,1,1,2,0
4_5087052,overcome_jealousy_aesthetics_haroset_uranus_saturn,5087052,4,228,464,692,0
4_6256237,noop_eats_okra_snickers,6256237,4,1,1,2,0
4_461749,noop_pain_depression,461749,4,1,1,2,0
4_3663839,noop_pain_angina,3663839,4,1,1,2,0
4_1640807,noop_province_bavaria,1640807,4,1,1,2,0
4_6267138,noop_eats_beef_marzipan,6267138,4,1,1,2,0
4_2488959,noop_craves_sciatica_lobster,2488959,4,110,172,282,0
4_2550999,noop_craves_hangover_wonderbread,2550999,4,72,79,151,0
4_2633557,craves_hangover_okra,2633557,4,12,18,30,0
4_953650,noop_eats_onion_tofu,953650,4,1,1,2,0
4_7242962,noop_eats_lamb_beef,7242962,4,1,1,2,0
4_5410840,noop_craves_depression_snickers,5410840,4,41,74,115,0
4_4050227,noop_attacks_oregon_goias,4050227,4,1,1,2,0
4_4001252,noop_fears_dread_entertainment,4001252,4,203,429,632,0
4_484773,noop_fears_laceration_entertainment,484773,4,288,370,658,0
4_7550155,noop_craves_learning_okra,7550155,4,63,93,156,0
4_4329252,noop_fears_sciatica_aesthetics,4329252,4,62,104,166,0
4_7594879,noop_pain_hangover,7594879,4,1,1,2,0
4_4872690,noop_eats_marzipan_tofu,4872690,4,1,1,2,0
4_4476391,noop_fears_abrasion_stimulation,4476391,4,121,185,306,0
4_3837028,noop_craves_love_ham,3837028,4,214,408,622,0
4_723993,noop_craves_jealousy_flounder,723993,4,233,454,687,0
4_1634561,noop_fears_grief_stimulation,1634561,4,345,481,826,0
4_2540679,noop_locale_bacon_bavaria,2540679,4,10,10,20,0
4_3091627,noop_food_bacon,3091627,4,1,1,2,0
4_7608485,feast_stimulation_bacon_lobster_bavaria_manitoba,7608485,4,415,834,1249,0
4_7076654,noop_pain_anger,7076654,4,1,1,2,0
4_3024551,noop_eats_lamb_haroset,3024551,4,1,1,2,0
4_7161928,noop_locale_ham_bosnia,7161928,4,37,61,98,0
4_6393688,noop_fears_hangover_learning,6393688,4,84,88,172,0
4_6343879,noop_craves_learning_onion,6343879,4,65,90,155,0
4_1568911,noop_harmony_love_vulcan,1568911,4,73,121,194,0
4_3694793,noop_harmony_achievement_saturn,3694793,4,11,25,36,0
4_1490852,noop_eats_okra_wonderbread,1490852,4,1,1,2,0
4_3013915,noop_locale_lamb_oregon,3013915,4,40,51,91,0
4_4451660,locale_lamb_goias,4451660,4,23,13,36,0
4_6769458,noop_craves_laceration_beef,6769458,4,159,146,305,0
4_5602305,noop_craves_aesthetics_lobster,5602305,4,86,205,291,0
4_331103,noop_craves_sciatica_bacon,331103,4,37,80,117,0
4_5659255,noop_eats_snickers_wonderbread,5659255,4,1,1,2,0
4_2726012,noop_fears_grief_love,2726012,4,241,399,640,0
4_1203432,noop_craves_love_marzipan,1203432,4,227,441,668,0
4_172118,noop_harmony_expectation_vulcan,172118,4,53,75,128,0
4_5895206,noop_fears_depression_learning,5895206,4,48,74,122,0
4_2174354,noop_pleasure_learning,2174354,4,1,1,2,0
4_2791656,noop_planet_vulcan,2791656,4,1,1,2,0
4_1981432,noop_eats_tofu_onion,1981432,4,1,1,2,0
4_6074345,noop_fears_jealousy_stimulation,6074345,4,153,222,375,0
4_1639546,noop_craves_aesthetics_flounder,1639546,4,313,609,922,0
4_1451630,noop_craves_aesthetics_wonderbread,1451630,4,79,178,257,0
4_5504547,noop_harmony_lubricity_saturn,5504547,4,83,215,298,0
4_6630041,noop_fears_jealousy_love,6630041,4,101,209,310,0
4_2029468,noop_eats_lobster_bacon,2029468,4,1,1,2,0
4_4085983,noop_eats_wonderbread_bacon,4085983,4,1,1,2,0
4_5254932,noop_locale_lemon_manitoba,5254932,4,133,308,441,0
4_6447545,locale_lemon_bavaria,6447545,4,10,2,12,0
4_7866860,noop_fears_dread_aesthetics,7866860,4,116,215,331,0
4_1002897,noop_fears_abrasion_lubricity,1002897,4,112,216,328,0
4_5844016,noop_fears_sciatica_entertainment,5844016,4,159,303,462,0
4_7842983,noop_craves_boils_beef,7842983,4,135,274,409,0
4_2266958,noop_harmony_aesthetics_uranus,2266958,4,78,164,242,0
4_325406,noop_craves_expectation_snickers,325406,4,52,77,129,0
4_7276459,noop_food_lemon,7276459,4,1,1,2,0
4_3418815,noop_pain_prostatitis,3418815,4,1,1,2,0
4_5221458,noop_planet_saturn,5221458,4,1,1,2,0
4_6057461,noop_craves_lubricity_lemon,6057461,4,119,262,381,0
4_2167967,noop_harmony_entertainment_uranus,2167967,4,42,81,123,0
4_5520783,noop_eats_ham_flounder,5520783,4,1,1,2,0
4_3226658,noop_craves_entertainment_lamb,3226658,4,261,507,768,0
4_4169649,noop_craves_stimulation_bacon,4169649,4,366,758,1124,0
4_5747312,noop_pleasure_achievement,5747312,4,1,1,2,0
4_5373533,noop_pain_dread,5373533,4,1,1,2,0
4_2749009,noop_pain_jealousy,2749009,4,1,1,2,0
4_6264297,noop_eats_marzipan_beef,6264297,4,1,1,2,0
4_4191586,noop_craves_aesthetics_lamb,4191586,4,313,607,920,0
4_405072,noop_craves_stimulation_haroset,405072,4,131,282,413,0
4_67286,noop_pleasure_stimulation,67286,4,1,1,2,0
4_2616621,noop_province_goias,2616621,4,1,1,2,0
4_962651,noop_craves_hangover_snickers,962651,4,71,71,142,0
4_3848059,noop_fears_anger_lubricity,3848059,4,155,324,479,0
4_7783167,noop_food_haroset,7783167,4,1,1,2,0
4_3813846,noop_craves_jealousy_haroset,3813846,4,48,109,157,0
4_434518,noop_craves_love_haroset,434518,4,108,173,281,0
4_6952736,noop_eats_haroset_flounder,6952736,4,1,1,2,0
4_8709,noop_locale_bacon_manitoba,8709,4,95,212,307,0
4_5395676,locale_bacon_bavaria,5395676,4,9,2,11,0
4_1408559,noop_eats_flounder_ham,1408559,4,1,1,2,0
4_2087401,noop_craves_learning_snickers,2087401,4,54,68,122,0
4_7212115,noop_craves_stimulation_ham,7212115,4,161,302,463,0
4_2384120,noop_harmony_learning_vulcan,2384120,4,54,69,123,0
4_1669810,noop_province_manitoba,1669810,4,1,1,2,0
4_4856647,noop_locale_haroset_manitoba,4856647,4,215,436,651,0
4_7733722,locale_haroset_bavaria,7733722,4,16,2,18,0
4_159761,noop_craves_lubricity_tofu,159761,4,173,339,512,0
4_6298403,noop_locale_lamb_pennsylvania,6298403,4,230,51,281,0
4_5944252,noop_fears_laceration_lubricity,5944252,4,198,330,528,0
4_1318637,noop_food_onion,1318637,4,1,1,2,0
4_7007816,noop_pleasure_entertainment,7007816,4,1,1,2,0
4_7735830,noop_locale_cantelope_bavaria,7735830,4,1,1,2,0
4_5721688,noop_eats_wonderbread_okra,5721688,4,1,1,2,0
4_5199351,noop_eats_bacon_lobster,5199351,4,1,1,2,0
4_1191871,noop_eats_cantelope_marzipan,1191871,4,1,1,2,0
4_1042911,noop_craves_lubricity_lamb,1042911,4,140,279,419,0
4_6623699,noop_craves_depression_onion,6623699,4,85,119,204,0
4_1750704,noop_craves_entertainment_ham,1750704,4,270,533,803,0
4_5342758,noop_food_okra,5342758,4,1,1,2,0
4_534272,noop_harmony_lubricity_earth,534272,4,66,187,253,0
4_1581872,noop_eats_marzipan_cantelope,1581872,4,1,1,2,0
4_5296267,noop_fears_dread_learning,5296267,4,94,107,201,0
4_353504,noop_craves_stimulation_lemon,353504,4,153,292,445,0
4_3735115,noop_craves_entertainment_beef,3735115,4,271,532,803,0
4_7722518,noop_craves_love_flounder,7722518,4,207,428,635,0
4_7231076,noop_eats_beef_lamb,7231076,4,1,1,2,0
4_2484442,noop_pain_laceration,2484442,4,1,1,2,0
4_3260377,noop_eats_tofu_marzipan,3260377,4,1,1,2,0
4_6517750,noop_fears_anger_love,6517750,4,215,431,646,0
4_3255443,noop_craves_jealousy_lamb,3255443,4,231,151,382,0
4_1284607,noop_craves_lubricity_haroset,1284607,4,134,298,432,0
4_1192067,noop_harmony_aesthetics_saturn,1192067,4,73,136,209,0
4_735143,noop_orbits_uranus_saturn,735143,4,1,1,2,0
4_2533093,noop_fears_anxiety_learning,2533093,4,73,98,171,0
4_3837243,craves_anxiety_onion,3837243,4,9,14,23,0
4_7341957,noop_craves_lubricity_cantelope,7341957,4,135,308,443,0
4_1189107,noop_fears_hangover_expectation,1189107,4,46,68,114,0
4_6935494,noop_pain_loneliness,6935494,4,1,1,2,0
4_2832879,noop_eats_lemon_ham,2832879,4,1,1,2,0
4_1232579,noop_locale_lamb_bosnia,1232579,4,201,411,612,0
4_6227808,noop_locale_beef_pennsylvania,6227808,4,39,49,88,0
4_6052961,locale_beef_manitoba,6052961,4,26,17,43,0
4_2287477,noop_locale_flounder_pennsylvania,2287477,4,25,34,59,0
4_2060469,noop_fears_anxiety_expectation,2060469,4,115,187,302,0
4_6659042,noop_fears_prostatitis_stimulation,6659042,4,188,288,476,0
4_3761495,noop_eats_lemon_cantelope,3761495,4,1,1,2,0
4_6765322,noop_locale_okra_manitoba,6765322,4,57,77,134,0
4_765503,locale_okra_bavaria,765503,4,5,2,7,0
4_6721758,noop_craves_stimulation_lobster,6721758,4,313,650,963,0
4_3340809,noop_craves_expectation_onion,3340809,4,106,161,267,0
4_7286596,noop_craves_aesthetics_haroset,7286596,4,177,352,529,0
4_2622029,noop_craves_entertainment_haroset,2622029,4,124,287,411,0
4_3008246,noop_locale_lobster_bavaria,3008246,4,10,12,22,0
4_1551368,noop_craves_lubricity_beef,1551368,4,120,285,405,0
4_6751204,noop_craves_love_lobster,6751204,4,208,437,645,0
4_6098876,noop_food_lobster,6098876,4,1,1,2,0
4_964644,noop_pain_grief,964644,4,1,1,2,0
4_5073604,noop_harmony_love_uranus,5073604,4,49,96,145,0
4_982246,noop_craves_anxiety_onion,982246,4,10,14,24,0
4_4745869,noop_fears_angina_love,4745869,4,229,465,694,0
4_737720,noop_eats_lemon_beef,737720,4,1,1,2,0
4_3551919,noop_craves_angina_ham,3551919,4,15,44,59,0
4_3235111,noop_attacks_bavaria_manitoba,3235111,4,1,1,2,0
4_6938998,noop_eats_wonderbread_snickers,6938998,4,1,1,2,0
4_7656944,noop_craves_entertainment_flounder,7656944,4,261,500,761,0
4_3809309,noop_craves_entertainment_wonderbread,3809309,4,175,352,527,0
4_3592548,noop_locale_lemon_bavaria,3592548,4,11,14,25,0
4_3676811,noop_harmony_expectation_uranus,3676811,4,51,60,111,0
4_3295483,noop_eats_snickers_okra,3295483,4,1,1,2,0
4_4634499,noop_locale_marzipan_oregon,4634499,4,44,112,156,0
4_556463,noop_locale_snickers_manitoba,556463,4,68,93,161,0
4_2639657,locale_snickers_bavaria,2639657,4,7,2,9,0
4_5554132,noop_fears_jealousy_entertainment,5554132,4,157,298,455,0
4_4124722,noop_craves_sciatica_wonderbread,4124722,4,111,223,334,0
4_2312224,noop_fears_anger_entertainment,2312224,4,269,539,808,0
4_7543600,noop_province_bosnia,7543600,4,1,1,2,0
4_7650497,noop_attacks_manitoba_pennsylvania,7650497,4,1,1,2,0
4_6317512,noop_locale_beef_oregon,6317512,4,127,244,371,0
4_4892132,noop_craves_boils_ham,4892132,4,141,304,445,0
4_2224484,noop_locale_marzipan_pennsylvania,2224484,4,47,67,114,0
4_3159359,noop_pleasure_aesthetics,3159359,4,1,1,2,0
4_2443351,noop_eats_bacon_wonderbread,2443351,4,1,1,2,0
4_6512278,noop_attacks_goias_bosnia,6512278,4,1,1,2,0
4_1205284,noop_fears_boils_stimulation,1205284,4,211,331,542,0
4_335752,noop_craves_lubricity_ham,335752,4,121,289,410,0
4_2417187,noop_pleasure_lubricity,2417187,4,1,1,2,0
4_6239897,province_bosnia,6239897,4,1,1,2,0
4_7650924,eats_onion_tofu,7650924,4,1,1,2,0
3_6670250,succumb_jealousy_aesthetics_haroset_saturn_earth,6670250,3,6,225,231,0
2_7711852,fears_jealousy_aesthetics,7711852,2,0,1,1,0
3_3949850,succumb_depression_expectation_okra_uranus_saturn,3949850,3,7,95,102,0
3_7354400,succumb_jealousy_stimulation_lamb_saturn_earth,7354400,3,7,189,196,0
3_7971350,succumb_hangover_expectation_onion_uranus_saturn,7971350,3,7,118,125,0
4_3848180,craves_hangover_onion,3848180,4,1,45,46,0
3_7097700,feast_love_flounder_ham_bavaria_manitoba,7097700,3,6,339,345,0
2_5825714,locale_flounder_manitoba,5825714,2,0,2,2,0
4_1657041,locale_flounder_bavaria,1657041,4,2,87,89,0
3_4539100,feast_entertainment_flounder_ham_manitoba_pennsylvania,4539100,3,7,274,281,0
3_7405600,overcome_boils_lubricity_lemon_vulcan_uranus,7405600,3,8,141,149,0
2_7367121,harmony_lubricity_uranus,7367121,2,0,11,11,0
4_3862428,harmony_lubricity_vulcan,3862428,4,4,70,74,0
4_4679598,eats_bacon_wonderbread,4679598,4,1,6,7,0
4_1221736,eats_bacon_lobster,1221736,4,1,6,7,0
3_962651,noop_craves_hangover_snickers,962651,3,0,71,71,0
2_1750334,craves_hangover_snickers,1750334,2,0,3,3,0
4_5978126,eats_lamb_haroset,5978126,4,1,26,27,0
3_3339251,succumb_laceration_stimulation_lobster_saturn_earth,3339251,3,7,331,338,0
4_6130372,craves_laceration_lobster,6130372,4,1,94,95,0
3_7324951,succumb_depression_expectation_onion_uranus_saturn,7324951,3,7,123,130,0
3_1856801,succumb_prostatitis_stimulation_marzipan_saturn_earth,1856801,3,6,196,202,0
2_5866392,fears_prostatitis_stimulation,5866392,2,0,1,1,0
3_3839051,feast_love_lamb_beef_manitoba_pennsylvania,3839051,3,6,270,276,0
2_7086086,locale_lamb_pennsylvania,7086086,2,0,6,6,0
4_7957589,locale_lamb_manitoba,7957589,4,6,65,71,0
3_4255301,feast_stimulation_beef_lamb_bavaria_manitoba,4255301,3,6,175,181,0
2_6052961,locale_beef_manitoba,6052961,2,0,12,12,0
4_5689671,locale_beef_bavaria,5689671,4,12,3,15,0
3_2426101,feast_aesthetics_flounder_haroset_manitoba_pennsylvania,2426101,3,6,323,329,0
2_929030,craves_aesthetics_flounder,929030,2,0,5,5,0
3_5944252,noop_fears_laceration_lubricity,5944252,3,0,198,198,0
2_5233736,fears_laceration_lubricity,5233736,2,0,1,1,0
4_4281177,eats_okra_wonderbread,4281177,4,1,3,4,0
3_4001252,noop_fears_dread_entertainment,4001252,3,0,203,203,0
2_5623675,fears_dread_entertainment,5623675,2,0,1,1,0
3_5839952,succumb_abrasion_stimulation_lemon_saturn_earth,5839952,3,7,179,186,0
4_6559853,craves_abrasion_lemon,6559853,4,3,14,17,0
3_3306552,succumb_hangover_learning_snickers_uranus_saturn,3306552,3,7,102,109,0
3_6958152,succumb_jealousy_stimulation_lamb_uranus_saturn,6958152,3,6,189,195,0
2_1293205,harmony_stimulation_uranus,1293205,2,0,13,13,0
3_4670002,succumb_dread_aesthetics_wonderbread_uranus_saturn,4670002,3,6,127,133,0
2_3889381,harmony_aesthetics_uranus,3889381,2,0,13,13,0
3_5093302,succumb_jealousy_entertainment_lamb_vulcan_uranus,5093302,3,7,285,292,0
3_1723202,succumb_boils_stimulation_lemon_saturn_earth,1723202,3,6,218,224,0
2_5615149,fears_boils_stimulation,5615149,2,0,1,1,0
3_766152,feast_entertainment_beef_lamb_bavaria_manitoba,766152,3,6,298,304,0
2_5357538,craves_entertainment_beef,5357538,2,0,12,12,0
3_1518752,feast_love_flounder_haroset_manitoba_pennsylvania,1518752,3,7,221,228,0
3_3894502,overcome_sciatica_entertainment_lobster_vulcan_uranus,3894502,3,8,184,192,0
2_6898824,craves_sciatica_lobster,6898824,2,0,5,5,0
3_5087052,overcome_jealousy_aesthetics_haroset_uranus_saturn,5087052,3,9,223,232,0
3_6298403,noop_locale_lamb_pennsylvania,6298403,3,1,230,231,0
4_3046200,locale_tofu_manitoba,3046200,4,5,10,15,0
3_162853,noop_craves_boils_cantelope,162853,3,0,146,146,0
2_2399100,craves_boils_cantelope,2399100,2,0,2,2,0
3_2453,succumb_laceration_love_haroset_vulcan_uranus,2453,3,7,252,259,0
3_4446503,feast_love_marzipan_tofu_manitoba_pennsylvania,4446503,3,5,257,262,0
2_3534048,locale_marzipan_pennsylvania,3534048,2,0,12,12,0
2_4058429,craves_love_marzipan,4058429,2,0,9,9,0
4_7514601,locale_marzipan_manitoba,7514601,4,12,21,33,0
4_2670059,craves_love_tofu,2670059,4,2,72,74,0
3_7591803,feast_entertainment_beef_lamb_manitoba_pennsylvania,7591803,3,7,298,305,0
3_3555053,overcome_abrasion_entertainment_beef_vulcan_uranus,3555053,3,9,298,307,0
4_137328,fears_abrasion_entertainment,137328,4,1,86,87,0
3_1750704,noop_craves_entertainment_ham,1750704,3,0,270,270,0
2_2538387,craves_entertainment_ham,2538387,2,0,6,6,0
4_5127929,pleasure_learning,5127929,4,1,89,90,0
4_1567476,pain_anger,1567476,4,1,82,83,0
3_3637704,noop_craves_lubricity_wonderbread,3637704,3,0,170,170,0
2_4947268,craves_lubricity_wonderbread,4947268,2,0,4,4,0
4_7563751,eats_cantelope_lemon,7563751,4,1,1,2,0
4_3344601,craves_loneliness_tofu,3344601,4,3,10,13,0
3_7710104,feast_aesthetics_flounder_ham_pennsylvania_oregon,7710104,3,7,323,330,0
4_2544554,craves_aesthetics_ham,2544554,4,2,114,116,0
3_4812954,feast_lubricity_tofu_onion_bavaria_manitoba,4812954,3,6,178,184,0
2_2950086,craves_lubricity_tofu,2950086,2,0,3,3,0
4_4459027,locale_tofu_bavaria,4459027,4,4,12,16,0
4_2335886,craves_lubricity_onion,2335886,4,1,61,62,0
3_7169104,feast_lubricity_lamb_beef_manitoba_pennsylvania,7169104,3,7,347,354,0
3_5284704,overcome_sciatica_stimulation_lobster_saturn_earth,5284704,3,9,400,409,0
4_2813229,fears_sciatica_stimulation,2813229,4,4,64,68,0
4_7281678,eats_snickers_wonderbread,7281678,4,1,3,4,0
3_1814505,noop_fears_abrasion_love,1814505,3,0,232,232,0
2_7670121,fears_abrasion_love,7670121,2,0,1,1,0
3_2098705,noop_fears_sciatica_love,2098705,3,0,290,290,0
2_7954321,fears_sciatica_love,7954321,2,0,1,1,0
3_2129555,noop_craves_jealousy_lobster,2129555,3,0,234,234,0
2_6539420,craves_jealousy_lobster,6539420,2,0,5,5,0
3_5174505,noop_craves_stimulation_cantelope,5174505,3,0,179,179,0
2_6484069,craves_stimulation_cantelope,6484069,2,0,1,1,0
4_4730552,eats_beef_lemon,4730552,4,1,16,17,0
3_4033505,feast_lubricity_haroset_flounder_bavaria_manitoba,4033505,3,6,337,343,0
2_2072290,craves_lubricity_haroset,2072290,2,0,6,6,0
3_2268705,overcome_prostatitis_love_marzipan_vulcan_uranus,2268705,3,9,240,249,0
4_2054340,fears_prostatitis_love,2054340,4,1,66,67,0
3_2848655,overcome_laceration_aesthetics_haroset_uranus_saturn,2848655,3,8,330,338,0
2_7814663,craves_laceration_haroset,7814663,2,0,6,6,0
4_4107973,fears_laceration_aesthetics,4107973,4,3,77,80,0
4_3976229,planet_vulcan,3976229,4,1,332,333,0
3_1308456,feast_stimulation_marzipan_tofu_manitoba_pennsylvania,1308456,3,7,184,191,0
3_6976806,feast_love_lamb_beef_pennsylvania_oregon,6976806,3,7,230,237,0
3_2348506,feast_love_marzipan_wonderbread_manitoba_pennsylvania,2348506,3,7,257,264,0
3_1199656,overcome_depression_expectation_okra_uranus_saturn,1199656,3,8,122,130,0
2_7412205,craves_depression_okra,7412205,2,0,3,3,0
3_2537806,overcome_hangover_stimulation_wonderbread_saturn_earth,2537806,3,7,262,269,0
2_3955115,craves_stimulation_wonderbread,3955115,2,0,4,4,0
2_4681374,craves_hangover_wonderbread,4681374,2,0,12,12,0
4_1239506,fears_hangover_stimulation,1239506,4,1,56,57,0
3_1671606,overcome_jealousy_lubricity_lamb_uranus_saturn,1671606,3,8,353,361,0
2_6110440,craves_jealousy_lamb,6110440,2,0,6,6,0
4_5529098,fears_jealousy_lubricity,5529098,4,5,56,61,0
3_3900606,overcome_laceration_stimulation_haroset_saturn_earth,3900606,3,9,174,183,0
3_2078856,overcome_grief_love_haroset_vulcan_uranus,2078856,3,8,252,260,0
2_7158854,craves_grief_haroset,7158854,2,0,6,6,0
3_1284607,noop_craves_lubricity_haroset,1284607,3,1,134,135,0
4_3933873,province_bavaria,3933873,4,1,1,2,0
4_4177969,food_cantelope,4177969,4,1,75,76,0
3_4303857,noop_craves_grief_haroset,4303857,3,1,149,150,0
3_1313207,succumb_hangover_expectation_okra_vulcan_uranus,1313207,3,6,75,81,0
2_7462579,harmony_expectation_vulcan,7462579,2,0,7,7,0
3_183107,feast_love_marzipan_wonderbread_pennsylvania_oregon,183107,3,7,267,274,0
3_1246857,overcome_abrasion_lubricity_beef_vulcan_uranus,1246857,3,9,158,167,0
3_605957,overcome_anger_lubricity_flounder_uranus_saturn,605957,3,9,162,171,0
3_2353707,overcome_dread_stimulation_wonderbread_saturn_earth,2353707,3,9,220,229,0
4_1449880,fears_dread_stimulation,1449880,4,1,53,54,0
3_3724357,overcome_jealousy_stimulation_lamb_saturn_earth,3724357,3,9,332,341,0
3_109407,overcome_jealousy_lubricity_flounder_saturn_earth,109407,3,8,357,365,0
2_1511676,craves_jealousy_flounder,1511676,2,0,3,3,0
3_5684257,overcome_laceration_lubricity_haroset_saturn_earth,5684257,3,9,285,294,0
4_6133837,food_okra,6133837,4,1,31,32,0
4_6406031,planet_saturn,6406031,4,1,465,466,0
3_2266958,noop_harmony_aesthetics_uranus,2266958,3,1,78,79,0
3_6769458,noop_craves_laceration_beef,6769458,3,0,159,159,0
2_1004728,craves_laceration_beef,1004728,2,0,6,6,0
3_5175958,noop_craves_depression_okra,5175958,3,1,83,84,0
3_1601758,feast_entertainment_ham_lemon_oregon_goias,1601758,3,7,285,292,0
4_4317787,craves_entertainment_lemon,4317787,4,5,90,95,0
3_5289058,feast_entertainment_beef_lemon_pennsylvania_oregon,5289058,3,7,370,377,0
3_1740408,overcome_sciatica_expectation_wonderbread_uranus_saturn,1740408,3,8,166,174,0
2_6255097,craves_sciatica_wonderbread,6255097,2,0,9,9,0
4_2052314,fears_sciatica_expectation,2052314,4,2,43,45,0
3_5180458,overcome_sciatica_stimulation_lobster_uranus_saturn,5180458,3,9,397,406,0
3_2037158,overcome_depression_aesthetics_wonderbread_saturn_earth,2037158,3,8,178,186,0
2_4561120,craves_depression_wonderbread,4561120,2,0,12,12,0
4_1269400,fears_depression_aesthetics,1269400,4,3,4,7,0
3_719808,overcome_hangover_aesthetics_wonderbread_vulcan_uranus,719808,3,9,173,182,0
4_384688,harmony_aesthetics_vulcan,384688,4,7,34,41,0
4_1288709,fears_hangover_aesthetics,1288709,4,3,42,45,0
4_1013998,pleasure_aesthetics,1013998,4,1,287,288,0
4_4362134,eats_flounder_ham,4362134,4,1,16,17,0
3_3848059,noop_fears_anger_lubricity,3848059,3,0,155,155,0
2_6638384,fears_anger_lubricity,6638384,2,0,1,1,0
4_3933582,pain_jealousy,3933582,4,1,182,183,0
4_1767281,food_lemon,1767281,4,1,154,155,0
3_2488959,noop_craves_sciatica_lobster,2488959,3,1,110,111,0
4_20256,province_oregon,20256,4,1,1,2,0
3_105909,succumb_grief_aesthetics_haroset_saturn_earth,105909,3,7,202,209,0
3_5978109,succumb_abrasion_stimulation_marzipan_saturn_earth,5978109,3,7,179,186,0
4_666181,craves_abrasion_marzipan,666181,4,2,18,20,0
3_2415109,succumb_jealousy_love_bacon_vulcan_uranus,2415109,3,7,282,289,0
4_3001779,craves_jealousy_bacon,3001779,4,1,86,87,0
3_2582759,feast_entertainment_lamb_beef_pennsylvania_oregon,2582759,3,7,283,290,0
3_1872809,feast_entertainment_lamb_haroset_pennsylvania_oregon,1872809,3,7,283,290,0
3_3218509,feast_aesthetics_lamb_beef_pennsylvania_oregon,3218509,3,6,332,338,0
2_6427833,craves_aesthetics_lamb,6427833,2,0,7,7,0
4_6936290,craves_aesthetics_beef,6936290,4,3,119,122,0
3_4063809,feast_entertainment_ham_lemon_goias_bosnia,4063809,3,7,294,301,0
3_1110459,feast_lubricity_ham_lemon_pennsylvania_oregon,1110459,3,6,341,347,0
2_3895862,locale_ham_oregon,3895862,2,0,2,2,0
4_7946530,locale_ham_pennsylvania,7946530,4,2,99,101,0
3_6495159,overcome_depression_entertainment_wonderbread_vulcan_uranus,6495159,3,9,265,274,0
4_4530591,fears_depression_entertainment,4530591,4,1,76,77,0
3_535709,overcome_dread_aesthetics_wonderbread_vulcan_uranus,535709,3,9,127,136,0
4_4623385,province_manitoba,4623385,4,1,1,2,0
3_5822310,succumb_depression_expectation_snickers_vulcan_uranus,5822310,3,7,95,102,0
3_1621760,succumb_jealousy_stimulation_lobster_saturn_earth,1621760,3,7,339,346,0
3_7837110,succumb_jealousy_love_beef_vulcan_uranus,7837110,3,7,242,249,0
4_6618897,craves_jealousy_beef,6618897,4,1,74,75,0
3_4191810,succumb_laceration_lubricity_lamb_saturn_earth,4191810,3,7,211,218,0
3_689260,overcome_hangover_aesthetics_wonderbread_saturn_earth,689260,3,9,167,176,0
3_7178510,overcome_laceration_stimulation_lamb_vulcan_uranus,7178510,3,9,158,167,0
4_5789489,harmony_stimulation_vulcan,5789489,4,6,67,73,0
4_4022794,attacks_bavaria_manitoba,4022794,4,1,126,127,0
3_159761,noop_craves_lubricity_tofu,159761,3,1,173,174,0
3_1634561,noop_fears_grief_stimulation,1634561,3,0,345,345,0
2_6044426,fears_grief_stimulation,6044426,2,0,1,1,0
3_7818311,succumb_jealousy_stimulation_haroset_uranus_saturn,7818311,3,7,189,196,0
3_6581411,feast_love_lemon_beef_bavaria_manitoba,6581411,3,6,332,338,0
2_614612,craves_love_lemon,614612,2,0,4,4,0
3_3825711,overcome_hangover_learning_wonderbread_uranus_saturn,3825711,3,9,113,122,0
3_6002311,overcome_hangover_lubricity_wonderbread_saturn_earth,6002311,3,9,247,256,0
4_3222479,fears_hangover_lubricity,3222479,4,1,66,67,0
3_2250911,overcome_jealousy_love_lamb_vulcan_uranus,2250911,3,9,242,251,0
4_601332,pleasure_achievement,601332,4,1,35,36,0
4_6456524,eats_lamb_beef,6456524,4,1,26,27,0
4_3715801,orbits_saturn_earth,3715801,4,1,456,457,0
3_3333912,succumb_grief_aesthetics_lobster_uranus_saturn,3333912,3,7,134,141,0
3_3373212,succumb_jealousy_entertainment_flounder_vulcan_uranus,3373212,3,7,285,292,0
3_3174512,overcome_depression_expectation_wonderbread_vulcan_uranus,3174512,3,9,122,131,0
3_713912,overcome_jealousy_love_lobster_vulcan_uranus,713912,3,9,242,251,0
3_4668313,succumb_sciatica_aesthetics_wonderbread_uranus_saturn,4668313,3,7,117,124,0
3_2073263,feast_love_lamb_haroset_manitoba_pennsylvania,2073263,3,7,270,277,0
3_2625063,feast_stimulation_ham_lemon_oregon_goias,2625063,3,6,180,186,0
2_1447385,craves_stimulation_ham,1447385,2,0,6,6,0
3_6375513,feast_lubricity_lamb_haroset_manitoba_pennsylvania,6375513,3,7,347,354,0
3_4890413,overcome_hangover_aesthetics_wonderbread_uranus_saturn,4890413,3,9,173,182,0
3_1206463,overcome_laceration_stimulation_beef_saturn_earth,1206463,3,9,174,183,0
3_4256113,overcome_laceration_lubricity_lamb_uranus_saturn,4256113,3,9,186,195,0
3_256263,overcome_grief_aesthetics_bacon_uranus_saturn,256263,3,8,200,208,0
2_5729757,craves_grief_bacon,5729757,2,0,4,4,0
3_5662014,noop_craves_love_lemon,5662014,3,1,211,212,0
4_4615811,locale_onion_bavaria,4615811,4,1,1,2,0
3_3197964,noop_locale_beef_manitoba,3197964,3,1,39,40,0
3_5699864,succumb_dread_expectation_wonderbread_vulcan_uranus,5699864,3,7,92,99,0
3_1978464,succumb_anger_love_ham_vulcan_uranus,1978464,3,7,232,239,0
4_587956,craves_anger_ham,587956,4,1,70,71,0
3_4999814,feast_stimulation_marzipan_beef_manitoba_pennsylvania,4999814,3,7,184,191,0
3_5087114,feast_stimulation_ham_lemon_goias_bosnia,5087114,3,7,193,200,0
3_4876814,overcome_boils_stimulation_lemon_uranus_saturn,4876814,3,9,189,198,0
3_5460364,overcome_boils_lubricity_beef_saturn_earth,5460364,3,8,150,158,0
2_2795581,craves_boils_beef,2795581,2,0,6,6,0
3_3224664,overcome_sciatica_achievement_wonderbread_uranus_saturn,3224664,3,9,123,132,0
4_492278,fears_sciatica_achievement,492278,4,2,40,42,0
3_6192364,overcome_sciatica_stimulation_wonderbread_saturn_earth,6192364,3,9,292,301,0
3_6283964,overcome_grief_stimulation_lobster_uranus_saturn,6283964,3,9,350,359,0
3_3735115,noop_craves_entertainment_beef,3735115,3,1,271,272,0
3_7212115,noop_craves_stimulation_ham,7212115,3,1,161,162,0
4_5711881,pain_prostatitis,5711881,4,1,100,101,0
4_7420512,orbits_vulcan_uranus,7420512,4,1,577,578,0
3_6173515,feast_love_flounder_haroset_bavaria_manitoba,6173515,3,7,339,346,0
3_1475265,feast_love_flounder_ham_manitoba_pennsylvania,1475265,3,7,221,228,0
4_1243086,pleasure_entertainment,1243086,4,1,173,174,0
3_4027966,succumb_laceration_stimulation_beef_uranus_saturn,4027966,3,7,168,175,0
3_2792416,succumb_prostatitis_lubricity_marzipan_saturn_earth,2792416,3,6,181,187,0
2_3194470,fears_prostatitis_lubricity,3194470,2,0,1,1,0
3_2530816,succumb_hangover_learning_wonderbread_uranus_saturn,2530816,3,7,102,109,0
3_1995966,feast_stimulation_flounder_haroset_manitoba_pennsylvania,1995966,3,7,329,336,0
3_4680216,overcome_jealousy_aesthetics_lobster_vulcan_uranus,4680216,3,9,307,316,0
3_6859466,overcome_grief_lubricity_haroset_saturn_earth,6859466,3,9,286,295,0
4_1606144,fears_grief_lubricity,1606144,4,1,87,88,0
4_2380884,food_haroset,2380884,4,1,204,205,0
3_7388917,feast_aesthetics_flounder_ham_manitoba_pennsylvania,7388917,3,7,323,330,0
3_1650517,overcome_sciatica_lubricity_wonderbread_saturn_earth,1650517,3,9,286,295,0
4_4553354,fears_sciatica_lubricity,4553354,4,1,83,84,0
3_4920217,overcome_abrasion_stimulation_beef_vulcan_uranus,4920217,3,9,169,178,0
3_7345117,overcome_depression_expectation_wonderbread_uranus_saturn,7345117,3,9,113,122,0
3_1688017,overcome_hangover_learning_snickers_vulcan_uranus,1688017,3,9,120,129,0
3_6350567,overcome_grief_stimulation_haroset_vulcan_uranus,6350567,3,9,282,291,0
4_6052830,eats_lobster_bacon,6052830,4,1,6,7,0
3_172118,noop_harmony_expectation_vulcan,172118,3,1,53,54,0
3_3565718,feast_love_lamb_haroset_pennsylvania_oregon,3565718,3,7,230,237,0
3_529568,feast_stimulation_lamb_haroset_manitoba_pennsylvania,529568,3,7,295,302,0
3_4658768,overcome_depression_achievement_wonderbread_vulcan_uranus,4658768,3,9,113,122,0
4_554475,harmony_achievement_vulcan,554475,4,3,15,18,0
4_1976428,fears_depression_achievement,1976428,4,2,27,29,0
3_3684018,overcome_jealousy_stimulation_haroset_vulcan_uranus,3684018,3,9,189,198,0
3_115618,overcome_jealousy_lubricity_haroset_saturn_earth,115618,3,9,183,192,0
3_4745869,noop_fears_angina_love,4745869,3,0,229,229,0
2_7699444,fears_angina_love,7699444,2,0,1,1,0
3_2060469,noop_fears_anxiety_expectation,2060469,3,0,115,115,0
2_3682892,fears_anxiety_expectation,3682892,2,0,1,1,0
4_3135358,eats_snickers_onion,3135358,4,1,3,4,0
3_850069,succumb_depression_learning_okra_vulcan_uranus,850069,3,6,89,95,0
2_6793985,harmony_learning_vulcan,6793985,2,0,9,9,0
3_2496319,succumb_sciatica_entertainment_wonderbread_vulcan_uranus,2496319,3,7,195,202,0
3_2287869,overcome_hangover_expectation_wonderbread_uranus_saturn,2287869,3,9,79,88,0
3_4991169,overcome_jealousy_love_flounder_vulcan_uranus,4991169,3,9,242,251,0
3_6016119,overcome_laceration_lubricity_beef_vulcan_uranus,6016119,3,9,282,291,0
4_7434994,eats_lemon_beef,7434994,4,1,6,7,0
3_2384120,noop_harmony_learning_vulcan,2384120,3,1,54,55,0
3_5353770,noop_craves_depression_wonderbread,5353770,3,1,83,84,0
4_3163114,planet_earth,3163114,4,1,239,240,0
3_5027470,overcome_boils_love_lemon_vulcan_uranus,5027470,3,9,245,254,0
4_1497644,fears_boils_love,1497644,4,3,69,72,0
3_7332920,overcome_laceration_love_haroset_vulcan_uranus,7332920,3,9,274,283,0
4_5601736,eats_cantelope_marzipan,5601736,4,1,1,2,0
4_1830183,province_goias,1830183,4,1,1,2,0
3_2003721,noop_harmony_stimulation_uranus,2003721,3,1,118,119,0
3_2267521,succumb_abrasion_stimulation_beef_uranus_saturn,2267521,3,7,169,176,0
3_5872071,succumb_jealousy_stimulation_flounder_saturn_earth,5872071,3,7,339,346,0
3_1092171,feast_entertainment_beef_lemon_manitoba_pennsylvania,1092171,3,7,298,305,0
3_7535671,feast_entertainment_flounder_haroset_manitoba_pennsylvania,7535671,3,7,274,281,0
3_6407521,overcome_boils_stimulation_beef_saturn_earth,6407521,3,9,269,278,0
3_1609871,overcome_jealousy_stimulation_lamb_vulcan_uranus,1609871,3,9,330,339,0
3_2619021,overcome_laceration_aesthetics_haroset_saturn_earth,2619021,3,9,333,342,0
3_4124722,noop_craves_sciatica_wonderbread,4124722,3,1,111,112,0
4_5991737,eats_marzipan_cantelope,5991737,4,1,16,17,0
3_7442272,succumb_laceration_stimulation_haroset_uranus_saturn,7442272,3,7,168,175,0
3_7780222,succumb_depression_expectation_okra_vulcan_uranus,7780222,3,7,95,102,0
3_1132122,succumb_sciatica_aesthetics_haroset_saturn_earth,1132122,3,7,191,198,0
4_582138,craves_sciatica_haroset,582138,4,1,67,68,0
3_5252072,succumb_depression_learning_onion_vulcan_uranus,5252072,3,7,89,96,0
3_5222622,succumb_abrasion_lubricity_lemon_uranus_saturn,5222622,3,7,158,165,0
3_6087972,succumb_abrasion_lubricity_beef_uranus_saturn,6087972,3,7,158,165,0
3_1363922,succumb_jealousy_entertainment_lobster_vulcan_uranus,1363922,3,7,177,184,0
3_3991422,feast_love_beef_marzipan_bavaria_manitoba,3991422,3,7,241,248,0
3_3081722,feast_aesthetics_lamb_beef_oregon_goias,3081722,3,7,332,339,0
3_4348222,feast_lubricity_beef_marzipan_bavaria_manitoba,4348222,3,7,164,171,0
3_1426622,overcome_sciatica_love_lobster_vulcan_uranus,1426622,3,9,297,306,0
3_5858622,overcome_hangover_learning_snickers_uranus_saturn,5858622,3,9,121,130,0
3_6035322,overcome_laceration_entertainment_beef_vulcan_uranus,6035322,3,9,369,378,0
3_491172,overcome_laceration_lubricity_beef_saturn_earth,491172,3,9,280,289,0
3_5218222,overcome_loneliness_stimulation_tofu_saturn_earth,5218222,3,8,193,201,0
2_4703614,craves_stimulation_tofu,4703614,2,0,3,3,0
4_1586642,fears_loneliness_stimulation,1586642,4,1,49,50,0
3_484773,noop_fears_laceration_entertainment,484773,3,0,288,288,0
2_5591775,fears_laceration_entertainment,5591775,2,0,1,1,0
3_1821573,succumb_grief_aesthetics_bacon_uranus_saturn,1821573,3,7,134,141,0
3_3834623,feast_stimulation_tofu_onion_bavaria_manitoba,3834623,3,7,193,200,0
4_3184342,craves_stimulation_onion,3184342,4,1,57,58,0
3_5543773,feast_aesthetics_lamb_beef_goias_bosnia,5543773,3,7,417,424,0
3_7065323,feast_entertainment_beef_marzipan_manitoba_pennsylvania,7065323,3,7,298,305,0
4_345208,craves_entertainment_marzipan,345208,4,3,100,103,0
3_6669823,overcome_grief_entertainment_haroset_vulcan_uranus,6669823,3,9,158,167,0
3_2312224,noop_fears_anger_entertainment,2312224,3,0,269,269,0
2_3934647,fears_anger_entertainment,3934647,2,0,1,1,0
4_1626822,province_pennsylvania,1626822,4,1,1,2,0
3_7136924,succumb_hangover_learning_snickers_vulcan_uranus,7136924,3,7,102,109,0
3_1221474,overcome_sciatica_stimulation_bacon_saturn_earth,1221474,3,8,393,401,0
2_4957332,craves_stimulation_bacon,4957332,2,0,3,3,0
3_244024,overcome_depression_learning_onion_uranus_saturn,244024,3,8,90,98,0
2_3032587,craves_depression_onion,3032587,2,0,1,1,0
3_3610125,succumb_angina_lubricity_ham_uranus_saturn,3610125,3,7,149,156,0
3_1927425,succumb_grief_aesthetics_bacon_saturn_earth,1927425,3,7,134,141,0
3_6490525,succumb_depression_learning_snickers_vulcan_uranus,6490525,3,7,79,86,0
3_6593675,succumb_anger_lubricity_flounder_saturn_earth,6593675,3,7,164,171,0
3_5993525,succumb_anxiety_expectation_onion_uranus_saturn,5993525,3,7,119,126,0
3_3806225,feast_lubricity_ham_flounder_pennsylvania_oregon,3806225,3,7,341,348,0
3_3772125,overcome_hangover_achievement_wonderbread_uranus_saturn,3772125,3,9,84,93,0
4_6919532,fears_hangover_achievement,6919532,4,2,24,26,0
3_2643175,overcome_dread_love_wonderbread_vulcan_uranus,2643175,3,8,333,341,0
2_7041704,craves_love_wonderbread,7041704,2,0,3,3,0
4_804392,fears_dread_love,804392,4,1,99,100,0
3_2858925,overcome_grief_aesthetics_bacon_saturn_earth,2858925,3,9,201,210,0
4_696593,food_lobster,696593,4,1,100,101,0
4_6444638,eats_beef_lamb,6444638,4,1,16,17,0
3_4827176,succumb_grief_entertainment_lamb_vulcan_uranus,4827176,3,7,281,288,0
4_5808558,craves_grief_lamb,5808558,4,1,88,89,0
3_1659426,succumb_abrasion_lubricity_lemon_saturn_earth,1659426,3,7,158,165,0
3_5717126,succumb_anxiety_learning_onion_vulcan_uranus,5717126,3,7,80,87,0
3_4528676,feast_entertainment_beef_lemon_bavaria_manitoba,4528676,3,7,298,305,0
3_6766776,overcome_sciatica_aesthetics_wonderbread_saturn_earth,6766776,3,9,118,127,0
3_2684976,overcome_prostatitis_lubricity_marzipan_uranus_saturn,2684976,3,9,158,167,0
3_5780476,overcome_jealousy_stimulation_lamb_uranus_saturn,5780476,3,9,330,339,0
4_7283739,eats_tofu_marzipan,7283739,4,1,5,6,0
4_5583426,food_bacon,5583426,4,1,68,69,0
4_6905224,attacks_oregon_goias,6905224,4,1,21,22,0
4_4569802,eats_haroset_lamb,4569802,4,1,6,7,0
3_1687677,feast_lubricity_marzipan_tofu_manitoba_pennsylvania,1687677,3,7,173,180,0
3_2619727,feast_lubricity_beef_lemon_bavaria_manitoba,2619727,3,7,164,171,0
3_3018377,overcome_depression_learning_wonderbread_uranus_saturn,3018377,3,9,90,99,0
3_5194977,overcome_depression_lubricity_wonderbread_saturn_earth,5194977,3,9,258,267,0
4_2128520,fears_depression_lubricity,2128520,4,1,69,70,0
3_2184177,overcome_angina_stimulation_ham_saturn_earth,2184177,3,9,180,189,0
4_597652,fears_angina_stimulation,597652,4,1,28,29,0
4_1366298,attacks_goias_bosnia,1366298,4,1,21,22,0
4_918250,pain_boils,918250,4,1,165,166,0
3_2643728,succumb_boils_lubricity_lemon_uranus_saturn,2643728,3,7,141,148,0
3_6766178,succumb_boils_lubricity_ham_uranus_saturn,6766178,3,7,149,156,0
3_135828,succumb_abrasion_love_beef_vulcan_uranus,135828,3,7,245,252,0
3_5030028,overcome_depression_expectation_okra_vulcan_uranus,5030028,3,9,121,130,0
3_103928,overcome_anger_stimulation_flounder_uranus_saturn,103928,3,9,330,339,0
3_4993028,overcome_grief_stimulation_haroset_saturn_earth,4993028,3,9,280,289,0
4_2046441,eats_lemon_ham,2046441,4,1,6,7,0
4_778475,pain_hangover,778475,4,1,78,79,0
4_1840068,food_wonderbread,1840068,4,1,316,317,0
3_6089429,noop_fears_jealousy_aesthetics,6089429,3,1,217,218,0
3_1092529,succumb_boils_lubricity_flounder_saturn_earth,1092529,3,7,155,162,0
4_7080594,craves_boils_flounder,7080594,4,1,52,53,0
3_7161479,overcome_hangover_entertainment_wonderbread_vulcan_uranus,7161479,3,9,254,263,0
4_4236582,fears_hangover_entertainment,4236582,4,1,73,74,0
4_522536,locale_cantelope_bavaria,522536,4,1,1,2,0
4_4138703,eats_wonderbread_marzipan,4138703,4,1,1,2,0
4_2200903,pleasure_love,2200903,4,1,195,196,0
3_3004630,succumb_anger_stimulation_flounder_saturn_earth,3004630,3,6,332,338,0
2_6654103,fears_anger_stimulation,6654103,2,0,1,1,0
3_532580,succumb_depression_expectation_wonderbread_vulcan_uranus,532580,3,7,95,102,0
3_1210430,succumb_hangover_expectation_snickers_vulcan_uranus,1210430,3,7,78,85,0
3_6207230,feast_entertainment_beef_marzipan_pennsylvania_oregon,6207230,3,7,370,377,0
3_5570780,overcome_sciatica_expectation_wonderbread_vulcan_uranus,5570780,3,9,171,180,0
3_6675930,overcome_hangover_expectation_snickers_uranus_saturn,6675930,3,9,79,88,0
4_6588915,locale_wonderbread_bavaria,6588915,4,1,1,2,0
3_5038031,noop_locale_flounder_manitoba,5038031,3,1,319,320,0
4_6425404,eats_marzipan_wonderbread,6425404,4,1,16,17,0
4_3412554,food_marzipan,3412554,4,1,164,165,0
4_2289801,eats_haroset_lobster,2289801,4,1,6,7,0
3_5236381,succumb_angina_lubricity_lemon_saturn_earth,5236381,3,7,149,156,0
4_894524,craves_angina_lemon,894524,4,2,50,52,0
3_5362331,succumb_grief_entertainment_wonderbread_vulcan_uranus,5362331,3,7,197,204,0
4_4546428,craves_grief_wonderbread,4546428,4,1,80,81,0
3_781281,succumb_anger_entertainment_flounder_vulcan_uranus,781281,3,7,277,284,0
3_7592181,feast_stimulation_tofu_marzipan_bavaria_manitoba,7592181,3,7,193,200,0
3_106781,overcome_boils_entertainment_ham_vulcan_uranus,106781,3,8,390,398,0
2_7185198,craves_boils_ham,7185198,2,0,4,4,0
4_3359573,fears_boils_entertainment,3359573,4,2,108,110,0
3_1390631,overcome_depression_learning_okra_uranus_saturn,1390631,3,9,90,99,0
3_465631,overcome_jealousy_lubricity_flounder_uranus_saturn,465631,3,9,354,363,0
3_4892132,noop_craves_boils_ham,4892132,3,1,141,142,0
4_677729,eats_tofu_onion,677729,4,1,5,6,0
3_1203432,noop_craves_love_marzipan,1203432,3,1,227,228,0
3_5441782,succumb_laceration_love_beef_vulcan_uranus,5441782,3,7,257,264,0
3_6098332,succumb_laceration_stimulation_lamb_uranus_saturn,6098332,3,7,158,165,0
3_5496032,succumb_laceration_stimulation_flounder_saturn_earth,5496032,3,7,331,338,0
4_808089,craves_laceration_flounder,808089,4,1,98,99,0
3_2066332,succumb_anger_love_haroset_vulcan_uranus,2066332,3,7,229,236,0
4_6590502,craves_anger_haroset,6590502,4,1,64,65,0
3_1210982,feast_love_marzipan_cantelope_manitoba_pennsylvania,1210982,3,7,257,264,0
4_1501452,craves_love_cantelope,1501452,4,3,67,70,0
3_6505132,feast_aesthetics_lamb_haroset_pennsylvania_oregon,6505132,3,7,332,339,0
3_4417732,overcome_sciatica_aesthetics_lobster_saturn_earth,4417732,3,9,118,127,0
4_7318845,eats_snickers_okra,7318845,4,1,3,4,0
4_7865332,pain_dread,7865332,4,1,38,39,0
4_473381,eats_ham_flounder,473381,4,1,22,23,0
3_7842983,noop_craves_boils_beef,7842983,3,1,135,136,0
4_6322230,eats_wonderbread_bacon,6322230,4,1,1,2,0
4_3151412,food_lamb,3151412,4,1,195,196,0
4_2268262,food_tofu,2268262,4,1,81,82,0
3_124533,succumb_abrasion_stimulation_lamb_saturn_earth,124533,3,7,169,176,0
4_1294904,craves_abrasion_lamb,1294904,4,3,18,21,0
3_7482733,feast_lubricity_marzipan_cantelope_manitoba_pennsylvania,7482733,3,7,173,180,0
3_938483,feast_stimulation_bacon_wonderbread_bavaria_manitoba,938483,3,7,412,419,0
3_7096833,overcome_boils_love_ham_vulcan_uranus,7096833,3,9,343,352,0
3_415833,overcome_boils_stimulation_beef_vulcan_uranus,415833,3,9,271,280,0
3_1732283,overcome_boils_stimulation_ham_saturn_earth,1732283,3,9,281,290,0
3_3557683,overcome_depression_stimulation_wonderbread_saturn_earth,3557683,3,9,273,282,0
4_4297379,fears_depression_stimulation,4297379,4,1,65,66,0
3_7656083,overcome_hangover_learning_wonderbread_vulcan_uranus,7656083,3,9,122,131,0
3_47083,overcome_prostatitis_stimulation_marzipan_uranus_saturn,47083,3,9,169,178,0
3_1954883,overcome_jealousy_aesthetics_lobster_saturn_earth,1954883,3,9,306,315,0
3_1205284,noop_fears_boils_stimulation,1205284,3,1,211,212,0
3_2224484,noop_locale_marzipan_pennsylvania,2224484,3,1,47,48,0
3_5372234,succumb_boils_lubricity_lamb_saturn_earth,5372234,3,7,159,166,0
4_2287124,craves_boils_lamb,2287124,4,1,52,53,0
3_1355634,succumb_grief_stimulation_lobster_saturn_earth,1355634,3,7,352,359,0
3_136884,feast_love_marzipan_beef_manitoba_pennsylvania,136884,3,7,257,264,0
3_1823234,feast_lubricity_tofu_marzipan_bavaria_manitoba,1823234,3,7,178,185,0
3_4839884,overcome_grief_entertainment_bacon_vulcan_uranus,4839884,3,9,158,167,0
4_6088560,attacks_pennsylvania_oregon,6088560,4,1,66,67,0
3_4703185,succumb_depression_expectation_wonderbread_uranus_saturn,4703185,3,7,95,102,0
3_5513735,succumb_hangover_learning_okra_vulcan_uranus,5513735,3,7,102,109,0
3_5379035,feast_lubricity_marzipan_beef_manitoba_pennsylvania,5379035,3,7,173,180,0
3_7608485,feast_stimulation_bacon_lobster_bavaria_manitoba,7608485,3,7,412,419,0
3_5527085,overcome_boils_love_beef_vulcan_uranus,5527085,3,9,336,345,0
3_4527235,overcome_boils_stimulation_cantelope_saturn_earth,4527235,3,9,293,302,0
3_7885585,overcome_boils_lubricity_ham_saturn_earth,7885585,3,9,150,159,0
3_1739685,overcome_depression_aesthetics_wonderbread_vulcan_uranus,1739685,3,9,184,193,0
3_68235,overcome_angina_lubricity_ham_vulcan_uranus,68235,3,9,149,158,0
3_4816985,overcome_jealousy_entertainment_lobster_vulcan_uranus,4816985,3,9,275,284,0
3_4086635,overcome_grief_aesthetics_bacon_vulcan_uranus,4086635,3,9,200,209,0
4_1742084,eats_haroset_flounder,1742084,4,1,6,7,0
4_2922283,pleasure_stimulation,2922283,4,1,452,453,0
3_4191586,noop_craves_aesthetics_lamb,4191586,3,1,313,314,0
4_4985459,pain_sciatica,4985459,4,1,112,113,0
3_1029536,succumb_boils_lubricity_marzipan_saturn_earth,1029536,3,7,159,166,0
4_561508,craves_boils_marzipan,561508,4,1,50,51,0
3_816536,succumb_sciatica_love_bacon_vulcan_uranus,816536,3,7,296,303,0
3_7754586,succumb_dread_entertainment_wonderbread_vulcan_uranus,7754586,3,7,207,214,0
3_2320336,succumb_grief_love_bacon_vulcan_uranus,2320336,3,7,284,291,0
3_154486,feast_entertainment_ham_flounder_oregon_goias,154486,3,7,285,292,0
3_7055036,overcome_sciatica_achievement_wonderbread_vulcan_uranus,7055036,3,9,136,145,0
3_7822436,overcome_sciatica_aesthetics_bacon_vulcan_uranus,7822436,3,9,99,108,0
3_4821686,overcome_laceration_entertainment_haroset_vulcan_uranus,4821686,3,9,282,291,0
4_6440549,pleasure_lubricity,6440549,4,1,423,424,0
4_3810436,food_onion,3810436,4,1,69,70,0
4_2278622,eats_okra_snickers,2278622,4,1,3,4,0
4_5075412,craves_achievement_wonderbread,5075412,4,1,35,36,0
3_942287,noop_locale_ham_oregon,942287,3,1,318,319,0
3_4337887,succumb_abrasion_stimulation_lamb_uranus_saturn,4337887,3,7,169,176,0
3_2616537,feast_entertainment_ham_flounder_goias_bosnia,2616537,3,7,294,301,0
3_5574087,overcome_angina_entertainment_ham_vulcan_uranus,5574087,3,9,286,295,0
4_828927,fears_angina_entertainment,828927,4,1,84,85,0
3_7461837,overcome_dread_lubricity_wonderbread_saturn_earth,7461837,3,9,205,214,0
4_4319540,fears_dread_lubricity,4319540,4,1,57,58,0
4_511036,eats_wonderbread_okra,511036,4,1,1,2,0
4_2289523,eats_beef_marzipan,2289523,4,1,16,17,0
3_6579438,noop_harmony_lubricity_uranus,6579438,3,1,113,114,0
3_2244238,noop_fears_anger_stimulation,2244238,3,1,324,325,0
3_6361188,succumb_hangover_learning_wonderbread_vulcan_uranus,6361188,3,7,102,109,0
3_761938,feast_stimulation_ham_flounder_oregon_goias,761938,3,7,180,187,0
3_7114488,feast_lubricity_haroset_lamb_bavaria_manitoba,7114488,3,7,337,344,0
3_4586438,overcome_boils_stimulation_beef_uranus_saturn,4586438,3,9,271,280,0
3_3281138,overcome_anger_aesthetics_flounder_saturn_earth,3281138,3,9,322,331,0
4_3653896,fears_anger_aesthetics,3653896,4,1,100,101,0
4_1486223,pain_angina,1486223,4,1,75,76,0
3_2631839,noop_craves_love_wonderbread,2631839,3,1,308,309,0
4_6188452,food_ham,6188452,4,1,167,168,0
4_137551,eats_ham_lemon,137551,4,1,22,23,0
3_5433039,succumb_laceration_stimulation_marzipan_saturn_earth,5433039,3,7,178,185,0
4_2289980,craves_laceration_marzipan,2289980,4,1,49,50,0
3_5324389,succumb_jealousy_love_ham_vulcan_uranus,5324389,3,7,244,251,0
4_2574568,craves_jealousy_ham,2574568,4,1,75,76,0
3_6546489,succumb_abrasion_lubricity_lamb_saturn_earth,6546489,3,7,168,175,0
3_441439,succumb_sciatica_entertainment_lobster_vulcan_uranus,441439,3,7,167,174,0
3_6563539,succumb_dread_learning_wonderbread_vulcan_uranus,6563539,3,7,103,110,0
3_4522139,feast_aesthetics_flounder_haroset_pennsylvania_oregon,4522139,3,7,323,330,0
3_3223989,feast_stimulation_ham_flounder_goias_bosnia,3223989,3,7,193,200,0
3_1578989,overcome_boils_lubricity_cantelope_saturn_earth,1578989,3,9,150,159,0
3_3304289,overcome_sciatica_learning_wonderbread_vulcan_uranus,3304289,3,9,182,191,0
4_4464227,fears_sciatica_learning,4464227,4,2,47,49,0
4_895075,eats_marzipan_tofu,895075,4,1,16,17,0
4_3659869,food_beef,3659869,4,1,196,197,0
3_6849090,noop_craves_stimulation_wonderbread,6849090,3,1,185,186,0
4_1930663,food_flounder,1930663,4,1,195,196,0
3_6192240,noop_craves_laceration_haroset,6192240,3,1,165,166,0
4_6634256,eats_onion_snickers,6634256,4,1,1,2,0
3_4889090,succumb_grief_entertainment_flounder_vulcan_uranus,4889090,3,7,281,288,0
4_941502,craves_grief_flounder,941502,4,1,37,38,0
3_5169740,succumb_sciatica_aesthetics_bacon_uranus_saturn,5169740,3,7,99,106,0
3_6445540,feast_stimulation_marzipan_wonderbread_manitoba_pennsylvania,6445540,3,7,184,191,0
3_4815740,feast_love_lemon_ham_bavaria_manitoba,4815740,3,7,332,339,0
3_4775790,feast_love_beef_lamb_bavaria_manitoba,4775790,3,7,241,248,0
3_3070140,feast_aesthetics_lamb_haroset_oregon_goias,3070140,3,7,332,339,0
3_5910290,overcome_depression_aesthetics_wonderbread_uranus_saturn,5910290,3,9,184,193,0
3_1518391,succumb_angina_lubricity_flounder_saturn_earth,1518391,3,7,156,163,0
4_5215288,craves_angina_flounder,5215288,4,1,54,55,0
3_1514841,succumb_boils_lubricity_beef_uranus_saturn,1514841,3,7,149,156,0
3_2972091,succumb_depression_learning_wonderbread_vulcan_uranus,2972091,3,7,88,95,0
3_5814941,succumb_hangover_expectation_wonderbread_vulcan_uranus,5814941,3,7,77,84,0
3_5531991,succumb_angina_love_ham_vulcan_uranus,5531991,3,7,237,244,0
3_3838791,feast_stimulation_lamb_beef_manitoba_pennsylvania,3838791,3,7,295,302,0
3_5532191,feast_aesthetics_lamb_haroset_goias_bosnia,5532191,3,7,417,424,0
3_3595591,feast_entertainment_beef_lamb_pennsylvania_oregon,3595591,3,7,370,377,0
3_3134141,feast_lubricity_ham_lemon_oregon_goias,3134141,3,7,147,154,0
3_3534241,overcome_grief_aesthetics_lobster_vulcan_uranus,3534241,3,9,134,143,0
3_6659042,noop_fears_prostatitis_stimulation,6659042,3,1,188,189,0
4_1180739,pain_laceration,1180739,4,1,187,188,0
3_2116192,feast_stimulation_beef_marzipan_bavaria_manitoba,2116192,3,7,175,182,0
3_7818142,overcome_depression_love_wonderbread_vulcan_uranus,7818142,3,9,391,400,0
4_7179962,fears_depression_love,7179962,4,1,110,111,0
3_6689142,overcome_laceration_aesthetics_lamb_saturn_earth,6689142,3,9,343,352,0
4_3590140,orbits_uranus_saturn,3590140,4,1,413,414,0
3_3255443,noop_craves_jealousy_lamb,3255443,3,1,231,232,0
3_723993,noop_craves_jealousy_flounder,723993,3,1,233,234,0
4_1484863,eats_lobster_haroset,1484863,4,1,6,7,0
4_1370260,pain_anxiety,1370260,4,1,20,21,0
3_6810793,succumb_laceration_entertainment_lamb_vulcan_uranus,6810793,3,7,298,305,0
3_88593,feast_stimulation_marzipan_cantelope_manitoba_pennsylvania,88593,3,7,184,191,0
3_3096043,feast_love_marzipan_cantelope_pennsylvania_oregon,3096043,3,7,267,274,0
4_3456443,pain_grief,3456443,4,1,151,152,0
4_5631791,pain_loneliness,5631791,4,1,20,21,0
3_1734444,succumb_grief_love_haroset_vulcan_uranus,1734444,3,7,251,258,0
3_2441894,feast_love_marzipan_beef_pennsylvania_oregon,2441894,3,7,267,274,0
3_3524044,feast_lubricity_haroset_lobster_bavaria_manitoba,3524044,3,7,337,344,0
4_387999,craves_lubricity_lobster,387999,4,1,106,107,0
3_291644,overcome_boils_entertainment_beef_vulcan_uranus,291644,3,9,386,395,0
3_7474894,overcome_sciatica_learning_wonderbread_uranus_saturn,7474894,3,9,177,186,0
3_645244,overcome_anxiety_expectation_onion_vulcan_uranus,645244,3,9,117,126,0
3_849844,overcome_jealousy_aesthetics_lobster_uranus_saturn,849844,3,9,307,316,0
4_6616492,eats_lemon_cantelope,6616492,4,1,6,7,0
4_4889270,eats_flounder_haroset,4889270,4,1,16,17,0
3_1064095,noop_fears_prostatitis_lubricity,1064095,3,1,173,174,0
3_1706395,noop_craves_grief_bacon,1706395,3,1,151,152,0
3_1067745,feast_love_lemon_cantelope_bavaria_manitoba,1067745,3,7,332,339,0
3_4910645,feast_love_marzipan_tofu_pennsylvania_oregon,4910645,3,7,267,274,0
3_5397895,feast_lubricity_ham_flounder_oregon_goias,5397895,3,7,147,154,0
3_2923645,overcome_hangover_love_wonderbread_vulcan_uranus,2923645,3,9,380,389,0
4_6026349,fears_hangover_love,6026349,4,1,107,108,0
3_4467745,overcome_loneliness_lubricity_tofu_saturn_earth,4467745,3,9,178,187,0
4_6847927,fears_loneliness_lubricity,6847927,4,1,52,53,0
3_2520195,overcome_grief_stimulation_haroset_uranus_saturn,2520195,3,9,282,291,0
3_1639546,noop_craves_aesthetics_flounder,1639546,3,1,313,314,0
3_1641396,feast_stimulation_beef_lemon_bavaria_manitoba,1641396,3,7,175,182,0
3_828396,overcome_depression_achievement_wonderbread_uranus_saturn,828396,3,9,95,104,0
3_6896196,overcome_jealousy_lubricity_lamb_saturn_earth,6896196,3,9,356,365,0
4_6857847,attacks_manitoba_pennsylvania,6857847,4,1,66,67,0
4_2286682,eats_marzipan_beef,2286682,4,1,16,17,0
4_7813070,pain_abrasion,7813070,4,1,166,167,0
3_810747,succumb_angina_lubricity_lemon_uranus_saturn,810747,3,7,149,156,0
3_7600397,succumb_laceration_stimulation_lemon_saturn_earth,7600397,3,7,178,185,0
4_2134230,craves_laceration_lemon,2134230,4,1,49,50,0
3_7932547,feast_stimulation_flounder_ham_manitoba_pennsylvania,7932547,3,7,329,336,0
3_7253147,feast_entertainment_beef_marzipan_bavaria_manitoba,7253147,3,7,298,305,0
3_6915697,feast_lubricity_beef_lamb_bavaria_manitoba,6915697,3,7,164,171,0
3_7602497,overcome_hangover_achievement_wonderbread_vulcan_uranus,7602497,3,9,102,111,0
3_6070497,overcome_laceration_love_beef_vulcan_uranus,6070497,3,9,326,335,0
3_2185747,overcome_laceration_lubricity_beef_uranus_saturn,2185747,3,9,282,291,0
4_560444,eats_wonderbread_snickers,560444,4,1,1,2,0
4_2161368,pleasure_expectation,2161368,4,1,92,93,0
3_1631598,feast_lubricity_marzipan_wonderbread_manitoba_pennsylvania,1631598,3,7,173,180,0
3_6870948,feast_love_beef_lemon_bavaria_manitoba,6870948,3,7,241,248,0
3_6623699,noop_craves_depression_onion,6623699,3,1,85,86,0
3_4169649,noop_craves_stimulation_bacon,4169649,3,1,366,367,0
3_2550999,noop_craves_hangover_wonderbread,2550999,3,1,72,73,0
4_7159023,pain_depression,7159023,4,1,81,82,0
4_7480922,planet_uranus,7480922,4,1,558,559,0
4_7835272,food_snickers,7835272,4,1,33,34,0
3_293749,noop_craves_stimulation_tofu,293749,3,1,188,189,0
3_2012199,succumb_sciatica_aesthetics_lobster_uranus_saturn,2012199,3,7,117,124,0
3_6789549,succumb_abrasion_lubricity_marzipan_saturn_earth,6789549,3,7,168,175,0
5_7140002,noop_fears_depression_aesthetics,7140002,5,299,409,708,0
5_274283,succumb_depression_aesthetics_wonderbread_uranus_saturn,274283,5,330,452,782,0
5_4104655,succumb_depression_aesthetics_wonderbread_vulcan_uranus,4104655,5,342,452,794,0
5_1733858,succumb_depression_aesthetics_wonderbread_saturn_earth,1733858,5,320,452,772,0
5_6026349,fears_hangover_love,6026349,5,107,80,187,0
5_1344146,locale_snickers_manitoba,1344146,5,23,17,40,0
5_3653896,fears_anger_aesthetics,3653896,5,99,94,193,0
5_7423494,craves_entertainment_wonderbread,7423494,5,51,59,110,0
5_3682892,fears_anxiety_expectation,3682892,5,38,33,71,0
5_4128492,craves_expectation_onion,4128492,5,29,33,62,0
5_908042,craves_aesthetics_haroset,908042,5,58,94,152,0
5_804392,fears_dread_love,804392,5,99,76,175,0
5_4530591,fears_depression_entertainment,4530591,5,76,69,145,0
5_4769340,fears_anxiety_learning,4769340,5,22,17,39,0
5_6936290,craves_aesthetics_beef,6936290,5,106,126,232,0
5_582138,craves_sciatica_haroset,582138,5,66,70,136,0
5_3032587,craves_depression_onion,3032587,5,31,28,59,0
5_6793985,harmony_learning_vulcan,6793985,5,29,15,44,0
5_2799034,locale_bacon_manitoba,2799034,5,36,39,75,0
5_2875084,craves_learning_snickers,2875084,5,16,22,38,0
5_6427833,craves_aesthetics_lamb,6427833,5,99,122,221,0
5_4236582,fears_hangover_entertainment,4236582,5,73,68,141,0
5_929030,craves_aesthetics_flounder,929030,5,97,122,219,0
5_3848180,craves_hangover_onion,3848180,5,42,41,83,0
5_7517629,fears_depression_learning,7517629,5,31,23,54,0
5_4297379,fears_depression_stimulation,4297379,5,65,42,107,0
5_7224728,craves_aesthetics_lobster,7224728,5,31,54,85,0
5_1976428,fears_depression_achievement,1976428,5,27,16,43,0
5_4546428,craves_grief_wonderbread,4546428,5,74,64,138,0
5_1133227,craves_learning_onion,1133227,5,17,25,42,0
5_5623675,fears_dread_entertainment,5623675,5,65,64,129,0
5_2404175,craves_learning_okra,2404175,5,20,25,45,0
5_4700324,craves_depression_snickers,4700324,5,21,17,38,0
5_4107973,fears_laceration_aesthetics,4107973,5,77,66,143,0
5_4561120,craves_depression_wonderbread,4561120,5,44,32,76,0
5_6305720,harmony_aesthetics_earth,6305720,5,57,65,122,0
5_2128520,fears_depression_lubricity,2128520,5,69,45,114,0
5_4244617,craves_aesthetics_bacon,4244617,5,21,41,62,0
5_3536464,fears_depression_expectation,3536464,5,31,23,54,0
5_7179962,fears_depression_love,7179962,5,110,81,191,0
5_1288709,fears_hangover_aesthetics,1288709,5,44,40,84,0
5_7412205,craves_depression_okra,7412205,5,24,19,43,0
5_2544554,craves_aesthetics_ham,2544554,5,102,126,228,0
5_3557753,fears_grief_aesthetics,3557753,5,47,33,80,0
5_7711852,fears_jealousy_aesthetics,7711852,5,67,24,91,0
5_13203,noop_fears_angina_lubricity,13203,5,238,349,587,0
5_1121570,succumb_angina_lubricity_flounder_uranus_saturn,1121570,5,341,577,918,0
5_1518391,succumb_angina_lubricity_flounder_saturn_earth,1518391,5,331,568,899,0
5_810747,succumb_angina_lubricity_lemon_uranus_saturn,810747,5,343,579,922,0
5_4641119,succumb_angina_lubricity_lemon_vulcan_uranus,4641119,5,343,586,929,0
5_5236381,succumb_angina_lubricity_lemon_saturn_earth,5236381,5,333,579,912,0
5_5371763,succumb_angina_lubricity_haroset_saturn_earth,5371763,5,340,567,907,0
5_3610125,succumb_angina_lubricity_ham_uranus_saturn,3610125,5,342,580,922,0
5_7440497,succumb_angina_lubricity_ham_vulcan_uranus,7440497,5,343,587,930,0
5_1684381,succumb_angina_lubricity_ham_saturn_earth,1684381,5,332,571,903,0
5_387999,craves_lubricity_lobster,387999,5,92,110,202,0
5_7699444,fears_angina_love,7699444,5,66,74,140,0
5_6505494,craves_angina_ham,6505494,5,20,18,38,0
5_1606144,fears_grief_lubricity,1606144,5,87,61,148,0
5_4341693,craves_lubricity_beef,4341693,5,48,70,118,0
5_6631441,craves_lubricity_cantelope,6631441,5,37,52,89,0
5_4319540,fears_dread_lubricity,4319540,5,57,42,99,0
5_5215288,craves_angina_flounder,5215288,5,53,22,75,0
5_2950086,craves_lubricity_tofu,2950086,5,41,55,96,0
5_5233736,fears_laceration_lubricity,5233736,5,62,48,110,0
5_3833236,craves_lubricity_lamb,3833236,5,44,77,121,0
5_2335886,craves_lubricity_onion,2335886,5,48,50,98,0
5_2795581,craves_boils_beef,2795581,5,51,24,75,0
5_44280,locale_lemon_manitoba,44280,5,47,47,94,0
5_1790580,fears_abrasion_lubricity,1790580,5,54,44,98,0
5_7946530,locale_ham_pennsylvania,7946530,5,100,14,114,0
5_3222479,fears_hangover_lubricity,3222479,5,66,45,111,0
5_6847927,fears_loneliness_lubricity,6847927,5,50,41,91,0
5_828927,fears_angina_entertainment,828927,5,84,91,175,0
5_2287124,craves_boils_lamb,2287124,5,51,48,99,0
5_894524,craves_angina_lemon,894524,5,51,20,71,0
5_3194470,fears_prostatitis_lubricity,3194470,5,46,42,88,0
5_4947268,craves_lubricity_wonderbread,4947268,5,36,60,96,0
5_561508,craves_boils_marzipan,561508,5,49,46,95,0
5_4553354,fears_sciatica_lubricity,4553354,5,85,49,134,0
5_597652,fears_angina_stimulation,597652,5,50,39,89,0
5_2399100,craves_boils_cantelope,2399100,5,48,4,52,0
5_4422260,craves_lubricity_marzipan,4422260,5,48,70,118,0
5_191203,noop_locale_tofu_manitoba,191203,5,16,44,60,0
5_1063198,feast_love_tofu_onion_bavaria_manitoba,1063198,5,483,761,1244,0
5_1466434,feast_love_tofu_marzipan_bavaria_manitoba,1466434,5,483,761,1244,0
5_3834623,feast_stimulation_tofu_onion_bavaria_manitoba,3834623,5,356,601,957,0
5_7592181,feast_stimulation_tofu_marzipan_bavaria_manitoba,7592181,5,356,601,957,0
5_4812954,feast_lubricity_tofu_onion_bavaria_manitoba,4812954,5,361,573,934,0
5_1823234,feast_lubricity_tofu_marzipan_bavaria_manitoba,1823234,5,361,573,934,0
5_3184342,craves_stimulation_onion,3184342,5,44,49,93,0
5_4459027,locale_tofu_bavaria,4459027,5,18,3,21,0
5_6427428,noop_pain_boils,6427428,5,1,1,2,0
5_3990322,succumb_boils_lubricity_marzipan_uranus_saturn,3990322,5,359,615,974,0
5_1029536,succumb_boils_lubricity_marzipan_saturn_earth,1029536,5,359,615,974,0
5_5619303,succumb_boils_lubricity_wonderbread_saturn_earth,5619303,5,372,629,1001,0
5_4114576,succumb_boils_lubricity_flounder_uranus_saturn,4114576,5,345,599,944,0
5_1092529,succumb_boils_lubricity_flounder_saturn_earth,1092529,5,342,599,941,0
5_2643728,succumb_boils_lubricity_lemon_uranus_saturn,2643728,5,336,587,923,0
5_6474100,succumb_boils_lubricity_lemon_vulcan_uranus,6474100,5,336,588,924,0
5_5087272,succumb_boils_lubricity_lemon_saturn_earth,5087272,5,327,587,914,0
5_3585207,succumb_boils_lubricity_lamb_uranus_saturn,3585207,5,345,599,944,0
5_5372234,succumb_boils_lubricity_lamb_saturn_earth,5372234,5,345,599,944,0
5_5774068,succumb_boils_lubricity_tofu_saturn_earth,5774068,5,372,633,1005,0
5_2557256,succumb_boils_lubricity_haroset_saturn_earth,2557256,5,343,598,941,0
5_1810380,succumb_boils_lubricity_cantelope_uranus_saturn,1810380,5,346,604,950,0
5_5209032,succumb_boils_lubricity_cantelope_saturn_earth,5209032,5,346,604,950,0
5_1514841,succumb_boils_lubricity_beef_uranus_saturn,1514841,5,345,602,947,0
5_5345213,succumb_boils_lubricity_beef_vulcan_uranus,5345213,5,346,602,948,0
5_5301639,succumb_boils_lubricity_beef_saturn_earth,5301639,5,345,602,947,0
5_6766178,succumb_boils_lubricity_ham_uranus_saturn,6766178,5,346,602,948,0
5_2595573,succumb_boils_lubricity_ham_vulcan_uranus,2595573,5,347,603,950,0
5_7541173,succumb_boils_lubricity_ham_saturn_earth,7541173,5,346,602,948,0
5_777291,succumb_boils_entertainment_ham_vulcan_uranus,777291,5,730,952,1682,0
5_3921687,succumb_boils_entertainment_beef_vulcan_uranus,3921687,5,730,952,1682,0
5_5734094,succumb_boils_love_lemon_vulcan_uranus,5734094,5,513,833,1346,0
5_3529601,succumb_boils_love_beef_vulcan_uranus,3529601,5,514,836,1350,0
5_6463954,succumb_boils_love_ham_vulcan_uranus,6463954,5,513,836,1349,0
5_1975165,succumb_boils_stimulation_cantelope_saturn_earth,1975165,5,401,682,1083,0
5_6151748,succumb_boils_stimulation_beef_uranus_saturn,6151748,5,388,681,1069,0
5_5476021,succumb_boils_stimulation_beef_saturn_earth,5476021,5,388,681,1069,0
5_1981143,succumb_boils_stimulation_beef_vulcan_uranus,1981143,5,388,681,1069,0
5_1103568,succumb_boils_stimulation_ham_saturn_earth,1103568,5,392,674,1066,0
5_5547324,succumb_boils_stimulation_lemon_uranus_saturn,5547324,5,388,679,1067,0
5_1723202,succumb_boils_stimulation_lemon_saturn_earth,1723202,5,388,679,1067,0
5_4107482,overcome_boils_love_cantelope_vulcan_uranus,4107482,5,716,836,1552,0
5_3501678,overcome_boils_love_marzipan_vulcan_uranus,3501678,5,707,1106,1813,0
5_5027470,overcome_boils_love_lemon_vulcan_uranus,5027470,5,515,819,1334,0
5_7597451,overcome_boils_love_lamb_vulcan_uranus,7597451,5,706,1129,1835,0
5_5527085,overcome_boils_love_beef_vulcan_uranus,5527085,5,647,836,1483,0
5_3625932,overcome_boils_love_flounder_vulcan_uranus,3625932,5,709,1124,1833,0
5_7096833,overcome_boils_love_ham_vulcan_uranus,7096833,5,673,836,1509,0
5_4527235,overcome_boils_stimulation_cantelope_saturn_earth,4527235,5,629,676,1305,0
5_3291842,overcome_boils_stimulation_cantelope_uranus_saturn,3291842,5,628,682,1310,0
5_7138897,overcome_boils_stimulation_marzipan_vulcan_uranus,7138897,5,613,1003,1616,0
5_2683325,overcome_boils_stimulation_marzipan_saturn_earth,2683325,5,610,1004,1614,0
5_3308525,overcome_boils_stimulation_marzipan_uranus_saturn,3308525,5,613,1003,1616,0
5_706209,overcome_boils_stimulation_lemon_vulcan_uranus,706209,5,390,679,1069,0
5_157892,overcome_boils_stimulation_lemon_saturn_earth,157892,5,384,680,1064,0
5_4876814,overcome_boils_stimulation_lemon_uranus_saturn,4876814,5,390,679,1069,0
5_2486199,overcome_boils_stimulation_lamb_vulcan_uranus,2486199,5,606,998,1604,0
5_6478116,overcome_boils_stimulation_lamb_saturn_earth,6478116,5,606,998,1604,0
5_6656804,overcome_boils_stimulation_lamb_uranus_saturn,6656804,5,606,998,1604,0
5_415833,overcome_boils_stimulation_beef_vulcan_uranus,415833,5,556,681,1237,0
5_6407521,overcome_boils_stimulation_beef_saturn_earth,6407521,5,557,681,1238,0
5_4586438,overcome_boils_stimulation_beef_uranus_saturn,4586438,5,556,681,1237,0
5_7263151,overcome_boils_stimulation_flounder_vulcan_uranus,7263151,5,618,1008,1626,0
5_2746318,overcome_boils_stimulation_flounder_saturn_earth,2746318,5,617,1001,1618,0
5_3432779,overcome_boils_stimulation_flounder_uranus_saturn,3432779,5,618,1000,1618,0
5_1732283,overcome_boils_stimulation_ham_saturn_earth,1732283,5,585,659,1244,0
5_7872060,overcome_boils_stimulation_ham_uranus_saturn,7872060,5,583,674,1257,0
5_5633593,overcome_boils_entertainment_marzipan_vulcan_uranus,5633593,5,796,1250,2046,0
5_917733,overcome_boils_entertainment_lemon_vulcan_uranus,917733,5,615,992,1607,0
5_2362010,overcome_boils_entertainment_lamb_vulcan_uranus,2362010,5,781,1228,2009,0
5_291644,overcome_boils_entertainment_beef_vulcan_uranus,291644,5,749,945,1694,0
5_5757847,overcome_boils_entertainment_flounder_vulcan_uranus,5757847,5,779,1226,2005,0
5_106781,overcome_boils_entertainment_ham_vulcan_uranus,106781,5,783,945,1728,0
5_6646951,overcome_boils_aesthetics_lamb_saturn_earth,6646951,5,874,1295,2169,0
5_1872702,overcome_boils_aesthetics_lamb_uranus_saturn,1872702,5,872,1300,2172,0
5_6576356,overcome_boils_aesthetics_beef_saturn_earth,6576356,5,828,1102,1930,0
5_3159714,overcome_boils_aesthetics_flounder_saturn_earth,3159714,5,877,1293,2170,0
5_5249454,overcome_boils_aesthetics_flounder_uranus_saturn,5249454,5,875,1297,2172,0
5_1139120,overcome_boils_aesthetics_ham_saturn_earth,1139120,5,862,1103,1965,0
5_1578989,overcome_boils_lubricity_cantelope_saturn_earth,1578989,5,350,604,954,0
5_359026,overcome_boils_lubricity_marzipan_saturn_earth,359026,5,362,616,978,0
5_7405600,overcome_boils_lubricity_lemon_vulcan_uranus,7405600,5,338,587,925,0
5_3575228,overcome_boils_lubricity_lemon_uranus_saturn,3575228,5,328,587,915,0
5_5715987,overcome_boils_lubricity_lemon_saturn_earth,5715987,5,328,587,915,0
5_5530959,overcome_boils_lubricity_lamb_saturn_earth,5530959,5,362,603,965,0
5_2143556,overcome_boils_lubricity_beef_uranus_saturn,2143556,5,348,602,950,0
5_5460364,overcome_boils_lubricity_beef_saturn_earth,5460364,5,349,602,951,0
5_422019,overcome_boils_lubricity_flounder_saturn_earth,422019,5,358,601,959,0
5_6924903,overcome_boils_lubricity_ham_uranus_saturn,6924903,5,349,603,952,0
5_7885585,overcome_boils_lubricity_ham_saturn_earth,7885585,5,349,603,952,0
5_162853,noop_craves_boils_cantelope,162853,5,341,179,520,0
5_5615149,fears_boils_stimulation,5615149,5,61,50,111,0
5_7185198,craves_boils_ham,7185198,5,50,25,75,0
5_5529098,fears_jealousy_lubricity,5529098,5,60,46,106,0
5_1497644,fears_boils_love,1497644,5,71,79,150,0
5_7080594,craves_boils_flounder,7080594,5,51,46,97,0
5_1657041,locale_flounder_bavaria,1657041,5,96,4,100,0
5_2072290,craves_lubricity_haroset,2072290,5,42,62,104,0
5_6638384,fears_anger_lubricity,6638384,5,53,41,94,0
5_292731,craves_lubricity_lemon,292731,5,35,66,101,0
5_6292230,harmony_lubricity_saturn,6292230,5,155,147,302,0
5_3862428,harmony_lubricity_vulcan,3862428,5,60,61,121,0
5_3359573,fears_boils_entertainment,3359573,5,109,96,205,0
5_7367121,harmony_lubricity_uranus,7367121,5,111,123,234,0
5_2940369,craves_lubricity_flounder,2940369,5,37,73,110,0
5_2249450,fears_angina_lubricity,2249450,5,44,15,59,0
5_5022204,fears_boils_lubricity,5022204,5,50,45,95,0
5_4536909,craves_boils_lemon,4536909,5,24,23,47,0
5_3190749,craves_lubricity_ham,3190749,5,40,72,112,0
5_6726918,noop_locale_marzipan_manitoba,6726918,5,67,80,147,0
5_3289810,feast_entertainment_marzipan_wonderbread_bavaria_manitoba,3289810,5,586,903,1489,0
5_3050273,feast_entertainment_marzipan_tofu_bavaria_manitoba,3050273,5,586,903,1489,0
5_3929698,feast_entertainment_marzipan_beef_bavaria_manitoba,3929698,5,586,903,1489,0
5_5452724,feast_entertainment_marzipan_cantelope_bavaria_manitoba,5452724,5,586,903,1489,0
5_4549577,feast_stimulation_marzipan_wonderbread_bavaria_manitoba,4549577,5,366,612,978,0
5_5914295,feast_stimulation_marzipan_tofu_bavaria_manitoba,5914295,5,366,612,978,0
5_6793720,feast_stimulation_marzipan_beef_bavaria_manitoba,6793720,5,366,612,978,0
5_2068663,feast_stimulation_marzipan_cantelope_bavaria_manitoba,2068663,5,366,612,978,0
5_6142471,feast_lubricity_marzipan_wonderbread_bavaria_manitoba,6142471,5,361,585,946,0
5_145348,feast_lubricity_marzipan_tofu_bavaria_manitoba,145348,5,361,585,946,0
5_1024773,feast_lubricity_marzipan_beef_bavaria_manitoba,1024773,5,361,585,946,0
5_2447884,feast_lubricity_marzipan_cantelope_bavaria_manitoba,2447884,5,361,585,946,0
5_2484961,feast_love_marzipan_wonderbread_bavaria_manitoba,2484961,5,482,732,1214,0
5_7789525,feast_love_marzipan_tofu_bavaria_manitoba,7789525,5,482,732,1214,0
5_667973,feast_love_marzipan_beef_bavaria_manitoba,667973,5,482,732,1214,0
5_5206710,feast_love_marzipan_cantelope_bavaria_manitoba,5206710,5,482,732,1214,0
5_3534048,locale_marzipan_pennsylvania,3534048,5,35,24,59,0
5_2339897,locale_beef_oregon,2339897,5,49,60,109,0
5_6870746,locale_marzipan_oregon,6870746,5,34,45,79,0
5_5861162,noop_orbits_saturn_earth,5861162,5,1,1,2,0
5_1252677,succumb_angina_stimulation_ham_saturn_earth,1252677,5,368,607,975,0
5_7403790,succumb_jealousy_aesthetics_lobster_saturn_earth,7403790,5,440,641,1081,0
5_5891006,succumb_jealousy_aesthetics_flounder_saturn_earth,5891006,5,663,972,1635,0
5_4775145,succumb_jealousy_aesthetics_lamb_saturn_earth,4775145,5,662,973,1635,0
5_6670250,succumb_jealousy_aesthetics_haroset_saturn_earth,6670250,5,471,736,1207,0
5_1927425,succumb_grief_aesthetics_bacon_saturn_earth,1927425,5,283,462,745,0
5_839449,succumb_grief_aesthetics_lobster_saturn_earth,839449,5,294,480,774,0
5_5624880,succumb_grief_aesthetics_flounder_saturn_earth,5624880,5,632,936,1568,0
5_5768295,succumb_grief_aesthetics_lamb_saturn_earth,5768295,5,631,937,1568,0
5_105909,succumb_grief_aesthetics_haroset_saturn_earth,105909,5,415,668,1083,0
5_3004630,succumb_anger_stimulation_flounder_saturn_earth,3004630,5,708,611,1319,0
5_1908395,succumb_anger_stimulation_haroset_saturn_earth,1908395,5,708,612,1320,0
5_4810109,succumb_anger_stimulation_ham_saturn_earth,4810109,5,708,612,1320,0
5_355622,succumb_sciatica_lubricity_wonderbread_saturn_earth,355622,5,591,748,1339,0
5_6662125,succumb_hangover_stimulation_wonderbread_saturn_earth,6662125,5,466,629,1095,0
5_5237174,succumb_hangover_aesthetics_wonderbread_saturn_earth,5237174,5,304,440,744,0
5_5433039,succumb_laceration_stimulation_marzipan_saturn_earth,5433039,5,380,655,1035,0
5_6725965,succumb_laceration_stimulation_lamb_saturn_earth,6725965,5,358,633,991,0
5_7127799,succumb_laceration_stimulation_tofu_saturn_earth,7127799,5,393,674,1067,0
5_1293775,succumb_laceration_stimulation_wonderbread_saturn_earth,1293775,5,366,639,1005,0
5_5496032,succumb_laceration_stimulation_flounder_saturn_earth,5496032,5,376,644,1020,0
5_4368043,succumb_laceration_stimulation_cantelope_saturn_earth,4368043,5,379,644,1023,0
5_6655370,succumb_laceration_stimulation_beef_saturn_earth,6655370,5,365,643,1008,0
5_7061635,succumb_laceration_stimulation_bacon_saturn_earth,7061635,5,785,1286,2071,0
5_2605711,succumb_laceration_stimulation_haroset_saturn_earth,2605711,5,365,642,1007,0
5_2952150,succumb_laceration_stimulation_ham_saturn_earth,2952150,5,369,645,1014,0
5_7600397,succumb_laceration_stimulation_lemon_saturn_earth,7600397,5,367,641,1008,0
5_3339251,succumb_laceration_stimulation_lobster_saturn_earth,3339251,5,708,1188,1896,0
5_5564124,succumb_depression_expectation_wonderbread_saturn_earth,5564124,5,133,180,313,0
5_5779958,succumb_depression_expectation_okra_saturn_earth,5779958,5,146,179,325,0
5_2521913,succumb_depression_expectation_snickers_saturn_earth,2521913,5,149,182,331,0
5_2386476,succumb_depression_expectation_onion_saturn_earth,2386476,5,194,239,433,0
5_1958866,succumb_dread_expectation_wonderbread_saturn_earth,1958866,5,117,152,269,0
5_1318319,succumb_depression_lubricity_wonderbread_saturn_earth,1318319,5,478,648,1126,0
5_2792416,succumb_prostatitis_lubricity_marzipan_saturn_earth,2792416,5,357,609,966,0
5_4606631,succumb_prostatitis_lubricity_wonderbread_saturn_earth,4606631,5,370,623,993,0
5_5877496,succumb_prostatitis_lubricity_tofu_saturn_earth,5877496,5,370,627,997,0
5_450623,succumb_prostatitis_lubricity_cantelope_saturn_earth,450623,5,357,611,968,0
5_5405067,succumb_prostatitis_lubricity_beef_saturn_earth,5405067,5,357,609,966,0
5_7866818,succumb_laceration_aesthetics_lamb_saturn_earth,7866818,5,687,1011,1698,0
5_2582709,succumb_laceration_aesthetics_haroset_saturn_earth,2582709,5,502,747,1249,0
5_5978109,succumb_abrasion_stimulation_marzipan_saturn_earth,5978109,5,386,679,1065,0
5_124533,succumb_abrasion_stimulation_lamb_saturn_earth,124533,5,373,657,1030,0
5_526367,succumb_abrasion_stimulation_tofu_saturn_earth,526367,5,399,698,1097,0
5_1751860,succumb_abrasion_stimulation_wonderbread_saturn_earth,1751860,5,373,663,1036,0
5_7889354,succumb_abrasion_stimulation_cantelope_saturn_earth,7889354,5,385,668,1053,0
5_53938,succumb_abrasion_stimulation_beef_saturn_earth,53938,5,371,667,1038,0
5_4170531,succumb_abrasion_stimulation_haroset_saturn_earth,4170531,5,373,666,1039,0
5_5676699,succumb_abrasion_stimulation_ham_saturn_earth,5676699,5,376,669,1045,0
5_5839952,succumb_abrasion_stimulation_lemon_saturn_earth,5839952,5,373,665,1038,0
5_1221666,succumb_sciatica_aesthetics_bacon_saturn_earth,1221666,5,224,404,628,0
5_1865662,succumb_sciatica_aesthetics_lobster_saturn_earth,1865662,5,260,427,687,0
5_3313713,succumb_sciatica_aesthetics_wonderbread_saturn_earth,3313713,5,259,426,685,0
5_4303167,succumb_sciatica_aesthetics_flounder_saturn_earth,4303167,5,629,933,1562,0
5_3233979,succumb_sciatica_aesthetics_lamb_saturn_earth,3233979,5,628,934,1562,0
5_1132122,succumb_sciatica_aesthetics_haroset_saturn_earth,1132122,5,406,654,1060,0
5_5586892,succumb_hangover_learning_wonderbread_saturn_earth,5586892,5,141,192,333,0
5_3989637,succumb_hangover_learning_okra_saturn_earth,3989637,5,157,194,351,0
5_7840197,succumb_hangover_learning_snickers_saturn_earth,7840197,5,147,170,317,0
5_7051960,succumb_grief_stimulation_bacon_saturn_earth,7051960,5,792,1281,2073,0
5_622094,succumb_grief_stimulation_haroset_saturn_earth,622094,5,528,812,1340,0
5_1355634,succumb_grief_stimulation_lobster_saturn_earth,1355634,5,731,1211,1942,0
5_96811,succumb_loneliness_lubricity_tofu_saturn_earth,96811,5,373,583,956,0
5_2315706,succumb_sciatica_stimulation_wonderbread_saturn_earth,2315706,5,488,736,1224,0
5_2399150,succumb_sciatica_stimulation_bacon_saturn_earth,2399150,5,818,1295,2113,0
5_33921,succumb_sciatica_stimulation_lobster_saturn_earth,33921,5,767,1215,1982,0
5_5922653,succumb_depression_stimulation_wonderbread_saturn_earth,5922653,5,480,632,1112,0
5_4707416,succumb_hangover_lubricity_wonderbread_saturn_earth,4707416,5,464,645,1109,0
5_7354400,succumb_jealousy_stimulation_lamb_saturn_earth,7354400,5,390,680,1070,0
5_5872071,succumb_jealousy_stimulation_flounder_saturn_earth,5872071,5,408,682,1090,0
5_7283805,succumb_jealousy_stimulation_beef_saturn_earth,7283805,5,399,690,1089,0
5_7921455,succumb_jealousy_stimulation_bacon_saturn_earth,7921455,5,786,1290,2076,0
5_888220,succumb_jealousy_stimulation_haroset_saturn_earth,888220,5,397,675,1072,0
5_7861454,succumb_jealousy_stimulation_ham_saturn_earth,7861454,5,402,683,1085,0
5_1621760,succumb_jealousy_stimulation_lobster_saturn_earth,1621760,5,712,1189,1901,0
5_354266,succumb_depression_learning_wonderbread_saturn_earth,354266,5,141,192,333,0
5_2533744,succumb_depression_learning_okra_saturn_earth,2533744,5,142,194,336,0
5_3457300,succumb_depression_learning_onion_saturn_earth,3457300,5,142,193,335,0
5_6306235,succumb_depression_learning_snickers_saturn_earth,6306235,5,125,170,295,0
5_2317395,succumb_dread_stimulation_wonderbread_saturn_earth,2317395,5,408,589,997,0
5_6789549,succumb_abrasion_lubricity_marzipan_saturn_earth,6789549,5,383,662,1045,0
5_3532515,succumb_abrasion_lubricity_wonderbread_saturn_earth,3532515,5,406,676,1082,0
5_1659426,succumb_abrasion_lubricity_lemon_saturn_earth,1659426,5,371,641,1012,0
5_6546489,succumb_abrasion_lubricity_lamb_saturn_earth,6546489,5,369,644,1013,0
5_6948323,succumb_abrasion_lubricity_tofu_saturn_earth,6948323,5,406,680,1086,0
5_6674006,succumb_abrasion_lubricity_haroset_saturn_earth,6674006,5,379,643,1022,0
5_7592592,succumb_abrasion_lubricity_cantelope_saturn_earth,7592592,5,380,651,1031,0
5_6475894,succumb_abrasion_lubricity_beef_saturn_earth,6475894,5,369,640,1009,0
5_1032191,succumb_dread_aesthetics_wonderbread_saturn_earth,1032191,5,243,393,636,0
5_6593675,succumb_anger_lubricity_flounder_saturn_earth,6593675,5,374,581,955,0
5_4766512,succumb_anger_lubricity_haroset_saturn_earth,4766512,5,374,580,954,0
5_5849983,succumb_anger_lubricity_ham_saturn_earth,5849983,5,375,584,959,0
5_4191810,succumb_laceration_lubricity_lamb_saturn_earth,4191810,5,394,673,1067,0
5_433474,succumb_laceration_lubricity_haroset_saturn_earth,433474,5,403,663,1066,0
5_4121215,succumb_laceration_lubricity_beef_saturn_earth,4121215,5,395,669,1064,0
5_3618692,succumb_dread_learning_wonderbread_saturn_earth,3618692,5,133,176,309,0
5_4909767,succumb_dread_lubricity_wonderbread_saturn_earth,4909767,5,406,605,1011,0
5_1521380,succumb_anxiety_learning_onion_saturn_earth,1521380,5,112,143,255,0
5_6303596,succumb_hangover_expectation_wonderbread_saturn_earth,6303596,5,125,171,296,0
5_6473534,succumb_hangover_expectation_okra_saturn_earth,6473534,5,123,170,293,0
5_7754539,succumb_hangover_expectation_snickers_saturn_earth,7754539,5,126,173,299,0
5_3920438,succumb_hangover_expectation_onion_saturn_earth,3920438,5,195,239,434,0
5_2666152,succumb_loneliness_stimulation_tofu_saturn_earth,2666152,5,375,597,972,0
5_1856801,succumb_prostatitis_stimulation_marzipan_saturn_earth,1856801,5,353,637,990,0
5_7378339,succumb_prostatitis_stimulation_tofu_saturn_earth,7378339,5,366,656,1022,0
5_2422390,succumb_prostatitis_stimulation_wonderbread_saturn_earth,2422390,5,353,634,987,0
5_962493,succumb_prostatitis_stimulation_cantelope_saturn_earth,962493,5,353,639,992,0
5_6905910,succumb_prostatitis_stimulation_beef_saturn_earth,6905910,5,353,638,991,0
5_423799,succumb_grief_lubricity_haroset_saturn_earth,423799,5,589,795,1384,0
5_6911181,succumb_anger_aesthetics_flounder_saturn_earth,6911181,5,643,948,1591,0
5_5558314,succumb_jealousy_lubricity_flounder_saturn_earth,5558314,5,414,674,1088,0
5_460529,succumb_jealousy_lubricity_lamb_saturn_earth,460529,5,415,673,1088,0
5_1293294,succumb_jealousy_lubricity_haroset_saturn_earth,1293294,5,412,664,1076,0
5_5284704,overcome_sciatica_stimulation_lobster_saturn_earth,5284704,5,759,1221,1980,0
5_1221474,overcome_sciatica_stimulation_bacon_saturn_earth,1221474,5,821,1291,2112,0
5_4551164,overcome_sciatica_stimulation_haroset_saturn_earth,4551164,5,676,1036,1712,0
5_6192364,overcome_sciatica_stimulation_wonderbread_saturn_earth,6192364,5,524,722,1246,0
5_4417732,overcome_sciatica_aesthetics_lobster_saturn_earth,4417732,5,263,427,690,0
5_5592600,overcome_sciatica_aesthetics_bacon_saturn_earth,5592600,5,226,404,630,0
5_3684192,overcome_sciatica_aesthetics_haroset_saturn_earth,3684192,5,410,656,1066,0
5_6766776,overcome_sciatica_aesthetics_wonderbread_saturn_earth,6766776,5,263,426,689,0
5_3327830,overcome_sciatica_lubricity_lobster_saturn_earth,3327830,5,779,1242,2021,0
5_2594290,overcome_sciatica_lubricity_haroset_saturn_earth,2594290,5,682,1016,1698,0
5_1650517,overcome_sciatica_lubricity_wonderbread_saturn_earth,1650517,5,559,728,1287,0
5_4714755,overcome_anxiety_stimulation_onion_saturn_earth,4714755,5,389,624,1013,0
5_646945,overcome_anxiety_lubricity_onion_saturn_earth,646945,5,387,610,997,0
5_4662276,overcome_abrasion_stimulation_lemon_saturn_earth,4662276,5,370,666,1036,0
5_4495467,overcome_abrasion_stimulation_lamb_saturn_earth,4495467,5,366,657,1023,0
5_4424872,overcome_abrasion_stimulation_beef_saturn_earth,4424872,5,375,667,1042,0
5_6014421,overcome_abrasion_stimulation_marzipan_saturn_earth,6014421,5,383,680,1063,0
5_1919880,overcome_abrasion_aesthetics_lamb_saturn_earth,1919880,5,692,1011,1703,0
5_1849285,overcome_abrasion_aesthetics_beef_saturn_earth,1849285,5,699,1107,1806,0
5_988916,overcome_abrasion_lubricity_lemon_saturn_earth,988916,5,346,641,987,0
5_4981179,overcome_abrasion_lubricity_lamb_saturn_earth,4981179,5,365,645,1010,0
5_4910584,overcome_abrasion_lubricity_beef_saturn_earth,4910584,5,373,640,1013,0
5_1340642,overcome_abrasion_lubricity_marzipan_saturn_earth,1340642,5,380,663,1043,0
5_3867199,overcome_angina_stimulation_lemon_saturn_earth,3867199,5,610,636,1246,0
5_359343,overcome_angina_stimulation_flounder_saturn_earth,359343,5,620,627,1247,0
5_2184177,overcome_angina_stimulation_ham_saturn_earth,2184177,5,362,591,953,0
5_2619075,overcome_angina_aesthetics_flounder_saturn_earth,2619075,5,870,937,1807,0
5_6454034,overcome_angina_aesthetics_ham_saturn_earth,6454034,5,665,1034,1699,0
5_6167881,overcome_angina_lubricity_lemon_saturn_earth,6167881,5,345,565,910,0
5_5889325,overcome_angina_lubricity_flounder_saturn_earth,5889325,5,354,569,923,0
5_1843106,overcome_angina_lubricity_ham_saturn_earth,1843106,5,335,570,905,0
5_3557683,overcome_depression_stimulation_wonderbread_saturn_earth,3557683,5,406,627,1033,0
5_3537053,overcome_depression_stimulation_onion_saturn_earth,3537053,5,486,743,1229,0
5_2037158,overcome_depression_aesthetics_wonderbread_saturn_earth,2037158,5,290,451,741,0
5_5194977,overcome_depression_lubricity_wonderbread_saturn_earth,5194977,5,437,632,1069,0
5_569525,overcome_depression_lubricity_onion_saturn_earth,569525,5,484,729,1213,0
5_2537806,overcome_hangover_stimulation_wonderbread_saturn_earth,2537806,5,399,617,1016,0
5_6643533,overcome_hangover_stimulation_onion_saturn_earth,6643533,5,550,837,1387,0
5_689260,overcome_hangover_aesthetics_wonderbread_saturn_earth,689260,5,282,439,721,0
5_6002311,overcome_hangover_lubricity_wonderbread_saturn_earth,6002311,5,430,622,1052,0
5_2829614,overcome_hangover_lubricity_onion_saturn_earth,2829614,5,548,823,1371,0
5_6279329,overcome_anger_stimulation_haroset_saturn_earth,6279329,5,693,634,1327,0
5_1826954,overcome_anger_stimulation_flounder_saturn_earth,1826954,5,368,611,979,0
5_5438824,overcome_anger_stimulation_ham_saturn_earth,5438824,5,692,624,1316,0
5_7035101,overcome_anger_aesthetics_haroset_saturn_earth,7035101,5,620,684,1304,0
5_3281138,overcome_anger_aesthetics_flounder_saturn_earth,3281138,5,643,936,1579,0
5_3201202,overcome_anger_lubricity_haroset_saturn_earth,3201202,5,704,563,1267,0
5_5923165,overcome_anger_lubricity_flounder_saturn_earth,5923165,5,339,582,921,0
5_6194395,overcome_anger_lubricity_ham_saturn_earth,6194395,5,701,592,1293,0
5_5733459,overcome_prostatitis_stimulation_marzipan_saturn_earth,5733459,5,349,638,987,0
5_4087311,overcome_prostatitis_lubricity_marzipan_saturn_earth,4087311,5,343,610,953,0
5_7190944,overcome_jealousy_stimulation_ham_saturn_earth,7190944,5,714,668,1382,0
5_6872543,overcome_jealousy_stimulation_lobster_saturn_earth,6872543,5,711,1189,1900,0
5_5908383,overcome_jealousy_stimulation_flounder_saturn_earth,5908383,5,679,683,1362,0
5_6139003,overcome_jealousy_stimulation_haroset_saturn_earth,6139003,5,401,675,1076,0
5_3724357,overcome_jealousy_stimulation_lamb_saturn_earth,3724357,5,392,680,1072,0
5_3653762,overcome_jealousy_stimulation_beef_saturn_earth,3653762,5,704,690,1394,0
5_1954883,overcome_jealousy_aesthetics_lobster_saturn_earth,1954883,5,438,645,1083,0
5_82246,overcome_jealousy_aesthetics_bacon_saturn_earth,82246,5,646,960,1606,0
5_1221343,overcome_jealousy_aesthetics_haroset_saturn_earth,1221343,5,463,737,1200,0
5_4104635,overcome_jealousy_aesthetics_lamb_saturn_earth,4104635,5,665,968,1633,0
5_733794,overcome_jealousy_lubricity_ham_saturn_earth,733794,5,736,725,1461,0
5_849158,overcome_jealousy_lubricity_lobster_saturn_earth,849158,5,741,1226,1967,0
5_109407,overcome_jealousy_lubricity_flounder_saturn_earth,109407,5,692,675,1367,0
5_115618,overcome_jealousy_lubricity_haroset_saturn_earth,115618,5,416,647,1063,0
5_6896196,overcome_jealousy_lubricity_lamb_saturn_earth,6896196,5,439,674,1113,0
5_6825601,overcome_jealousy_lubricity_beef_saturn_earth,6825601,5,728,717,1445,0
5_2353707,overcome_dread_stimulation_wonderbread_saturn_earth,2353707,5,364,573,937,0
5_6282974,overcome_dread_aesthetics_wonderbread_saturn_earth,6282974,5,247,392,639,0
5_7461837,overcome_dread_lubricity_wonderbread_saturn_earth,7461837,5,395,578,973,0
5_3900606,overcome_laceration_stimulation_haroset_saturn_earth,3900606,5,369,642,1011,0
5_1277058,overcome_laceration_stimulation_lamb_saturn_earth,1277058,5,360,633,993,0
5_4634146,overcome_laceration_stimulation_lobster_saturn_earth,4634146,5,712,1189,1901,0
5_1206463,overcome_laceration_stimulation_beef_saturn_earth,1206463,5,369,643,1012,0
5_885125,overcome_laceration_stimulation_marzipan_saturn_earth,885125,5,383,656,1039,0
5_4850203,overcome_laceration_stimulation_lemon_saturn_earth,4850203,5,383,642,1025,0
5_948118,overcome_laceration_stimulation_flounder_saturn_earth,948118,5,712,648,1360,0
5_2619021,overcome_laceration_aesthetics_haroset_saturn_earth,2619021,5,469,748,1217,0
5_6689142,overcome_laceration_aesthetics_lamb_saturn_earth,6689142,5,690,1006,1696,0
5_3352561,overcome_laceration_aesthetics_lobster_saturn_earth,3352561,5,838,1295,2133,0
5_6618547,overcome_laceration_aesthetics_beef_saturn_earth,6618547,5,697,1102,1799,0
5_5684257,overcome_laceration_lubricity_haroset_saturn_earth,5684257,5,421,647,1068,0
5_561767,overcome_laceration_lubricity_lamb_saturn_earth,561767,5,389,674,1063,0
5_491172,overcome_laceration_lubricity_beef_saturn_earth,491172,5,440,669,1109,0
5_1444092,overcome_laceration_lubricity_marzipan_saturn_earth,1444092,5,625,743,1368,0
5_5758178,overcome_laceration_lubricity_lemon_saturn_earth,5758178,5,618,712,1330,0
5_1507085,overcome_laceration_lubricity_flounder_saturn_earth,1507085,5,900,1024,1924,0
5_5218222,overcome_loneliness_stimulation_tofu_saturn_earth,5218222,5,357,591,948,0
5_4467745,overcome_loneliness_lubricity_tofu_saturn_earth,4467745,5,362,563,925,0
5_573955,overcome_grief_stimulation_flounder_saturn_earth,573955,5,776,1215,1991,0
5_4993028,overcome_grief_stimulation_haroset_saturn_earth,4993028,5,526,808,1334,0
5_5486650,overcome_grief_stimulation_bacon_saturn_earth,5486650,5,795,1277,2072,0
5_6501036,overcome_grief_stimulation_lamb_saturn_earth,6501036,5,769,1198,1967,0
5_5726568,overcome_grief_stimulation_lobster_saturn_earth,5726568,5,726,1211,1937,0
5_7995211,overcome_grief_stimulation_wonderbread_saturn_earth,7995211,5,689,947,1636,0
5_7436376,overcome_grief_aesthetics_haroset_saturn_earth,7436376,5,412,669,1081,0
5_2858925,overcome_grief_aesthetics_bacon_saturn_earth,2858925,5,272,462,734,0
5_168939,overcome_grief_aesthetics_lobster_saturn_earth,168939,5,297,480,777,0
5_6324440,overcome_grief_lubricity_flounder_saturn_earth,6324440,5,786,1220,2006,0
5_6859466,overcome_grief_lubricity_haroset_saturn_earth,6859466,5,534,776,1310,0
5_7686496,overcome_grief_lubricity_lamb_saturn_earth,7686496,5,786,1203,1989,0
5_7593006,overcome_grief_lubricity_lobster_saturn_earth,7593006,5,748,1232,1980,0
5_4113858,overcome_grief_lubricity_wonderbread_saturn_earth,4113858,5,722,962,1684,0
5_7435781,noop_eats_haroset_lobster,7435781,5,1,1,2,0
5_7068455,feast_stimulation_haroset_lobster_bavaria_manitoba,7068455,5,671,1117,1788,0
5_7135015,feast_love_haroset_lobster_bavaria_manitoba,7135015,5,450,707,1157,0
5_3524044,feast_lubricity_haroset_lobster_bavaria_manitoba,3524044,5,687,1107,1794,0
5_2073452,feast_aesthetics_haroset_lobster_bavaria_manitoba,2073452,5,595,881,1476,0
5_5442106,feast_entertainment_haroset_lobster_bavaria_manitoba,5442106,5,521,798,1319,0
5_923989,noop_eats_ham_lemon,923989,5,1,1,2,0
5_3351501,feast_aesthetics_ham_lemon_pennsylvania_oregon,3351501,5,650,1000,1650,0
5_2997853,feast_aesthetics_ham_lemon_oregon_goias,2997853,5,650,1000,1650,0
5_5459904,feast_aesthetics_ham_lemon_goias_bosnia,5459904,5,666,1000,1666,0
5_7109798,feast_love_ham_lemon_pennsylvania_oregon,7109798,5,438,723,1161,0
5_4932716,feast_love_ham_lemon_oregon_goias,4932716,5,438,723,1161,0
5_7394767,feast_love_ham_lemon_goias_bosnia,7394767,5,455,723,1178,0
5_6538810,feast_love_ham_lemon_manitoba_pennsylvania,6538810,5,717,723,1440,0
5_5039721,feast_stimulation_ham_lemon_pennsylvania_oregon,5039721,5,349,562,911,0
5_2625063,feast_stimulation_ham_lemon_oregon_goias,2625063,5,349,562,911,0
5_5087114,feast_stimulation_ham_lemon_goias_bosnia,5087114,5,367,562,929,0
5_2715751,feast_entertainment_ham_lemon_pennsylvania_oregon,2715751,5,561,837,1398,0
5_1601758,feast_entertainment_ham_lemon_oregon_goias,1601758,5,561,837,1398,0
5_4063809,feast_entertainment_ham_lemon_goias_bosnia,4063809,5,577,837,1414,0
5_1110459,feast_lubricity_ham_lemon_pennsylvania_oregon,1110459,5,341,555,896,0
5_3134141,feast_lubricity_ham_lemon_oregon_goias,3134141,5,341,555,896,0
5_5596192,feast_lubricity_ham_lemon_goias_bosnia,5596192,5,343,555,898,0
5_4708754,noop_eats_cantelope_lemon,4708754,5,1,1,2,0
5_1108354,noop_craves_loneliness_tofu,1108354,5,10,23,33,0
5_4972740,overcome_loneliness_love_tofu_vulcan_uranus,4972740,5,480,750,1230,0
5_4163020,overcome_loneliness_stimulation_tofu_uranus_saturn,4163020,5,356,597,953,0
5_4064356,overcome_loneliness_lubricity_tofu_uranus_saturn,4064356,5,361,569,930,0
5_1586642,fears_loneliness_stimulation,1586642,5,46,41,87,0
5_5888813,noop_harmony_learning_uranus,5888813,5,54,87,141,0
5_2530816,succumb_hangover_learning_wonderbread_uranus_saturn,2530816,5,140,191,331,0
5_1683363,succumb_hangover_learning_okra_uranus_saturn,1683363,5,157,194,351,0
5_3306552,succumb_hangover_learning_snickers_uranus_saturn,3306552,5,147,170,317,0
5_6179999,succumb_sciatica_learning_wonderbread_uranus_saturn,6179999,5,330,484,814,0
5_7142696,succumb_depression_learning_wonderbread_uranus_saturn,7142696,5,140,191,331,0
5_5020674,succumb_depression_learning_okra_uranus_saturn,5020674,5,142,194,336,0
5_1421700,succumb_depression_learning_onion_uranus_saturn,1421700,5,142,193,335,0
5_2660153,succumb_depression_learning_snickers_uranus_saturn,2660153,5,125,170,295,0
5_2733167,succumb_dread_learning_wonderbread_uranus_saturn,2733167,5,132,175,307,0
5_1886754,succumb_anxiety_learning_onion_uranus_saturn,1886754,5,112,143,255,0
5_3304289,overcome_sciatica_learning_wonderbread_vulcan_uranus,3304289,5,313,348,661,0
5_4151816,overcome_anxiety_learning_onion_vulcan_uranus,4151816,5,114,142,256,0
5_5221003,overcome_depression_learning_okra_vulcan_uranus,5221003,5,144,194,338,0
5_6848749,overcome_depression_learning_wonderbread_vulcan_uranus,6848749,5,142,191,333,0
5_6526837,overcome_depression_learning_snickers_vulcan_uranus,6526837,5,127,170,297,0
5_4074396,overcome_depression_learning_onion_vulcan_uranus,4074396,5,144,193,337,0
5_3948425,overcome_hangover_learning_okra_vulcan_uranus,3948425,5,159,194,353,0
5_7656083,overcome_hangover_learning_wonderbread_vulcan_uranus,7656083,5,142,191,333,0
5_1688017,overcome_hangover_learning_snickers_vulcan_uranus,1688017,5,144,170,314,0
5_1114632,overcome_dread_learning_wonderbread_vulcan_uranus,1114632,5,134,175,309,0
5_5767630,overcome_grief_learning_wonderbread_vulcan_uranus,5767630,5,509,626,1135,0
5_1222810,harmony_learning_saturn,1222810,5,33,30,63,0
5_6152154,noop_craves_grief_flounder,6152154,5,546,805,1351,0
5_3205636,overcome_grief_stimulation_flounder_vulcan_uranus,3205636,5,776,1222,1998,0
5_7376241,overcome_grief_stimulation_flounder_uranus_saturn,7376241,5,776,1214,1990,0
5_4925402,overcome_grief_entertainment_flounder_vulcan_uranus,4925402,5,564,881,1445,0
5_3150028,overcome_grief_lubricity_flounder_vulcan_uranus,3150028,5,797,1228,2025,0
5_7320633,overcome_grief_lubricity_flounder_uranus_saturn,7320633,5,794,1220,2014,0
5_3934647,fears_anger_entertainment,3934647,5,79,88,167,0
5_6618897,craves_jealousy_beef,6618897,5,75,28,103,0
5_6863696,fears_jealousy_entertainment,6863696,5,48,54,102,0
5_3931593,craves_entertainment_haroset,3931593,5,45,58,103,0
5_4605843,craves_love_lobster,4605843,5,57,72,129,0
5_6011242,craves_stimulation_lobster,6011242,5,80,121,201,0
5_2054340,fears_prostatitis_love,2054340,5,62,77,139,0
5_809839,fears_anger_love,809839,5,60,73,133,0
5_7957589,locale_lamb_manitoba,7957589,5,70,15,85,0
5_808089,craves_laceration_flounder,808089,5,93,51,144,0
5_5357538,craves_entertainment_beef,5357538,5,87,98,185,0
5_2576538,craves_love_flounder,2576538,5,62,77,139,0
5_2538387,craves_entertainment_ham,2538387,5,80,98,178,0
5_4317787,craves_entertainment_lemon,4317787,5,84,96,180,0
5_1265535,locale_haroset_manitoba,1265535,5,68,78,146,0
5_4957332,craves_stimulation_bacon,4957332,5,101,127,228,0
5_4849081,craves_entertainment_lamb,4849081,5,78,97,175,0
5_7153580,fears_sciatica_entertainment,7153580,5,48,51,99,0
5_4058429,craves_love_marzipan,4058429,5,69,84,153,0
5_3001779,craves_jealousy_bacon,3001779,5,84,95,179,0
5_5019078,fears_grief_love,5019078,5,59,61,120,0
5_137328,fears_abrasion_entertainment,137328,5,86,96,182,0
5_1511676,craves_jealousy_flounder,1511676,5,71,26,97,0
5_6044426,fears_grief_stimulation,6044426,5,76,62,138,0
5_5591775,fears_laceration_entertainment,5591775,5,57,61,118,0
5_2533325,craves_love_ham,2533325,5,58,81,139,0
5_6130372,craves_laceration_lobster,6130372,5,94,108,202,0
5_7954321,fears_sciatica_love,7954321,5,78,74,152,0
5_7670121,fears_abrasion_love,7670121,5,67,79,146,0
5_4101071,locale_lobster_manitoba,4101071,5,46,55,101,0
5_6539420,craves_jealousy_lobster,6539420,5,48,47,95,0
5_2574568,craves_jealousy_ham,2574568,5,73,29,102,0
5_4061666,craves_love_beef,4061666,5,68,81,149,0
5_7973815,harmony_entertainment_vulcan,7973815,5,74,56,130,0
5_5021913,fears_grief_entertainment,5021913,5,37,39,76,0
5_5474563,craves_grief_lobster,5474563,5,26,24,50,0
5_614612,craves_love_lemon,614612,5,58,73,131,0
5_3553209,craves_love_lamb,3553209,5,66,81,147,0
5_2670059,craves_love_tofu,2670059,5,64,77,141,0
5_345208,craves_entertainment_marzipan,345208,5,92,107,199,0
5_5808558,craves_grief_lamb,5808558,5,86,89,175,0
5_5729757,craves_grief_bacon,5729757,5,37,37,74,0
5_4430757,craves_love_bacon,4430757,5,70,87,157,0
5_587956,craves_anger_ham,587956,5,70,22,92,0
5_132955,craves_entertainment_bacon,132955,5,40,49,89,0
5_7158854,craves_grief_haroset,7158854,5,47,41,88,0
5_7041704,craves_love_wonderbread,7041704,5,53,75,128,0
5_6654103,fears_anger_stimulation,6654103,5,96,38,134,0
5_2247302,craves_entertainment_lobster,2247302,5,24,21,45,0
5_1501452,craves_love_cantelope,1501452,5,60,43,103,0
5_6590502,craves_anger_haroset,6590502,5,73,19,92,0
5_3735505,noop_craves_anger_haroset,3735505,5,455,121,576,0
5_2410744,overcome_anger_love_haroset_vulcan_uranus,2410744,5,468,367,835,0
5_7603566,overcome_anger_stimulation_haroset_vulcan_uranus,7603566,5,692,648,1340,0
5_3773194,overcome_anger_stimulation_haroset_uranus_saturn,3773194,5,692,634,1326,0
5_1184359,overcome_anger_entertainment_haroset_vulcan_uranus,1184359,5,546,584,1130,0
5_1056773,overcome_anger_aesthetics_haroset_vulcan_uranus,1056773,5,625,692,1317,0
5_5227378,overcome_anger_aesthetics_haroset_uranus_saturn,5227378,5,625,684,1309,0
5_7869405,overcome_anger_lubricity_haroset_uranus_saturn,7869405,5,701,579,1280,0
5_6864294,craves_entertainment_flounder,6864294,5,75,94,169,0
5_4484680,fears_jealousy_love,4484680,5,45,42,87,0
5_7424527,harmony_love_vulcan,7424527,5,90,76,166,0
5_7461953,craves_anger_flounder,7461953,5,24,18,42,0
5_3246453,fears_laceration_love,3246453,5,49,47,96,0
5_941502,craves_grief_flounder,941502,5,86,81,167,0
5_6712104,noop_craves_love_cantelope,6712104,5,441,688,1129,0
5_6290134,craves_love_haroset,6290134,5,35,41,76,0
5_7810946,noop_fears_angina_stimulation,7810946,5,352,513,865,0
5_5866392,fears_prostatitis_stimulation,5866392,5,39,42,81,0
5_5255941,locale_lamb_bosnia,5255941,5,51,56,107,0
5_5789489,harmony_stimulation_vulcan,5789489,5,64,63,127,0
5_1141187,craves_stimulation_lemon,1141187,5,36,70,106,0
5_7695533,craves_stimulation_haroset,7695533,5,37,72,109,0
5_1449880,fears_dread_stimulation,1449880,5,53,39,92,0
5_2134230,craves_laceration_lemon,2134230,5,48,27,75,0
5_2289980,craves_laceration_marzipan,2289980,5,48,29,77,0
5_5363829,fears_jealousy_stimulation,5363829,5,58,52,110,0
5_2813229,fears_sciatica_stimulation,2813229,5,67,52,119,0
5_3765875,fears_abrasion_stimulation,3765875,5,51,48,99,0
5_6095221,craves_stimulation_beef,6095221,5,43,72,115,0
5_6484069,craves_stimulation_cantelope,6484069,5,33,49,82,0
5_2314717,craves_stimulation_flounder,2314717,5,40,75,115,0
5_3955115,craves_stimulation_wonderbread,3955115,5,29,72,101,0
5_4703614,craves_stimulation_tofu,4703614,5,35,56,91,0
5_5586764,craves_stimulation_lamb,5586764,5,40,74,114,0
5_2883160,fears_laceration_stimulation,2883160,5,52,46,98,0
5_3796608,craves_stimulation_marzipan,3796608,5,44,74,118,0
5_794907,harmony_stimulation_earth,794907,5,112,84,196,0
5_1239506,fears_hangover_stimulation,1239506,5,62,36,98,0
5_1293205,harmony_stimulation_uranus,1293205,5,124,99,223,0
5_937738,noop_craves_entertainment_lobster,937738,5,156,207,363,0
5_5182809,succumb_grief_entertainment_lobster_vulcan_uranus,5182809,5,224,347,571,0
5_441439,succumb_sciatica_entertainment_lobster_vulcan_uranus,441439,5,316,447,763,0
5_1363922,succumb_jealousy_entertainment_lobster_vulcan_uranus,1363922,5,344,516,860,0
5_5347858,feast_entertainment_lobster_haroset_bavaria_manitoba,5347858,5,305,510,815,0
5_7467054,feast_entertainment_lobster_bacon_bavaria_manitoba,7467054,5,305,510,815,0
5_3894502,overcome_sciatica_entertainment_lobster_vulcan_uranus,3894502,5,316,427,743,0
5_4816985,overcome_jealousy_entertainment_lobster_vulcan_uranus,4816985,5,346,526,872,0
5_584478,overcome_laceration_entertainment_lobster_vulcan_uranus,584478,5,754,1205,1959,0
5_2432615,overcome_grief_entertainment_lobster_vulcan_uranus,2432615,5,226,347,573,0
5_1616227,noop_eats_haroset_lamb,1616227,5,1,1,2,0
5_3042773,feast_stimulation_haroset_lamb_bavaria_manitoba,3042773,5,671,1117,1788,0
5_5112850,feast_love_haroset_lamb_bavaria_manitoba,5112850,5,450,707,1157,0
5_7114488,feast_lubricity_haroset_lamb_bavaria_manitoba,7114488,5,687,1107,1794,0
5_1354553,feast_aesthetics_haroset_lamb_bavaria_manitoba,1354553,5,595,881,1476,0
5_718803,feast_entertainment_haroset_lamb_bavaria_manitoba,718803,5,521,798,1319,0
5_6034255,noop_eats_beef_lemon,6034255,5,1,1,2,0
5_6870948,feast_love_beef_lemon_bavaria_manitoba,6870948,5,458,724,1182,0
5_2785080,feast_love_beef_lemon_manitoba_pennsylvania,2785080,5,458,724,1182,0
5_2027333,feast_love_beef_lemon_pennsylvania_oregon,2027333,5,604,1019,1623,0
5_1641396,feast_stimulation_beef_lemon_bavaria_manitoba,1641396,5,357,588,945,0
5_2718520,feast_stimulation_beef_lemon_manitoba_pennsylvania,2718520,5,357,588,945,0
5_152103,feast_stimulation_beef_lemon_pennsylvania_oregon,152103,5,477,870,1347,0
5_4528676,feast_entertainment_beef_lemon_bavaria_manitoba,4528676,5,568,839,1407,0
5_1092171,feast_entertainment_beef_lemon_manitoba_pennsylvania,1092171,5,568,839,1407,0
5_5289058,feast_entertainment_beef_lemon_pennsylvania_oregon,5289058,5,712,1128,1840,0
5_6262540,feast_aesthetics_beef_lemon_bavaria_manitoba,6262540,5,657,1002,1659,0
5_5724494,feast_aesthetics_beef_lemon_manitoba_pennsylvania,5724494,5,657,1002,1659,0
5_20541,feast_aesthetics_beef_lemon_pennsylvania_oregon,20541,5,797,1278,2075,0
5_2619727,feast_lubricity_beef_lemon_bavaria_manitoba,2619727,5,353,551,904,0
5_7175086,feast_lubricity_beef_lemon_manitoba_pennsylvania,7175086,5,353,551,904,0
5_2384133,feast_lubricity_beef_lemon_pennsylvania_oregon,2384133,5,459,786,1245,0
5_1903589,noop_food_ham,1903589,5,1,1,2,0
5_6679712,succumb_grief_entertainment_ham_vulcan_uranus,6679712,5,567,888,1455,0
5_1203153,succumb_angina_entertainment_ham_vulcan_uranus,1203153,5,580,880,1460,0
5_5324389,succumb_jealousy_love_ham_vulcan_uranus,5324389,5,497,806,1303,0
5_5874296,succumb_anger_lubricity_ham_uranus_saturn,5874296,5,375,593,968,0
5_1978464,succumb_anger_love_ham_vulcan_uranus,1978464,5,458,763,1221,0
5_5531991,succumb_angina_love_ham_vulcan_uranus,5531991,5,486,763,1249,0
5_5243076,succumb_jealousy_entertainment_ham_vulcan_uranus,5243076,5,587,913,1500,0
5_6278437,succumb_anger_entertainment_ham_vulcan_uranus,6278437,5,565,879,1444,0
5_2355633,feast_aesthetics_ham_flounder_pennsylvania_oregon,2355633,5,650,1000,1650,0
5_7392701,feast_aesthetics_ham_flounder_oregon_goias,7392701,5,650,1000,1650,0
5_1853775,feast_aesthetics_ham_flounder_goias_bosnia,1853775,5,666,1000,1666,0
5_4815740,feast_love_lemon_ham_bavaria_manitoba,4815740,5,680,1109,1789,0
5_5027623,feast_stimulation_flounder_ham_bavaria_manitoba,5027623,5,360,567,927,0
5_4704130,feast_stimulation_flounder_ham_pennsylvania_oregon,4704130,5,389,595,984,0
5_7932547,feast_stimulation_flounder_ham_manitoba_pennsylvania,7932547,5,351,567,918,0
5_1098361,feast_lubricity_flounder_ham_bavaria_manitoba,1098361,5,325,543,868,0
5_1159719,feast_lubricity_flounder_ham_pennsylvania_oregon,1159719,5,361,576,937,0
5_5777515,feast_lubricity_flounder_ham_manitoba_pennsylvania,5777515,5,322,543,865,0
5_7417196,feast_love_ham_flounder_pennsylvania_oregon,7417196,5,438,723,1161,0
5_1982870,feast_love_ham_flounder_oregon_goias,1982870,5,438,723,1161,0
5_4444921,feast_love_ham_flounder_goias_bosnia,4444921,5,455,723,1178,0
5_5714052,feast_love_ham_flounder_manitoba_pennsylvania,5714052,5,717,723,1440,0
5_3339403,feast_aesthetics_flounder_ham_bavaria_manitoba,3339403,5,640,898,1538,0
5_7710104,feast_aesthetics_flounder_ham_pennsylvania_oregon,7710104,5,640,898,1538,0
5_7388917,feast_aesthetics_flounder_ham_manitoba_pennsylvania,7388917,5,640,898,1538,0
5_6955647,feast_lubricity_lemon_ham_bavaria_manitoba,6955647,5,327,537,864,0
5_7350636,feast_stimulation_ham_flounder_pennsylvania_oregon,7350636,5,349,562,911,0
5_761938,feast_stimulation_ham_flounder_oregon_goias,761938,5,349,562,911,0
5_3223989,feast_stimulation_ham_flounder_goias_bosnia,3223989,5,367,562,929,0
5_806102,feast_entertainment_lemon_ham_bavaria_manitoba,806102,5,776,1255,2031,0
5_4295251,feast_stimulation_lemon_ham_bavaria_manitoba,4295251,5,589,1008,1597,0
5_5724287,feast_entertainment_ham_flounder_pennsylvania_oregon,5724287,5,561,837,1398,0
5_154486,feast_entertainment_ham_flounder_oregon_goias,154486,5,561,837,1398,0
5_2616537,feast_entertainment_ham_flounder_goias_bosnia,2616537,5,577,837,1414,0
5_7097700,feast_love_flounder_ham_bavaria_manitoba,7097700,5,456,716,1172,0
5_4770690,feast_love_flounder_ham_pennsylvania_oregon,4770690,5,458,719,1177,0
5_1475265,feast_love_flounder_ham_manitoba_pennsylvania,1475265,5,456,716,1172,0
5_2703653,feast_entertainment_flounder_ham_bavaria_manitoba,2703653,5,529,828,1357,0
5_3077781,feast_entertainment_flounder_ham_pennsylvania_oregon,3077781,5,529,828,1357,0
5_4539100,feast_entertainment_flounder_ham_manitoba_pennsylvania,4539100,5,529,828,1357,0
5_3806225,feast_lubricity_ham_flounder_pennsylvania_oregon,3806225,5,341,555,896,0
5_5397895,feast_lubricity_ham_flounder_oregon_goias,5397895,5,341,555,896,0
5_7859946,feast_lubricity_ham_flounder_goias_bosnia,7859946,5,343,555,898,0
5_7529475,overcome_angina_love_ham_vulcan_uranus,7529475,5,457,763,1220,0
5_3542269,overcome_angina_stimulation_ham_uranus_saturn,3542269,5,360,607,967,0
5_5574087,overcome_angina_entertainment_ham_vulcan_uranus,5574087,5,582,873,1455,0
5_68235,overcome_angina_lubricity_ham_vulcan_uranus,68235,5,344,579,923,0
5_4238840,overcome_angina_lubricity_ham_uranus_saturn,4238840,5,334,570,904,0
5_2611343,overcome_anger_love_ham_vulcan_uranus,2611343,5,473,762,1235,0
5_4630293,overcome_anger_stimulation_ham_uranus_saturn,4630293,5,690,639,1329,0
5_1862416,overcome_anger_lubricity_ham_vulcan_uranus,1862416,5,705,601,1306,0
5_6033021,overcome_anger_lubricity_ham_uranus_saturn,6033021,5,701,592,1293,0
5_450139,overcome_jealousy_love_ham_vulcan_uranus,450139,5,510,806,1316,0
5_5118301,overcome_jealousy_stimulation_ham_uranus_saturn,5118301,5,712,683,1395,0
5_4119535,overcome_jealousy_lubricity_ham_vulcan_uranus,4119535,5,739,734,1473,0
5_289163,overcome_jealousy_lubricity_ham_uranus_saturn,289163,5,735,725,1460,0
5_6089429,noop_fears_jealousy_aesthetics,6089429,5,373,408,781,0
5_3600038,succumb_jealousy_aesthetics_lobster_uranus_saturn,3600038,5,440,649,1089,0
5_7430410,succumb_jealousy_aesthetics_lobster_vulcan_uranus,7430410,5,440,649,1089,0
5_7837246,succumb_jealousy_aesthetics_haroset_uranus_saturn,7837246,5,471,744,1215,0
5_6255097,craves_sciatica_wonderbread,6255097,5,58,42,100,0
5_6110440,craves_jealousy_lamb,6110440,5,34,25,59,0
5_222734,craves_jealousy_haroset,222734,5,29,25,54,0
5_658980,craves_aesthetics_wonderbread,658980,5,22,70,92,0
5_2102130,fears_dread_aesthetics,2102130,5,34,36,70,0
5_492278,fears_sciatica_achievement,492278,5,40,33,73,0
5_4464227,fears_sciatica_learning,4464227,5,47,43,90,0
5_2052314,fears_sciatica_expectation,2052314,5,44,40,84,0
5_1269400,fears_depression_aesthetics,1269400,5,47,6,53,0
5_3769528,noop_craves_abrasion_lemon,3769528,5,80,179,259,0
5_1192447,overcome_abrasion_love_lemon_vulcan_uranus,1192447,5,511,824,1335,0
5_1687825,overcome_abrasion_stimulation_lemon_vulcan_uranus,1687825,5,375,665,1040,0
5_5858430,overcome_abrasion_stimulation_lemon_uranus_saturn,5858430,5,375,665,1040,0
5_4248829,overcome_abrasion_entertainment_lemon_vulcan_uranus,4248829,5,611,997,1608,0
5_5422951,overcome_abrasion_lubricity_lemon_vulcan_uranus,5422951,5,372,641,1013,0
5_1592579,overcome_abrasion_lubricity_lemon_uranus_saturn,1592579,5,346,641,987,0
5_666181,craves_abrasion_marzipan,666181,5,21,23,44,0
5_1803361,craves_abrasion_beef,1803361,5,24,22,46,0
5_1294904,craves_abrasion_lamb,1294904,5,23,23,46,0
5_456128,noop_fears_laceration_love,456128,5,263,386,649,0
5_7512148,succumb_laceration_love_lamb_vulcan_uranus,7512148,5,514,843,1357,0
5_7192833,succumb_laceration_love_lemon_vulcan_uranus,7192833,5,514,843,1357,0
5_5441782,succumb_laceration_love_beef_vulcan_uranus,5441782,5,514,843,1357,0
5_2162529,succumb_laceration_love_marzipan_vulcan_uranus,2162529,5,526,850,1376,0
5_2453,succumb_laceration_love_haroset_vulcan_uranus,2453,5,311,455,766,0
5_2928243,harmony_love_uranus,2928243,5,95,81,176,0
5_1004728,craves_laceration_beef,1004728,5,32,26,58,0
5_496271,craves_laceration_lamb,496271,5,29,27,56,0
5_7814663,craves_laceration_haroset,7814663,5,31,27,58,0
5_1321506,noop_fears_grief_aesthetics,1321506,5,180,203,383,0
5_1821573,succumb_grief_aesthetics_bacon_uranus_saturn,1821573,5,283,462,745,0
5_5651945,succumb_grief_aesthetics_bacon_vulcan_uranus,5651945,5,283,462,745,0
5_3333912,succumb_grief_aesthetics_lobster_uranus_saturn,3333912,5,294,488,782,0
5_7164284,succumb_grief_aesthetics_lobster_vulcan_uranus,7164284,5,294,488,782,0
5_7571120,succumb_grief_aesthetics_haroset_uranus_saturn,7571120,5,415,676,1091,0
5_4671628,noop_craves_anger_flounder,4671628,5,52,90,142,0
5_2734050,overcome_anger_love_flounder_vulcan_uranus,2734050,5,460,759,1219,0
5_3934300,overcome_anger_stimulation_flounder_vulcan_uranus,3934300,5,372,619,991,0
5_103928,overcome_anger_stimulation_flounder_uranus_saturn,103928,5,372,610,982,0
5_817593,overcome_anger_entertainment_flounder_vulcan_uranus,817593,5,533,868,1401,0
5_4330090,overcome_anger_aesthetics_flounder_uranus_saturn,4330090,5,642,941,1583,0
5_4436329,overcome_anger_lubricity_flounder_vulcan_uranus,4436329,5,367,590,957,0
5_605957,overcome_anger_lubricity_flounder_uranus_saturn,605957,5,354,581,935,0
5_2516280,noop_eats_wonderbread_marzipan,2516280,5,1,1,2,0
5_1016330,noop_pleasure_love,1016330,5,1,1,2,0
5_2567359,succumb_depression_love_wonderbread_vulcan_uranus,2567359,5,732,810,1542,0
5_2206194,succumb_abrasion_love_lamb_vulcan_uranus,2206194,5,515,841,1356,0
5_1033722,succumb_abrasion_love_lemon_vulcan_uranus,1033722,5,515,841,1356,0
5_135828,succumb_abrasion_love_beef_vulcan_uranus,135828,5,515,841,1356,0
5_4517208,succumb_abrasion_love_marzipan_vulcan_uranus,4517208,5,522,848,1370,0
5_1323893,succumb_sciatica_love_wonderbread_vulcan_uranus,1323893,5,540,794,1334,0
5_816536,succumb_sciatica_love_bacon_vulcan_uranus,816536,5,584,888,1472,0
5_495122,succumb_sciatica_love_lobster_vulcan_uranus,495122,5,540,795,1335,0
5_5976703,succumb_grief_love_wonderbread_vulcan_uranus,5976703,5,500,796,1296,0
5_2320336,succumb_grief_love_bacon_vulcan_uranus,2320336,5,554,877,1431,0
5_1734444,succumb_grief_love_haroset_vulcan_uranus,1734444,5,416,580,996,0
5_5498213,succumb_grief_love_lobster_vulcan_uranus,5498213,5,505,797,1302,0
5_6846198,succumb_jealousy_love_wonderbread_vulcan_uranus,6846198,5,498,806,1304,0
5_2415109,succumb_jealousy_love_bacon_vulcan_uranus,2415109,5,579,917,1496,0
5_1906499,succumb_jealousy_love_lamb_vulcan_uranus,1906499,5,498,806,1304,0
5_4321572,succumb_jealousy_love_lemon_vulcan_uranus,4321572,5,498,806,1304,0
5_7837110,succumb_jealousy_love_beef_vulcan_uranus,7837110,5,498,806,1304,0
5_6432225,succumb_jealousy_love_marzipan_vulcan_uranus,6432225,5,510,813,1323,0
5_4019620,succumb_jealousy_love_haroset_vulcan_uranus,4019620,5,278,407,685,0
5_6556479,succumb_jealousy_love_flounder_vulcan_uranus,6556479,5,503,806,1309,0
5_7783389,succumb_jealousy_love_lobster_vulcan_uranus,7783389,5,503,807,1310,0
5_556434,succumb_anger_love_lemon_vulcan_uranus,556434,5,465,760,1225,0
5_2066332,succumb_anger_love_haroset_vulcan_uranus,2066332,5,458,763,1221,0
5_2575325,succumb_anger_love_flounder_vulcan_uranus,2575325,5,458,760,1218,0
5_3446381,succumb_prostatitis_love_marzipan_vulcan_uranus,3446381,5,484,810,1294,0
5_4208485,succumb_dread_love_wonderbread_vulcan_uranus,4208485,5,656,753,1409,0
5_64367,succumb_angina_love_lemon_vulcan_uranus,64367,5,486,763,1249,0
5_311154,succumb_angina_love_flounder_vulcan_uranus,311154,5,486,763,1249,0
5_4101321,succumb_hangover_love_wonderbread_vulcan_uranus,4101321,5,716,799,1515,0
5_1482738,feast_love_bacon_lobster_bavaria_manitoba,1482738,5,602,900,1502,0
5_2482178,feast_love_bacon_wonderbread_bavaria_manitoba,2482178,5,602,900,1502,0
5_5016585,feast_love_lamb_beef_oregon_goias,5016585,5,469,730,1199,0
5_6976806,feast_love_lamb_beef_pennsylvania_oregon,6976806,5,469,730,1199,0
5_3839051,feast_love_lamb_beef_manitoba_pennsylvania,3839051,5,469,730,1199,0
5_2475506,feast_love_lamb_beef_bavaria_manitoba,2475506,5,510,730,1240,0
5_7478636,feast_love_lamb_beef_goias_bosnia,7478636,5,675,1121,1796,0
5_5661286,feast_love_lamb_haroset_oregon_goias,5661286,5,469,730,1199,0
5_3565718,feast_love_lamb_haroset_pennsylvania_oregon,3565718,5,469,730,1199,0
5_2073263,feast_love_lamb_haroset_manitoba_pennsylvania,2073263,5,469,730,1199,0
5_2040829,feast_love_lamb_haroset_bavaria_manitoba,2040829,5,510,730,1240,0
5_122360,feast_love_lamb_haroset_goias_bosnia,122360,5,675,1121,1796,0
5_1067745,feast_love_lemon_cantelope_bavaria_manitoba,1067745,5,680,1109,1789,0
5_6581411,feast_love_lemon_beef_bavaria_manitoba,6581411,5,680,1109,1789,0
5_3991422,feast_love_beef_marzipan_bavaria_manitoba,3991422,5,458,724,1182,0
5_6819309,feast_love_beef_marzipan_manitoba_pennsylvania,6819309,5,458,724,1182,0
5_7539176,feast_love_beef_marzipan_pennsylvania_oregon,7539176,5,604,1019,1623,0
5_4775790,feast_love_beef_lamb_bavaria_manitoba,4775790,5,458,724,1182,0
5_4691811,feast_love_beef_lamb_manitoba_pennsylvania,4691811,5,458,724,1182,0
5_7989638,feast_love_beef_lamb_pennsylvania_oregon,7989638,5,604,1019,1623,0
5_183107,feast_love_marzipan_wonderbread_pennsylvania_oregon,183107,5,539,882,1421,0
5_2348506,feast_love_marzipan_wonderbread_manitoba_pennsylvania,2348506,5,482,732,1214,0
5_4910645,feast_love_marzipan_tofu_pennsylvania_oregon,4910645,5,539,882,1421,0
5_4446503,feast_love_marzipan_tofu_manitoba_pennsylvania,4446503,5,482,732,1214,0
5_2441894,feast_love_marzipan_beef_pennsylvania_oregon,2441894,5,539,882,1421,0
5_136884,feast_love_marzipan_beef_manitoba_pennsylvania,136884,5,482,732,1214,0
5_3096043,feast_love_marzipan_cantelope_pennsylvania_oregon,3096043,5,539,882,1421,0
5_1210982,feast_love_marzipan_cantelope_manitoba_pennsylvania,1210982,5,482,732,1214,0
5_328749,feast_love_haroset_flounder_bavaria_manitoba,328749,5,450,707,1157,0
5_6173515,feast_love_flounder_haroset_bavaria_manitoba,6173515,5,908,1181,2089,0
5_6749570,feast_love_flounder_haroset_pennsylvania_oregon,6749570,5,458,719,1177,0
5_1518752,feast_love_flounder_haroset_manitoba_pennsylvania,1518752,5,456,716,1172,0
5_7040767,feast_love_lobster_haroset_bavaria_manitoba,7040767,5,523,802,1325,0
5_4205329,feast_love_lobster_bacon_bavaria_manitoba,4205329,5,523,802,1325,0
5_1426622,overcome_sciatica_love_lobster_vulcan_uranus,1426622,5,542,801,1343,0
5_975261,overcome_sciatica_love_bacon_vulcan_uranus,975261,5,582,888,1470,0
5_5663830,overcome_sciatica_love_haroset_vulcan_uranus,5663830,5,561,821,1382,0
5_146217,overcome_sciatica_love_wonderbread_vulcan_uranus,146217,5,575,775,1350,0
5_2550606,overcome_abrasion_love_lamb_vulcan_uranus,2550606,5,512,841,1353,0
5_480240,overcome_abrasion_love_beef_vulcan_uranus,480240,5,505,841,1346,0
5_2951898,overcome_abrasion_love_marzipan_vulcan_uranus,2951898,5,524,841,1365,0
5_3191094,overcome_angina_love_lemon_vulcan_uranus,3191094,5,700,749,1449,0
5_939869,overcome_angina_love_flounder_vulcan_uranus,939869,5,702,763,1465,0
5_7818142,overcome_depression_love_wonderbread_vulcan_uranus,7818142,5,534,787,1321,0
5_2923645,overcome_hangover_love_wonderbread_vulcan_uranus,2923645,5,526,776,1302,0
5_2268705,overcome_prostatitis_love_marzipan_vulcan_uranus,2268705,5,486,798,1284,0
5_713912,overcome_jealousy_love_lobster_vulcan_uranus,713912,5,505,807,1312,0
5_4991169,overcome_jealousy_love_flounder_vulcan_uranus,4991169,5,505,806,1311,0
5_2573834,overcome_jealousy_love_bacon_vulcan_uranus,2573834,5,581,935,1516,0
5_4951120,overcome_jealousy_love_haroset_vulcan_uranus,4951120,5,269,407,676,0
5_2250911,overcome_jealousy_love_lamb_vulcan_uranus,2250911,5,500,806,1306,0
5_180545,overcome_jealousy_love_beef_vulcan_uranus,180545,5,505,806,1311,0
5_2643175,overcome_dread_love_wonderbread_vulcan_uranus,2643175,5,490,730,1220,0
5_7332920,overcome_laceration_love_haroset_vulcan_uranus,7332920,5,301,448,749,0
5_139886,overcome_laceration_love_lamb_vulcan_uranus,139886,5,516,843,1359,0
5_6070497,overcome_laceration_love_beef_vulcan_uranus,6070497,5,514,843,1357,0
5_6533463,overcome_laceration_love_marzipan_vulcan_uranus,6533463,5,702,848,1550,0
5_123356,overcome_laceration_love_lemon_vulcan_uranus,123356,5,710,826,1536,0
5_2078856,overcome_grief_love_haroset_vulcan_uranus,2078856,5,406,587,993,0
5_1613712,overcome_grief_love_bacon_vulcan_uranus,1613712,5,552,877,1429,0
5_5842625,overcome_grief_love_lobster_vulcan_uranus,5842625,5,507,797,1304,0
5_4411393,overcome_grief_love_wonderbread_vulcan_uranus,4411393,5,625,781,1406,0
5_7044628,noop_craves_expectation_wonderbread,7044628,5,49,61,110,0
5_5267480,succumb_sciatica_expectation_wonderbread_vulcan_uranus,5267480,5,323,460,783,0
5_1437108,succumb_sciatica_expectation_wonderbread_uranus_saturn,1437108,5,314,460,774,0
5_532580,succumb_depression_expectation_wonderbread_vulcan_uranus,532580,5,147,179,326,0
5_4703185,succumb_depression_expectation_wonderbread_uranus_saturn,4703185,5,132,179,311,0
5_5699864,succumb_dread_expectation_wonderbread_vulcan_uranus,5699864,5,130,151,281,0
5_1869492,succumb_dread_expectation_wonderbread_uranus_saturn,1869492,5,116,151,267,0
5_5814941,succumb_hangover_expectation_wonderbread_vulcan_uranus,5814941,5,124,170,294,0
5_1984569,succumb_hangover_expectation_wonderbread_uranus_saturn,1984569,5,124,170,294,0
5_1740408,overcome_sciatica_expectation_wonderbread_uranus_saturn,1740408,5,297,324,621,0
5_5570780,overcome_sciatica_expectation_wonderbread_vulcan_uranus,5570780,5,297,324,621,0
5_7345117,overcome_depression_expectation_wonderbread_uranus_saturn,7345117,5,135,180,315,0
5_3174512,overcome_depression_expectation_wonderbread_vulcan_uranus,3174512,5,134,179,313,0
5_2287869,overcome_hangover_expectation_wonderbread_uranus_saturn,2287869,5,127,171,298,0
5_6118241,overcome_hangover_expectation_wonderbread_vulcan_uranus,6118241,5,126,170,296,0
5_3164387,overcome_dread_expectation_wonderbread_uranus_saturn,3164387,5,119,152,271,0
5_6994759,overcome_dread_expectation_wonderbread_vulcan_uranus,6994759,5,118,151,269,0
5_7213551,overcome_grief_expectation_wonderbread_uranus_saturn,7213551,5,493,602,1095,0
5_3042946,overcome_grief_expectation_wonderbread_vulcan_uranus,3042946,5,493,602,1095,0
5_1619342,locale_okra_manitoba,1619342,5,18,12,30,0
5_2455781,craves_expectation_snickers,2455781,5,18,24,42,0
5_6885171,craves_expectation_okra,6885171,5,16,21,37,0
5_2910864,noop_locale_okra_bavaria,2910864,5,6,6,12,0
5_2244238,noop_fears_anger_stimulation,2244238,5,664,448,1112,0
5_5552835,succumb_anger_stimulation_flounder_uranus_saturn,5552835,5,708,620,1328,0
5_4950870,succumb_anger_stimulation_haroset_uranus_saturn,4950870,5,708,621,1329,0
5_6440884,noop_craves_abrasion_lamb,6440884,5,80,179,259,0
5_6990583,overcome_abrasion_stimulation_lamb_vulcan_uranus,6990583,5,366,657,1023,0
5_3160211,overcome_abrasion_stimulation_lamb_uranus_saturn,3160211,5,366,657,1023,0
5_5625419,overcome_abrasion_entertainment_lamb_vulcan_uranus,5625419,5,589,946,1535,0
5_7891030,overcome_abrasion_aesthetics_lamb_uranus_saturn,7891030,5,690,1017,1707,0
5_3317223,overcome_abrasion_lubricity_lamb_vulcan_uranus,3317223,5,381,653,1034,0
5_7487828,overcome_abrasion_lubricity_lamb_uranus_saturn,7487828,5,371,644,1015,0
5_6559853,craves_abrasion_lemon,6559853,5,21,22,43,0
5_7755206,noop_craves_aesthetics_ham,7755206,5,627,959,1586,0
5_2814490,harmony_aesthetics_saturn,2814490,5,90,97,187,0
5_384688,harmony_aesthetics_vulcan,384688,5,40,32,72,0
5_3889381,harmony_aesthetics_uranus,3889381,5,72,76,148,0
5_5951675,fears_sciatica_aesthetics,5951675,5,37,33,70,0
5_6898824,craves_sciatica_lobster,6898824,5,41,36,77,0
5_7012217,locale_flounder_oregon,7012217,5,20,15,35,0
5_3765671,noop_fears_sciatica_lubricity,3765671,5,581,651,1232,0
5_4944137,harmony_lubricity_earth,4944137,5,100,82,182,0
5_3121428,craves_sciatica_bacon,3121428,5,24,22,46,0
5_4802981,noop_eats_marzipan_wonderbread,4802981,5,1,1,2,0
5_4836223,feast_entertainment_marzipan_wonderbread_pennsylvania_oregon,4836223,5,641,1047,1688,0
5_7722281,feast_entertainment_marzipan_wonderbread_manitoba_pennsylvania,7722281,5,586,903,1489,0
5_7061695,feast_stimulation_marzipan_wonderbread_pennsylvania_oregon,7061695,5,407,739,1146,0
5_6445540,feast_stimulation_marzipan_wonderbread_manitoba_pennsylvania,6445540,5,366,612,978,0
5_6454858,feast_lubricity_marzipan_wonderbread_pennsylvania_oregon,6454858,5,386,653,1039,0
5_1631598,feast_lubricity_marzipan_wonderbread_manitoba_pennsylvania,1631598,5,361,585,946,0
5_2601920,noop_harmony_expectation_saturn,2601920,5,59,91,150,0
5_4815849,overcome_anxiety_expectation_onion_uranus_saturn,4815849,5,188,200,388,0
5_1199656,overcome_depression_expectation_okra_uranus_saturn,1199656,5,148,179,327,0
5_5868596,overcome_depression_expectation_snickers_uranus_saturn,5868596,5,151,182,333,0
5_7361263,overcome_depression_expectation_onion_uranus_saturn,7361263,5,203,239,442,0
5_4306136,overcome_hangover_expectation_okra_uranus_saturn,4306136,5,125,170,295,0
5_2522443,overcome_hangover_expectation_onion_uranus_saturn,2522443,5,200,266,466,0
5_6675930,overcome_hangover_expectation_snickers_uranus_saturn,6675930,5,128,173,301,0
5_2966295,harmony_expectation_uranus,2966295,5,48,32,80,0
5_7462579,harmony_expectation_vulcan,7462579,5,31,16,47,0
5_2227981,noop_food_marzipan,2227981,5,1,1,2,0
5_3149333,succumb_laceration_stimulation_marzipan_uranus_saturn,3149333,5,380,655,1035,0
5_7232890,succumb_prostatitis_lubricity_marzipan_uranus_saturn,7232890,5,357,616,973,0
5_6670644,succumb_abrasion_stimulation_marzipan_uranus_saturn,6670644,5,386,679,1065,0
5_6373882,succumb_abrasion_lubricity_marzipan_uranus_saturn,6373882,5,393,669,1062,0
5_7744760,succumb_prostatitis_stimulation_marzipan_uranus_saturn,7744760,5,353,637,990,0
5_3578699,feast_entertainment_marzipan_tofu_pennsylvania_oregon,3578699,5,641,1047,1688,0
5_4692517,feast_entertainment_marzipan_tofu_manitoba_pennsylvania,4692517,5,586,903,1489,0
5_1109948,feast_entertainment_marzipan_beef_pennsylvania_oregon,1109948,5,641,1047,1688,0
5_382898,feast_entertainment_marzipan_beef_manitoba_pennsylvania,382898,5,586,903,1489,0
5_1111985,feast_entertainment_marzipan_cantelope_pennsylvania_oregon,1111985,5,641,1047,1688,0
5_5864098,feast_entertainment_marzipan_cantelope_manitoba_pennsylvania,5864098,5,586,903,1489,0
5_3873239,feast_stimulation_marzipan_tofu_pennsylvania_oregon,3873239,5,407,739,1146,0
5_1308456,feast_stimulation_marzipan_tofu_manitoba_pennsylvania,1308456,5,366,612,978,0
5_1404488,feast_stimulation_marzipan_beef_pennsylvania_oregon,1404488,5,407,739,1146,0
5_4999814,feast_stimulation_marzipan_beef_manitoba_pennsylvania,4999814,5,366,612,978,0
5_3573257,feast_stimulation_marzipan_cantelope_pennsylvania_oregon,3573257,5,407,739,1146,0
5_88593,feast_stimulation_marzipan_cantelope_manitoba_pennsylvania,88593,5,366,612,978,0
5_614424,feast_lubricity_marzipan_tofu_pennsylvania_oregon,614424,5,386,653,1039,0
5_1687677,feast_lubricity_marzipan_tofu_manitoba_pennsylvania,1687677,5,361,585,946,0
5_6146650,feast_lubricity_marzipan_beef_pennsylvania_oregon,6146650,5,386,653,1039,0
5_5379035,feast_lubricity_marzipan_beef_manitoba_pennsylvania,5379035,5,361,585,946,0
5_3304294,feast_lubricity_marzipan_cantelope_pennsylvania_oregon,3304294,5,386,653,1039,0
5_7482733,feast_lubricity_marzipan_cantelope_manitoba_pennsylvania,7482733,5,361,585,946,0
5_2116192,feast_stimulation_beef_marzipan_bavaria_manitoba,2116192,5,357,588,945,0
5_3681262,feast_stimulation_beef_marzipan_manitoba_pennsylvania,3681262,5,357,588,945,0
5_6501770,feast_stimulation_beef_marzipan_pennsylvania_oregon,6501770,5,477,870,1347,0
5_7253147,feast_entertainment_beef_marzipan_bavaria_manitoba,7253147,5,568,839,1407,0
5_7065323,feast_entertainment_beef_marzipan_manitoba_pennsylvania,7065323,5,568,839,1407,0
5_6207230,feast_entertainment_beef_marzipan_pennsylvania_oregon,6207230,5,712,1128,1840,0
5_1984630,feast_aesthetics_beef_marzipan_bavaria_manitoba,1984630,5,657,1002,1659,0
5_528591,feast_aesthetics_beef_marzipan_manitoba_pennsylvania,528591,5,657,1002,1659,0
5_7937322,feast_aesthetics_beef_marzipan_pennsylvania_oregon,7937322,5,797,1278,2075,0
5_4348222,feast_lubricity_beef_marzipan_bavaria_manitoba,4348222,5,353,551,904,0
5_4060483,feast_lubricity_beef_marzipan_manitoba_pennsylvania,4060483,5,353,551,904,0
5_3242955,feast_lubricity_beef_marzipan_pennsylvania_oregon,3242955,5,459,786,1245,0
5_3794934,overcome_abrasion_stimulation_marzipan_vulcan_uranus,3794934,5,388,679,1067,0
5_7965539,overcome_abrasion_stimulation_marzipan_uranus_saturn,7965539,5,388,679,1067,0
5_2434455,overcome_abrasion_entertainment_marzipan_vulcan_uranus,2434455,5,623,1009,1632,0
5_7454060,overcome_abrasion_lubricity_marzipan_vulcan_uranus,7454060,5,395,669,1064,0
5_3623688,overcome_abrasion_lubricity_marzipan_uranus_saturn,3623688,5,385,662,1047,0
5_3877455,overcome_prostatitis_stimulation_marzipan_vulcan_uranus,3877455,5,355,637,992,0
5_47083,overcome_prostatitis_stimulation_marzipan_uranus_saturn,47083,5,355,637,992,0
5_1870259,overcome_prostatitis_entertainment_marzipan_vulcan_uranus,1870259,5,585,969,1554,0
5_6515348,overcome_prostatitis_lubricity_marzipan_vulcan_uranus,6515348,5,359,616,975,0
5_2684976,overcome_prostatitis_lubricity_marzipan_uranus_saturn,2684976,5,349,609,958,0
5_3735719,overcome_laceration_entertainment_marzipan_vulcan_uranus,3735719,5,781,1003,1784,0
5_1933352,overcome_laceration_lubricity_marzipan_vulcan_uranus,1933352,5,635,749,1384,0
5_6103957,overcome_laceration_lubricity_marzipan_uranus_saturn,6103957,5,628,742,1370,0
5_2231879,noop_fears_boils_lubricity,2231879,5,115,186,301,0
5_2631839,noop_craves_love_wonderbread,2631839,5,424,655,1079,0
5_4303857,noop_craves_grief_haroset,4303857,5,237,332,569,0
5_6350567,overcome_grief_stimulation_haroset_vulcan_uranus,6350567,5,525,822,1347,0
5_2520195,overcome_grief_stimulation_haroset_uranus_saturn,2520195,5,525,808,1333,0
5_6669823,overcome_grief_entertainment_haroset_vulcan_uranus,6669823,5,347,598,945,0
5_7771449,overcome_grief_aesthetics_haroset_vulcan_uranus,7771449,5,417,676,1093,0
5_3941077,overcome_grief_aesthetics_haroset_uranus_saturn,3941077,5,417,668,1085,0
5_269703,overcome_grief_lubricity_haroset_uranus_saturn,269703,5,531,793,1324,0
5_843471,noop_craves_entertainment_bacon,843471,5,295,502,797,0
5_6017560,succumb_grief_entertainment_bacon_vulcan_uranus,6017560,5,345,598,943,0
5_3700066,succumb_sciatica_entertainment_bacon_vulcan_uranus,3700066,5,364,588,952,0
5_4744463,feast_entertainment_bacon_lobster_bavaria_manitoba,4744463,5,383,601,984,0
5_5546013,feast_entertainment_bacon_wonderbread_bavaria_manitoba,5546013,5,383,601,984,0
5_3736378,overcome_sciatica_entertainment_bacon_vulcan_uranus,3736378,5,366,588,954,0
5_4839884,overcome_grief_entertainment_bacon_vulcan_uranus,4839884,5,347,598,945,0
5_2003721,noop_harmony_stimulation_uranus,2003721,5,251,463,714,0
5_6098332,succumb_laceration_stimulation_lamb_uranus_saturn,6098332,5,358,633,991,0
5_3273587,succumb_laceration_stimulation_flounder_uranus_saturn,3273587,5,376,644,1020,0
5_4027966,succumb_laceration_stimulation_beef_uranus_saturn,4027966,5,365,643,1008,0
5_7442272,succumb_laceration_stimulation_haroset_uranus_saturn,7442272,5,365,642,1007,0
5_5925568,succumb_laceration_stimulation_lemon_uranus_saturn,5925568,5,367,641,1008,0
5_3205064,succumb_laceration_stimulation_lobster_uranus_saturn,3205064,5,708,1188,1896,0
5_4337887,succumb_abrasion_stimulation_lamb_uranus_saturn,4337887,5,373,657,1030,0
5_2267521,succumb_abrasion_stimulation_beef_uranus_saturn,2267521,5,371,667,1038,0
5_7987342,succumb_abrasion_stimulation_haroset_uranus_saturn,7987342,5,373,666,1039,0
5_3306360,succumb_abrasion_stimulation_lemon_uranus_saturn,3306360,5,373,665,1038,0
5_3697871,succumb_grief_stimulation_haroset_uranus_saturn,3697871,5,528,817,1345,0
5_7461640,succumb_grief_stimulation_lobster_uranus_saturn,7461640,5,731,1216,1947,0
5_5144146,succumb_sciatica_stimulation_lobster_uranus_saturn,5144146,5,767,1220,1987,0
5_6958152,succumb_jealousy_stimulation_lamb_uranus_saturn,6958152,5,390,680,1070,0
5_3527847,succumb_jealousy_stimulation_flounder_uranus_saturn,3527847,5,408,691,1099,0
5_4887786,succumb_jealousy_stimulation_beef_uranus_saturn,4887786,5,399,690,1089,0
5_7818311,succumb_jealousy_stimulation_haroset_uranus_saturn,7818311,5,397,689,1086,0
5_3581103,succumb_jealousy_stimulation_lobster_uranus_saturn,3581103,5,712,1194,1906,0
5_4158390,succumb_prostatitis_stimulation_beef_uranus_saturn,4158390,5,353,638,991,0
5_1009853,overcome_sciatica_stimulation_lobster_vulcan_uranus,1009853,5,763,1226,1989,0
5_5247061,overcome_sciatica_stimulation_haroset_vulcan_uranus,5247061,5,674,1047,1721,0
5_4920217,overcome_abrasion_stimulation_beef_vulcan_uranus,4920217,5,373,667,1040,0
5_4271803,overcome_angina_stimulation_flounder_vulcan_uranus,4271803,5,621,636,1257,0
5_7447787,overcome_jealousy_stimulation_lobster_vulcan_uranus,7447787,5,714,1194,1908,0
5_652137,overcome_jealousy_stimulation_flounder_vulcan_uranus,652137,5,679,691,1370,0
5_3684018,overcome_jealousy_stimulation_haroset_vulcan_uranus,3684018,5,399,689,1088,0
5_1609871,overcome_jealousy_stimulation_lamb_vulcan_uranus,1609871,5,392,680,1072,0
5_7540482,overcome_jealousy_stimulation_beef_vulcan_uranus,7540482,5,702,690,1392,0
5_6724730,overcome_laceration_stimulation_haroset_vulcan_uranus,6724730,5,368,642,1010,0
5_7178510,overcome_laceration_stimulation_lamb_vulcan_uranus,7178510,5,360,633,993,0
5_5108144,overcome_laceration_stimulation_beef_vulcan_uranus,5108144,5,367,643,1010,0
5_352742,overcome_grief_stimulation_lamb_vulcan_uranus,352742,5,769,1198,1967,0
5_2113359,overcome_grief_stimulation_lobster_vulcan_uranus,2113359,5,730,1216,1946,0
5_1447385,craves_stimulation_ham,1447385,5,38,65,103,0
5_218314,harmony_stimulation_saturn,218314,5,174,143,317,0
5_5175958,noop_craves_depression_okra,5175958,5,87,105,192,0
5_5030028,overcome_depression_expectation_okra_vulcan_uranus,5030028,5,148,179,327,0
5_1390631,overcome_depression_learning_okra_uranus_saturn,1390631,5,144,194,338,0
5_6295867,noop_craves_anger_ham,6295867,5,456,121,577,0
5_1950022,noop_fears_hangover_stimulation,1950022,5,455,587,1042,0
5_478591,fears_hangover_expectation,478591,5,30,23,53,0
5_1750334,craves_hangover_snickers,1750334,5,22,17,39,0
5_6919532,fears_hangover_achievement,6919532,5,24,15,39,0
5_2802576,fears_hangover_learning,2802576,5,30,24,54,0
5_4681374,craves_hangover_wonderbread,4681374,5,43,31,74,0
5_2633557,craves_hangover_okra,2633557,5,21,17,38,0
5_778640,noop_eats_onion_snickers,778640,5,1,1,2,0
5_1323959,noop_province_oregon,1323959,5,1,1,2,0
5_2720041,noop_fears_dread_achievement,2720041,5,44,46,90,0
5_3353748,succumb_dread_achievement_wonderbread_uranus_saturn,3353748,5,62,81,143,0
5_7184120,succumb_dread_achievement_wonderbread_vulcan_uranus,7184120,5,62,81,143,0
5_150287,fears_dread_learning,150287,5,23,20,43,0
5_2984277,harmony_achievement_saturn,2984277,5,15,17,32,0
5_688965,fears_dread_expectation,688965,5,20,17,37,0
5_7952859,craves_dread_wonderbread,7952859,5,39,25,64,0
5_8131,noop_craves_learning_wonderbread,8131,5,65,85,150,0
5_6361188,succumb_hangover_learning_wonderbread_vulcan_uranus,6361188,5,155,191,346,0
5_2009394,succumb_sciatica_learning_wonderbread_vulcan_uranus,2009394,5,339,484,823,0
5_2972091,succumb_depression_learning_wonderbread_vulcan_uranus,2972091,5,140,191,331,0
5_6563539,succumb_dread_learning_wonderbread_vulcan_uranus,6563539,5,146,175,321,0
5_7474894,overcome_sciatica_learning_wonderbread_uranus_saturn,7474894,5,313,348,661,0
5_3018377,overcome_depression_learning_wonderbread_uranus_saturn,3018377,5,143,192,335,0
5_3825711,overcome_hangover_learning_wonderbread_uranus_saturn,3825711,5,143,192,335,0
5_5285237,overcome_dread_learning_wonderbread_uranus_saturn,5285237,5,135,176,311,0
5_1937258,overcome_grief_learning_wonderbread_uranus_saturn,1937258,5,509,626,1135,0
5_1477182,noop_craves_love_bacon,1477182,5,516,813,1329,0
5_7779537,noop_craves_hangover_okra,7779537,5,68,89,157,0
5_135531,overcome_hangover_expectation_okra_vulcan_uranus,135531,5,125,170,295,0
5_118053,overcome_hangover_learning_okra_uranus_saturn,118053,5,159,194,353,0
5_7173461,noop_harmony_stimulation_earth,7173461,5,219,404,623,0
5_6230769,noop_locale_snickers_bavaria,6230769,5,8,8,16,0
5_1706395,noop_craves_grief_bacon,1706395,5,191,342,533,0
5_871795,overcome_grief_stimulation_bacon_uranus_saturn,871795,5,794,1281,2075,0
5_4086635,overcome_grief_aesthetics_bacon_vulcan_uranus,4086635,5,272,462,734,0
5_256263,overcome_grief_aesthetics_bacon_uranus_saturn,256263,5,272,462,734,0
5_5772160,noop_craves_boils_marzipan,5772160,5,338,525,863,0
5_2854983,noop_craves_grief_lamb,2854983,5,543,789,1332,0
5_4523347,overcome_grief_stimulation_lamb_uranus_saturn,4523347,5,769,1198,1967,0
5_1197133,overcome_grief_entertainment_lamb_vulcan_uranus,1197133,5,564,881,1445,0
5_7794353,overcome_grief_lubricity_lamb_vulcan_uranus,7794353,5,793,1211,2004,0
5_3963981,overcome_grief_lubricity_lamb_uranus_saturn,3963981,5,789,1203,1992,0
5_1137858,noop_craves_entertainment_marzipan,1137858,5,549,862,1411,0
5_1666233,noop_craves_stimulation_marzipan,1666233,5,305,525,830,0
5_5280719,noop_eats_snickers_onion,5280719,5,1,1,2,0
5_6245149,feast_expectation_snickers_onion_bavaria_manitoba,6245149,5,163,200,363,0
5_2466891,feast_learning_snickers_onion_bavaria_manitoba,2466891,5,110,136,246,0
5_376993,noop_craves_love_tofu,376993,5,462,712,1174,0
5_7667263,noop_fears_hangover_aesthetics,7667263,5,283,397,680,0
5_1013755,succumb_hangover_aesthetics_wonderbread_uranus_saturn,1013755,5,314,440,754,0
5_4844127,succumb_hangover_aesthetics_wonderbread_vulcan_uranus,4844127,5,326,440,766,0
5_513547,noop_craves_boils_lemon,513547,5,92,179,271,0
5_7165176,noop_craves_dread_wonderbread,7165176,5,43,46,89,0
5_478038,overcome_dread_achievement_wonderbread_vulcan_uranus,478038,5,64,81,145,0
5_4648643,overcome_dread_achievement_wonderbread_uranus_saturn,4648643,5,67,82,149,0
5_6937064,overcome_dread_stimulation_wonderbread_uranus_saturn,6937064,5,360,588,948,0
5_3630267,overcome_dread_entertainment_wonderbread_vulcan_uranus,3630267,5,406,559,965,0
5_535709,overcome_dread_aesthetics_wonderbread_vulcan_uranus,535709,5,255,392,647,0
5_4706314,overcome_dread_aesthetics_wonderbread_uranus_saturn,4706314,5,245,392,637,0
5_2458116,overcome_dread_lubricity_wonderbread_uranus_saturn,2458116,5,391,591,982,0
5_554475,harmony_achievement_vulcan,554475,5,19,6,25,0
5_7129906,fears_dread_achievement,7129906,5,13,8,21,0
5_3800886,noop_pain_sciatica,3800886,5,1,1,2,0
5_5169740,succumb_sciatica_aesthetics_bacon_uranus_saturn,5169740,5,224,404,628,0
5_999135,succumb_sciatica_aesthetics_bacon_vulcan_uranus,999135,5,224,404,628,0
5_2012199,succumb_sciatica_aesthetics_lobster_uranus_saturn,2012199,5,260,427,687,0
5_5842571,succumb_sciatica_aesthetics_lobster_vulcan_uranus,5842571,5,260,427,687,0
5_4668313,succumb_sciatica_aesthetics_wonderbread_uranus_saturn,4668313,5,259,426,685,0
5_497708,succumb_sciatica_aesthetics_wonderbread_vulcan_uranus,497708,5,259,426,685,0
5_6249407,succumb_sciatica_aesthetics_haroset_uranus_saturn,6249407,5,406,654,1060,0
5_2921364,succumb_sciatica_achievement_wonderbread_uranus_saturn,2921364,5,265,390,655,0
5_6751736,succumb_sciatica_achievement_wonderbread_vulcan_uranus,6751736,5,291,390,681,0
5_2496319,succumb_sciatica_entertainment_wonderbread_vulcan_uranus,2496319,5,406,599,1005,0
5_7055036,overcome_sciatica_achievement_wonderbread_vulcan_uranus,7055036,5,246,254,500,0
5_3224664,overcome_sciatica_achievement_wonderbread_uranus_saturn,3224664,5,249,254,503,0
5_5180458,overcome_sciatica_stimulation_lobster_uranus_saturn,5180458,5,763,1221,1984,0
5_5120588,overcome_sciatica_stimulation_bacon_uranus_saturn,5120588,5,820,1295,2115,0
5_1416689,overcome_sciatica_stimulation_haroset_uranus_saturn,1416689,5,674,1036,1710,0
5_5513085,overcome_sciatica_stimulation_wonderbread_uranus_saturn,5513085,5,520,736,1256,0
5_5138251,overcome_sciatica_entertainment_wonderbread_vulcan_uranus,5138251,5,413,599,1012,0
5_3092377,overcome_sciatica_aesthetics_lobster_vulcan_uranus,3092377,5,262,427,689,0
5_7262982,overcome_sciatica_aesthetics_lobster_uranus_saturn,7262982,5,262,427,689,0
5_7822436,overcome_sciatica_aesthetics_bacon_vulcan_uranus,7822436,5,226,404,630,0
5_3992064,overcome_sciatica_aesthetics_bacon_uranus_saturn,3992064,5,226,404,630,0
5_4374366,overcome_sciatica_aesthetics_wonderbread_vulcan_uranus,4374366,5,261,426,687,0
5_543994,overcome_sciatica_aesthetics_wonderbread_uranus_saturn,543994,5,261,426,687,0
5_4518496,overcome_sciatica_lubricity_haroset_uranus_saturn,4518496,5,679,1029,1708,0
5_2941918,overcome_sciatica_lubricity_wonderbread_uranus_saturn,2941918,5,555,741,1296,0
5_1260143,noop_craves_love_lamb,1260143,5,431,692,1123,0
5_2799837,noop_craves_lubricity_marzipan,2799837,5,300,502,802,0
5_4813922,noop_harmony_learning_saturn,4813922,5,55,88,143,0
5_321444,overcome_anxiety_learning_onion_uranus_saturn,321444,5,114,142,256,0
5_2696465,overcome_depression_learning_snickers_uranus_saturn,2696465,5,127,170,297,0
5_244024,overcome_depression_learning_onion_uranus_saturn,244024,5,144,193,337,0
5_5858622,overcome_hangover_learning_snickers_uranus_saturn,5858622,5,144,170,314,0
5_2297701,harmony_learning_uranus,2297701,5,44,23,67,0
5_3958185,noop_attacks_pennsylvania_oregon,3958185,5,1,1,2,0
5_4906729,feast_stimulation_lamb_beef_pennsylvania_oregon,4906729,5,351,584,935,0
5_3499158,feast_stimulation_lamb_haroset_pennsylvania_oregon,3499158,5,351,584,935,0
5_3507238,feast_stimulation_flounder_haroset_pennsylvania_oregon,3507238,5,389,595,984,0
5_4576090,feast_lubricity_flounder_haroset_pennsylvania_oregon,4576090,5,361,576,937,0
5_5919561,feast_stimulation_beef_lamb_pennsylvania_oregon,5919561,5,477,870,1347,0
5_4522139,feast_aesthetics_flounder_haroset_pennsylvania_oregon,4522139,5,640,898,1538,0
5_2582759,feast_entertainment_lamb_beef_pennsylvania_oregon,2582759,5,541,838,1379,0
5_1872809,feast_entertainment_lamb_haroset_pennsylvania_oregon,1872809,5,541,838,1379,0
5_3218509,feast_aesthetics_lamb_beef_pennsylvania_oregon,3218509,5,645,908,1553,0
5_6505132,feast_aesthetics_lamb_haroset_pennsylvania_oregon,6505132,5,645,908,1553,0
5_977467,feast_lubricity_lamb_beef_pennsylvania_oregon,977467,5,347,561,908,0
5_7955724,feast_lubricity_lamb_haroset_pennsylvania_oregon,7955724,5,347,561,908,0
5_3595591,feast_entertainment_beef_lamb_pennsylvania_oregon,3595591,5,712,1128,1840,0
5_4231341,feast_aesthetics_beef_lamb_pennsylvania_oregon,4231341,5,797,1278,2075,0
5_1990299,feast_lubricity_beef_lamb_pennsylvania_oregon,1990299,5,459,786,1245,0
5_5721338,feast_entertainment_flounder_haroset_pennsylvania_oregon,5721338,5,529,828,1357,0
5_6772543,noop_pain_anxiety,6772543,5,1,1,2,0
5_5717126,succumb_anxiety_learning_onion_vulcan_uranus,5717126,5,112,143,255,0
5_1822920,succumb_anxiety_expectation_onion_vulcan_uranus,1822920,5,199,259,458,0
5_5993525,succumb_anxiety_expectation_onion_uranus_saturn,5993525,5,199,253,452,0
5_645244,overcome_anxiety_expectation_onion_vulcan_uranus,645244,5,191,200,391,0
5_1573596,noop_fears_laceration_stimulation,1573596,5,115,205,320,0
5_1927727,succumb_laceration_stimulation_lamb_vulcan_uranus,1927727,5,358,633,991,0
5_7858338,succumb_laceration_stimulation_beef_vulcan_uranus,7858338,5,366,643,1009,0
5_3271667,succumb_laceration_stimulation_haroset_vulcan_uranus,3271667,5,366,642,1008,0
5_1498085,noop_locale_lamb_goias,1498085,5,51,56,107,0
5_2708932,feast_stimulation_lamb_beef_oregon_goias,2708932,5,351,584,935,0
5_4440354,feast_stimulation_lamb_haroset_oregon_goias,4440354,5,351,584,935,0
5_1685627,feast_entertainment_lamb_beef_oregon_goias,1685627,5,541,838,1379,0
5_3832902,feast_entertainment_lamb_haroset_oregon_goias,3832902,5,541,838,1379,0
5_3081722,feast_aesthetics_lamb_beef_oregon_goias,3081722,5,645,908,1553,0
5_3070140,feast_aesthetics_lamb_haroset_oregon_goias,3070140,5,645,908,1553,0
5_3218010,feast_lubricity_lamb_beef_oregon_goias,3218010,5,347,561,908,0
5_1075334,feast_lubricity_lamb_haroset_oregon_goias,1075334,5,347,561,908,0
5_7086086,locale_lamb_pennsylvania,7086086,5,24,15,39,0
5_7037277,locale_lamb_oregon,7037277,5,24,15,39,0
5_6949341,noop_craves_abrasion_beef,6949341,5,80,179,259,0
5_1089845,overcome_abrasion_stimulation_beef_uranus_saturn,1089845,5,373,667,1040,0
5_3555053,overcome_abrasion_entertainment_beef_vulcan_uranus,3555053,5,616,950,1566,0
5_1246857,overcome_abrasion_lubricity_beef_vulcan_uranus,1246857,5,381,656,1037,0
5_5417462,overcome_abrasion_lubricity_beef_uranus_saturn,5417462,5,371,640,1011,0
5_1760814,noop_locale_onion_bavaria,1760814,5,1,1,2,0
5_3197964,noop_locale_beef_manitoba,3197964,5,49,49,98,0
5_4255301,feast_stimulation_beef_lamb_bavaria_manitoba,4255301,5,357,588,945,0
5_766152,feast_entertainment_beef_lamb_bavaria_manitoba,766152,5,568,839,1407,0
5_5523505,feast_aesthetics_beef_lamb_bavaria_manitoba,5523505,5,657,1002,1659,0
5_6915697,feast_lubricity_beef_lamb_bavaria_manitoba,6915697,5,353,551,904,0
5_7015491,locale_beef_pennsylvania,7015491,5,33,18,51,0
5_5689671,locale_beef_bavaria,5689671,5,18,2,20,0
5_4389637,noop_fears_depression_love,4389637,5,725,806,1531,0
5_7969387,noop_craves_achievement_wonderbread,7969387,5,1,1,2,0
5_6187441,succumb_depression_achievement_wonderbread_uranus_saturn,6187441,5,144,140,284,0
5_2016836,succumb_depression_achievement_wonderbread_vulcan_uranus,2016836,5,177,140,317,0
5_3468825,succumb_hangover_achievement_wonderbread_uranus_saturn,3468825,5,128,128,256,0
5_7299197,succumb_hangover_achievement_wonderbread_vulcan_uranus,7299197,5,161,128,289,0
5_4658768,overcome_depression_achievement_wonderbread_vulcan_uranus,4658768,5,112,140,252,0
5_828396,overcome_depression_achievement_wonderbread_uranus_saturn,828396,5,115,141,256,0
5_7602497,overcome_hangover_achievement_wonderbread_vulcan_uranus,7602497,5,104,128,232,0
5_3772125,overcome_hangover_achievement_wonderbread_uranus_saturn,3772125,5,107,129,236,0
5_4527202,overcome_grief_achievement_wonderbread_vulcan_uranus,4527202,5,442,532,974,0
5_696830,overcome_grief_achievement_wonderbread_uranus_saturn,696830,5,445,532,977,0
5_4565515,noop_orbits_vulcan_uranus,4565515,5,1,1,2,0
5_4827176,succumb_grief_entertainment_lamb_vulcan_uranus,4827176,5,562,877,1439,0
5_2756810,succumb_grief_entertainment_beef_vulcan_uranus,2756810,5,567,888,1455,0
5_1419040,succumb_grief_entertainment_haroset_vulcan_uranus,1419040,5,345,598,943,0
5_5362331,succumb_grief_entertainment_wonderbread_vulcan_uranus,5362331,5,417,609,1026,0
5_4889090,succumb_grief_entertainment_flounder_vulcan_uranus,4889090,5,555,877,1432,0
5_7780222,succumb_depression_expectation_okra_vulcan_uranus,7780222,5,146,179,325,0
5_5822310,succumb_depression_expectation_snickers_vulcan_uranus,5822310,5,149,182,331,0
5_3154346,succumb_depression_expectation_onion_vulcan_uranus,3154346,5,196,245,441,0
5_167282,succumb_abrasion_stimulation_lamb_vulcan_uranus,167282,5,373,657,1030,0
5_6097893,succumb_abrasion_stimulation_beef_vulcan_uranus,6097893,5,372,667,1039,0
5_3816737,succumb_abrasion_stimulation_haroset_vulcan_uranus,3816737,5,373,666,1039,0
5_6810793,succumb_laceration_entertainment_lamb_vulcan_uranus,6810793,5,592,940,1532,0
5_4740427,succumb_laceration_entertainment_beef_vulcan_uranus,4740427,5,612,951,1563,0
5_4518386,succumb_laceration_entertainment_haroset_vulcan_uranus,4518386,5,399,661,1060,0
5_7754586,succumb_dread_entertainment_wonderbread_vulcan_uranus,7754586,5,436,630,1066,0
5_5513735,succumb_hangover_learning_okra_vulcan_uranus,5513735,5,157,194,351,0
5_7136924,succumb_hangover_learning_snickers_vulcan_uranus,7136924,5,147,170,317,0
5_7528243,succumb_grief_stimulation_haroset_vulcan_uranus,7528243,5,528,817,1345,0
5_6305247,succumb_abrasion_entertainment_beef_vulcan_uranus,6305247,5,614,957,1571,0
5_2787547,succumb_jealousy_stimulation_lamb_vulcan_uranus,2787547,5,390,680,1070,0
5_717181,succumb_jealousy_stimulation_beef_vulcan_uranus,717181,5,399,690,1089,0
5_3647706,succumb_jealousy_stimulation_haroset_vulcan_uranus,3647706,5,398,689,1087,0
5_850069,succumb_depression_learning_okra_vulcan_uranus,850069,5,142,194,336,0
5_5252072,succumb_depression_learning_onion_vulcan_uranus,5252072,5,142,193,335,0
5_6490525,succumb_depression_learning_snickers_vulcan_uranus,6490525,5,125,170,295,0
5_1052017,succumb_abrasion_lubricity_lemon_vulcan_uranus,1052017,5,381,649,1030,0
5_1917367,succumb_abrasion_lubricity_beef_vulcan_uranus,1917367,5,380,663,1043,0
5_499397,succumb_dread_aesthetics_wonderbread_vulcan_uranus,499397,5,265,393,658,0
5_4519547,succumb_hangover_entertainment_wonderbread_vulcan_uranus,4519547,5,496,677,1173,0
5_7193795,succumb_laceration_lubricity_beef_vulcan_uranus,7193795,5,405,692,1097,0
5_5981887,succumb_depression_entertainment_wonderbread_vulcan_uranus,5981887,5,512,689,1201,0
5_1313207,succumb_hangover_expectation_okra_vulcan_uranus,1313207,5,123,170,293,0
5_1210430,succumb_hangover_expectation_snickers_vulcan_uranus,1210430,5,126,173,299,0
5_3800745,succumb_hangover_expectation_onion_vulcan_uranus,3800745,5,194,239,433,0
5_5093302,succumb_jealousy_entertainment_lamb_vulcan_uranus,5093302,5,567,906,1473,0
5_3022936,succumb_jealousy_entertainment_beef_vulcan_uranus,3022936,5,587,906,1493,0
5_5601130,succumb_jealousy_entertainment_haroset_vulcan_uranus,5601130,5,388,653,1041,0
5_3373212,succumb_jealousy_entertainment_flounder_vulcan_uranus,3373212,5,567,913,1480,0
5_3934553,succumb_anger_entertainment_haroset_vulcan_uranus,3934553,5,560,868,1428,0
5_781281,succumb_anger_entertainment_flounder_vulcan_uranus,781281,5,560,868,1428,0
5_6531735,overcome_angina_entertainment_lemon_vulcan_uranus,6531735,5,789,920,1709,0
5_4713773,overcome_angina_entertainment_flounder_vulcan_uranus,4713773,5,772,869,1641,0
5_1697991,overcome_depression_expectation_snickers_vulcan_uranus,1697991,5,151,182,333,0
5_3190658,overcome_depression_expectation_onion_vulcan_uranus,3190658,5,203,239,442,0
5_6495159,overcome_depression_entertainment_wonderbread_vulcan_uranus,6495159,5,451,618,1069,0
5_1739685,overcome_depression_aesthetics_wonderbread_vulcan_uranus,1739685,5,300,451,751,0
5_2505325,overcome_hangover_expectation_snickers_vulcan_uranus,2505325,5,128,173,301,0
5_7161479,overcome_hangover_entertainment_wonderbread_vulcan_uranus,7161479,5,443,606,1049,0
5_719808,overcome_hangover_aesthetics_wonderbread_vulcan_uranus,719808,5,292,439,731,0
5_7249870,overcome_jealousy_entertainment_flounder_vulcan_uranus,7249870,5,569,906,1475,0
5_1053216,overcome_jealousy_entertainment_haroset_vulcan_uranus,1053216,5,390,646,1036,0
5_2343108,overcome_jealousy_entertainment_lamb_vulcan_uranus,2343108,5,562,906,1468,0
5_4680216,overcome_jealousy_aesthetics_lobster_vulcan_uranus,4680216,5,438,653,1091,0
5_5343764,overcome_jealousy_aesthetics_bacon_vulcan_uranus,5343764,5,646,960,1606,0
5_916447,overcome_jealousy_aesthetics_haroset_vulcan_uranus,916447,5,469,744,1213,0
5_4296003,overcome_jealousy_lubricity_flounder_vulcan_uranus,4296003,5,707,683,1390,0
5_5501978,overcome_jealousy_lubricity_lamb_vulcan_uranus,5501978,5,456,682,1138,0
5_3431612,overcome_jealousy_lubricity_beef_vulcan_uranus,3431612,5,731,733,1464,0
5_4821686,overcome_laceration_entertainment_haroset_vulcan_uranus,4821686,5,394,654,1048,0
5_104711,overcome_laceration_entertainment_lamb_vulcan_uranus,104711,5,587,940,1527,0
5_6035322,overcome_laceration_entertainment_beef_vulcan_uranus,6035322,5,614,944,1558,0
5_7120510,overcome_laceration_entertainment_lemon_vulcan_uranus,7120510,5,790,991,1781,0
5_6679027,overcome_laceration_aesthetics_haroset_vulcan_uranus,6679027,5,475,755,1230,0
5_2441819,overcome_laceration_aesthetics_lobster_vulcan_uranus,2441819,5,837,1302,2139,0
5_85508,overcome_laceration_lubricity_lamb_vulcan_uranus,85508,5,406,682,1088,0
5_6016119,overcome_laceration_lubricity_beef_vulcan_uranus,6016119,5,449,685,1134,0
5_2204542,overcome_laceration_lubricity_lemon_vulcan_uranus,2204542,5,637,712,1349,0
5_2057606,overcome_laceration_lubricity_flounder_vulcan_uranus,2057606,5,903,1031,1934,0
5_1238012,overcome_grief_entertainment_wonderbread_vulcan_uranus,1238012,5,431,609,1040,0
5_3534241,overcome_grief_aesthetics_lobster_vulcan_uranus,3534241,5,296,488,784,0
5_2360333,noop_food_lamb,2360333,5,1,1,2,0
5_157361,succumb_abrasion_lubricity_lamb_uranus_saturn,157361,5,379,653,1032,0
5_5433789,succumb_laceration_lubricity_lamb_uranus_saturn,5433789,5,404,682,1086,0
5_2342116,succumb_jealousy_lubricity_lamb_uranus_saturn,2342116,5,415,682,1097,0
5_3838791,feast_stimulation_lamb_beef_manitoba_pennsylvania,3838791,5,351,584,935,0
5_1955017,feast_stimulation_lamb_beef_bavaria_manitoba,1955017,5,596,584,1180,0
5_5170983,feast_stimulation_lamb_beef_goias_bosnia,5170983,5,439,696,1135,0
5_529568,feast_stimulation_lamb_haroset_manitoba_pennsylvania,529568,5,351,584,935,0
5_7971729,feast_stimulation_lamb_haroset_bavaria_manitoba,7971729,5,596,584,1180,0
5_6902405,feast_stimulation_lamb_haroset_goias_bosnia,6902405,5,439,696,1135,0
5_4691551,feast_stimulation_beef_lamb_manitoba_pennsylvania,4691551,5,357,588,945,0
5_6739043,feast_entertainment_lamb_beef_manitoba_pennsylvania,6739043,5,541,838,1379,0
5_4147678,feast_entertainment_lamb_beef_goias_bosnia,4147678,5,741,1222,1963,0
5_5137098,feast_entertainment_lamb_haroset_manitoba_pennsylvania,5137098,5,541,838,1379,0
5_6294953,feast_entertainment_lamb_haroset_goias_bosnia,6294953,5,741,1222,1963,0
5_2162827,feast_aesthetics_lamb_beef_manitoba_pennsylvania,2162827,5,645,908,1553,0
5_5543773,feast_aesthetics_lamb_beef_goias_bosnia,5543773,5,834,1292,2126,0
5_7986915,feast_aesthetics_lamb_haroset_manitoba_pennsylvania,7986915,5,645,908,1553,0
5_5532191,feast_aesthetics_lamb_haroset_goias_bosnia,5532191,5,834,1292,2126,0
5_7169104,feast_lubricity_lamb_beef_manitoba_pennsylvania,7169104,5,347,561,908,0
5_4615413,feast_lubricity_lamb_beef_bavaria_manitoba,4615413,5,643,561,1204,0
5_5680061,feast_lubricity_lamb_beef_goias_bosnia,5680061,5,671,1112,1783,0
5_6375513,feast_lubricity_lamb_haroset_manitoba_pennsylvania,6375513,5,347,561,908,0
5_4042467,feast_lubricity_lamb_haroset_bavaria_manitoba,4042467,5,643,561,1204,0
5_3537385,feast_lubricity_lamb_haroset_goias_bosnia,3537385,5,671,1112,1783,0
5_7591803,feast_entertainment_beef_lamb_manitoba_pennsylvania,7591803,5,568,839,1407,0
5_3015587,feast_aesthetics_beef_lamb_manitoba_pennsylvania,3015587,5,657,1002,1659,0
5_20887,feast_lubricity_beef_lamb_manitoba_pennsylvania,20887,5,353,551,904,0
5_5780476,overcome_jealousy_stimulation_lamb_uranus_saturn,5780476,5,392,680,1072,0
5_7119920,overcome_jealousy_aesthetics_lamb_uranus_saturn,7119920,5,664,973,1637,0
5_1671606,overcome_jealousy_lubricity_lamb_uranus_saturn,1671606,5,446,673,1119,0
5_3348138,overcome_laceration_stimulation_lamb_uranus_saturn,3348138,5,360,633,993,0
5_4672621,overcome_laceration_aesthetics_lamb_uranus_saturn,4672621,5,689,1011,1700,0
5_4256113,overcome_laceration_lubricity_lamb_uranus_saturn,4256113,5,396,673,1069,0
5_1477183,noop_food_tofu,1477183,5,1,1,2,0
5_942287,noop_locale_ham_oregon,942287,5,36,47,83,0
5_2114526,locale_ham_bosnia,2114526,5,17,14,31,0
5_157616,locale_ham_goias,157616,5,23,13,36,0
5_5662014,noop_craves_love_lemon,5662014,5,424,671,1095,0
5_2619566,noop_craves_grief_lobster,2619566,5,92,166,258,0
5_6283964,overcome_grief_stimulation_lobster_uranus_saturn,6283964,5,730,1211,1941,0
5_7704846,overcome_grief_aesthetics_lobster_uranus_saturn,7704846,5,296,480,776,0
5_6630843,noop_eats_lobster_haroset,6630843,5,1,1,2,0
5_1979204,feast_aesthetics_lobster_haroset_bavaria_manitoba,1979204,5,386,606,992,0
5_6974207,feast_stimulation_lobster_haroset_bavaria_manitoba,6974207,5,744,1225,1969,0
5_3429796,feast_lubricity_lobster_haroset_bavaria_manitoba,3429796,5,766,1234,2000,0
5_746090,noop_food_flounder,746090,5,1,1,2,0
5_4236000,succumb_anger_lubricity_flounder_uranus_saturn,4236000,5,374,590,964,0
5_3215825,succumb_jealousy_lubricity_flounder_uranus_saturn,3215825,5,415,683,1098,0
5_5136109,feast_stimulation_flounder_haroset_bavaria_manitoba,5136109,5,360,567,927,0
5_1995966,feast_stimulation_flounder_haroset_manitoba_pennsylvania,1995966,5,351,567,918,0
5_1877294,feast_lubricity_flounder_haroset_bavaria_manitoba,1877294,5,325,543,868,0
5_1727003,feast_lubricity_flounder_haroset_manitoba_pennsylvania,1727003,5,322,543,865,0
5_6571661,feast_aesthetics_flounder_haroset_bavaria_manitoba,6571661,5,640,898,1538,0
5_2426101,feast_aesthetics_flounder_haroset_manitoba_pennsylvania,2426101,5,640,898,1538,0
5_7292320,feast_stimulation_haroset_flounder_bavaria_manitoba,7292320,5,671,1117,1788,0
5_4033505,feast_lubricity_haroset_flounder_bavaria_manitoba,4033505,5,687,1107,1794,0
5_726895,feast_aesthetics_haroset_flounder_bavaria_manitoba,726895,5,595,881,1476,0
5_6997780,feast_entertainment_haroset_flounder_bavaria_manitoba,6997780,5,521,798,1319,0
5_4841569,feast_entertainment_flounder_haroset_bavaria_manitoba,4841569,5,529,828,1357,0
5_7535671,feast_entertainment_flounder_haroset_manitoba_pennsylvania,7535671,5,529,828,1357,0
5_441431,overcome_angina_stimulation_flounder_uranus_saturn,441431,5,621,627,1248,0
5_2862479,overcome_angina_aesthetics_flounder_uranus_saturn,2862479,5,868,942,1810,0
5_4822742,overcome_jealousy_stimulation_flounder_uranus_saturn,4822742,5,679,682,1361,0
5_465631,overcome_jealousy_lubricity_flounder_uranus_saturn,465631,5,703,674,1377,0
5_6228211,overcome_laceration_lubricity_flounder_uranus_saturn,6228211,5,902,1023,1925,0
5_3399490,noop_fears_grief_entertainment,3399490,5,174,279,453,0
5_3477531,harmony_entertainment_uranus,3477531,5,80,77,157,0
5_6192240,noop_craves_laceration_haroset,6192240,5,117,203,320,0
5_2894358,overcome_laceration_stimulation_haroset_uranus_saturn,2894358,5,368,642,1010,0
5_2848655,overcome_laceration_aesthetics_haroset_uranus_saturn,2848655,5,475,747,1222,0
5_3453325,overcome_laceration_lubricity_haroset_uranus_saturn,3453325,5,418,663,1081,0
5_2762830,noop_fears_sciatica_expectation,2762830,5,297,427,724,0
5_1891404,harmony_expectation_saturn,1891404,5,36,29,65,0
5_2226900,noop_fears_depression_expectation,2226900,5,74,92,166,0
5_3949850,succumb_depression_expectation_okra_uranus_saturn,3949850,5,146,179,325,0
5_1991938,succumb_depression_expectation_snickers_uranus_saturn,1991938,5,149,182,331,0
5_7324951,succumb_depression_expectation_onion_uranus_saturn,7324951,5,196,239,435,0
5_1176899,noop_craves_stimulation_lamb,1176899,5,280,499,779,0
5_564420,noop_planet_earth,564420,5,1,1,2,0
5_928830,noop_harmony_stimulation_saturn,928830,5,231,447,678,0
5_2343143,overcome_angina_stimulation_lemon_uranus_saturn,2343143,5,614,636,1250,0
5_3116817,overcome_depression_stimulation_wonderbread_uranus_saturn,3116817,5,402,642,1044,0
5_6060546,overcome_hangover_stimulation_wonderbread_uranus_saturn,6060546,5,395,632,1027,0
5_3617415,overcome_jealousy_stimulation_lobster_uranus_saturn,3617415,5,714,1189,1903,0
5_7854623,overcome_jealousy_stimulation_haroset_uranus_saturn,7854623,5,399,675,1074,0
5_3710110,overcome_jealousy_stimulation_beef_uranus_saturn,3710110,5,702,690,1392,0
5_1277772,overcome_laceration_stimulation_beef_uranus_saturn,1277772,5,367,643,1010,0
5_2985251,overcome_grief_stimulation_wonderbread_uranus_saturn,2985251,5,685,961,1646,0
5_5038031,noop_locale_flounder_manitoba,5038031,5,43,34,77,0
5_3597041,locale_flounder_pennsylvania,3597041,5,23,13,36,0
5_293749,noop_craves_stimulation_tofu,293749,5,334,550,884,0
5_4280077,noop_fears_dread_expectation,4280077,5,91,106,197,0
5_7299431,noop_locale_wonderbread_bavaria,7299431,5,1,1,2,0
5_6664251,noop_harmony_entertainment_vulcan,6664251,5,113,135,248,0
5_6849090,noop_craves_stimulation_wonderbread,6849090,5,294,479,773,0
5_1768600,noop_craves_love_beef,1768600,5,422,687,1109,0
5_5865527,noop_locale_ham_goias,5865527,5,36,47,83,0
5_3895862,locale_ham_oregon,3895862,5,23,11,34,0
5_184342,noop_craves_stimulation_flounder,184342,5,297,496,793,0
5_7835729,noop_craves_aesthetics_bacon,7835729,5,161,305,466,0
5_7476923,feast_aesthetics_bacon_lobster_bavaria_manitoba,7476923,5,234,366,600,0
5_394853,feast_aesthetics_bacon_wonderbread_bavaria_manitoba,394853,5,234,366,600,0
5_1513392,overcome_jealousy_aesthetics_bacon_uranus_saturn,1513392,5,646,960,1606,0
5_4775970,noop_locale_flounder_oregon,4775970,5,79,72,151,0
5_5825714,locale_flounder_manitoba,5825714,5,25,11,36,0
5_4719929,noop_craves_jealousy_ham,4719929,5,493,247,740,0
5_918343,noop_craves_prostatitis_marzipan,918343,5,28,108,136,0
5_7307348,noop_pleasure_expectation,7307348,5,1,1,2,0
5_5483812,succumb_hangover_expectation_okra_uranus_saturn,5483812,5,123,170,293,0
5_5381035,succumb_hangover_expectation_snickers_uranus_saturn,5381035,5,126,173,299,0
5_7971350,succumb_hangover_expectation_onion_uranus_saturn,7971350,5,194,239,433,0
5_1923741,feast_expectation_okra_snickers_bavaria_manitoba,1923741,5,94,112,206,0
5_2186495,feast_expectation_okra_wonderbread_bavaria_manitoba,2186495,5,94,112,206,0
5_7618197,feast_expectation_snickers_wonderbread_bavaria_manitoba,7618197,5,163,200,363,0
5_7665601,feast_expectation_snickers_okra_bavaria_manitoba,7665601,5,163,200,363,0
5_7547979,noop_food_wonderbread,7547979,5,1,1,2,0
5_4670002,succumb_dread_aesthetics_wonderbread_uranus_saturn,4670002,5,253,393,646,0
5_4506403,feast_learning_okra_wonderbread_bavaria_manitoba,4506403,5,163,200,363,0
5_938483,feast_stimulation_bacon_wonderbread_bavaria_manitoba,938483,5,837,1317,2154,0
5_5107816,feast_learning_snickers_wonderbread_bavaria_manitoba,5107816,5,110,136,246,0
5_5910290,overcome_depression_aesthetics_wonderbread_uranus_saturn,5910290,5,289,451,740,0
5_6213277,overcome_depression_lubricity_wonderbread_uranus_saturn,6213277,5,433,645,1078,0
5_4890413,overcome_hangover_aesthetics_wonderbread_uranus_saturn,4890413,5,281,439,720,0
5_4865379,overcome_hangover_lubricity_wonderbread_uranus_saturn,4865379,5,426,635,1061,0
5_1480031,overcome_grief_lubricity_wonderbread_uranus_saturn,1480031,5,718,975,1693,0
5_4769684,noop_harmony_achievement_uranus,4769684,5,21,37,58,0
5_3637704,noop_craves_lubricity_wonderbread,3637704,5,325,484,809,0
5_1317946,noop_craves_lubricity_flounder,1317946,5,267,471,738,0
5_4964407,noop_food_cantelope,4964407,5,1,1,2,0
5_7807157,succumb_prostatitis_lubricity_cantelope_uranus_saturn,7807157,5,357,618,975,0
5_3927488,succumb_abrasion_lubricity_cantelope_uranus_saturn,3927488,5,380,658,1038,0
5_5457751,feast_lubricity_lemon_cantelope_bavaria_manitoba,5457751,5,327,537,864,0
5_7375813,feast_entertainment_lemon_cantelope_bavaria_manitoba,7375813,5,776,1255,2031,0
5_1001185,feast_stimulation_lemon_cantelope_bavaria_manitoba,1001185,5,589,1008,1597,0
5_2868790,noop_food_beef,2868790,5,1,1,2,0
5_3989478,succumb_prostatitis_lubricity_beef_uranus_saturn,3989478,5,357,616,973,0
5_6087972,succumb_abrasion_lubricity_beef_uranus_saturn,6087972,5,379,656,1035,0
5_3363423,succumb_laceration_lubricity_beef_uranus_saturn,3363423,5,405,685,1090,0
5_2330190,feast_lubricity_lemon_beef_bavaria_manitoba,2330190,5,327,537,864,0
5_4239139,feast_entertainment_lemon_beef_bavaria_manitoba,4239139,5,776,1255,2031,0
5_1351859,feast_stimulation_lemon_beef_bavaria_manitoba,1351859,5,589,1008,1597,0
5_7602217,overcome_jealousy_lubricity_beef_uranus_saturn,7602217,5,726,717,1443,0
5_2185747,overcome_laceration_lubricity_beef_uranus_saturn,2185747,5,439,669,1108,0
5_5174505,noop_craves_stimulation_cantelope,5174505,5,321,523,844,0
5_2839036,noop_fears_depression_lubricity,2839036,5,467,606,1073,0
5_2098945,noop_eats_flounder_haroset,2098945,5,1,1,2,0
5_5518037,noop_harmony_aesthetics_earth,5518037,5,117,239,356,0
5_6628497,noop_pain_abrasion,6628497,5,1,1,2,0
5_5222622,succumb_abrasion_lubricity_lemon_uranus_saturn,5222622,5,381,641,1022,0
5_1064095,noop_fears_prostatitis_lubricity,1064095,5,293,349,642,0
5_3048718,craves_prostatitis_marzipan,3048718,5,16,17,33,0
5_2129555,noop_craves_jealousy_lobster,2129555,5,284,431,715,0
5_849844,overcome_jealousy_aesthetics_lobster_uranus_saturn,849844,5,438,645,1083,0
5_5353770,noop_craves_depression_wonderbread,5353770,5,87,105,192,0
5_7835032,noop_locale_beef_bavaria,7835032,5,49,49,98,0
5_6052961,locale_beef_manitoba,6052961,5,33,16,49,0
5_2475306,noop_craves_expectation_okra,2475306,5,74,93,167,0
5_4150653,craves_expectation_wonderbread,4150653,5,8,21,29,0
5_7692183,noop_locale_lobster_manitoba,7692183,5,291,498,789,0
5_2198537,feast_aesthetics_lobster_bacon_bavaria_manitoba,2198537,5,386,606,992,0
5_2330099,feast_stimulation_lobster_bacon_bavaria_manitoba,2330099,5,744,1225,1969,0
5_4562129,feast_lubricity_lobster_bacon_bavaria_manitoba,4562129,5,766,1234,2000,0
5_5244493,locale_lobster_bavaria,5244493,5,11,1,12,0
5_6261001,noop_craves_laceration_lamb,6261001,5,101,203,304,0
5_1685356,noop_craves_stimulation_beef,1685356,5,285,512,797,0
5_6579438,noop_harmony_lubricity_uranus,6579438,5,255,441,696,0
5_1814505,noop_fears_abrasion_love,1814505,5,473,785,1258,0
5_2098705,noop_fears_sciatica_love,2098705,5,527,662,1189,0
5_4507949,noop_craves_laceration_lobster,4507949,5,698,1145,1843,0
5_6612424,overcome_laceration_aesthetics_lobster_uranus_saturn,6612424,5,837,1295,2132,0
5_6256237,noop_eats_okra_snickers,6256237,5,1,1,2,0
5_3471673,feast_learning_okra_snickers_bavaria_manitoba,3471673,5,163,200,363,0
5_6296349,noop_planet_uranus,6296349,5,1,1,2,0
5_7246414,overcome_angina_lubricity_lemon_uranus_saturn,7246414,5,345,565,910,0
5_5087052,overcome_jealousy_aesthetics_haroset_uranus_saturn,5087052,5,469,736,1205,0
5_2055647,overcome_jealousy_lubricity_haroset_uranus_saturn,2055647,5,413,663,1076,0
5_6375147,overcome_laceration_lubricity_lemon_uranus_saturn,6375147,5,618,712,1330,0
5_6837474,noop_province_pennsylvania,6837474,5,1,1,2,0
5_6650699,noop_food_snickers,6650699,5,1,1,2,0
5_1212556,feast_learning_snickers_okra_bavaria_manitoba,1212556,5,110,136,246,0
5_5497475,noop_locale_haroset_bavaria,5497475,5,17,17,34,0
5_1737150,noop_fears_boils_entertainment,1737150,5,702,888,1590,0
5_1977598,noop_fears_laceration_aesthetics,1977598,5,464,541,1005,0
5_1553760,succumb_laceration_aesthetics_haroset_uranus_saturn,1553760,5,502,755,1257,0
5_6267138,noop_eats_beef_marzipan,6267138,5,1,1,2,0
5_1640807,noop_province_bavaria,1640807,5,1,1,2,0
5_3663839,noop_pain_angina,3663839,5,1,1,2,0
5_461749,noop_pain_depression,461749,5,1,1,2,0
5_3039885,noop_craves_angina_lemon,3039885,5,328,107,435,0
5_7334526,noop_craves_boils_lamb,7334526,5,339,530,869,0
5_4050227,noop_attacks_oregon_goias,4050227,5,1,1,2,0
5_5410840,noop_craves_depression_snickers,5410840,5,74,92,166,0
5_7242962,noop_eats_lamb_beef,7242962,5,1,1,2,0
5_953650,noop_eats_onion_tofu,953650,5,1,1,2,0
5_2550999,noop_craves_hangover_wonderbread,2550999,5,79,93,172,0
5_2488959,noop_craves_sciatica_lobster,2488959,5,172,227,399,0
5_1264991,noop_harmony_achievement_vulcan,1264991,5,55,37,92,0
5_4059168,harmony_achievement_uranus,4059168,5,20,15,35,0
5_3837028,noop_craves_love_ham,3837028,5,408,688,1096,0
5_4476391,noop_fears_abrasion_stimulation,4476391,5,185,224,409,0
5_4872690,noop_eats_marzipan_tofu,4872690,5,1,1,2,0
5_7594879,noop_pain_hangover,7594879,5,1,1,2,0
5_4329252,noop_fears_sciatica_aesthetics,4329252,5,104,150,254,0
5_7550155,noop_craves_learning_okra,7550155,5,93,120,213,0
5_2138506,craves_learning_wonderbread,2138506,5,11,35,46,0
5_484773,noop_fears_laceration_entertainment,484773,5,370,541,911,0
5_4001252,noop_fears_dread_entertainment,4001252,5,429,626,1055,0
5_6393688,noop_fears_hangover_learning,6393688,5,88,93,181,0
5_7161928,noop_locale_ham_bosnia,7161928,5,61,47,108,0
5_3024551,noop_eats_lamb_haroset,3024551,5,1,1,2,0
5_7076654,noop_pain_anger,7076654,5,1,1,2,0
5_3091627,noop_food_bacon,3091627,5,1,1,2,0
5_7608485,feast_stimulation_bacon_lobster_bavaria_manitoba,7608485,5,837,1317,2154,0
5_2540679,noop_locale_bacon_bavaria,2540679,5,10,12,22,0
5_1634561,noop_fears_grief_stimulation,1634561,5,481,603,1084,0
5_723993,noop_craves_jealousy_flounder,723993,5,454,199,653,0
5_6604388,noop_locale_tofu_bavaria,6604388,5,59,47,106,0
5_3046200,locale_tofu_manitoba,3046200,5,9,6,15,0
5_54362,noop_fears_sciatica_learning,54362,5,313,451,764,0
5_1539443,noop_fears_angina_entertainment,1539443,5,567,857,1424,0
5_7558443,noop_fears_loneliness_lubricity,7558443,5,364,534,898,0
5_3344601,craves_loneliness_tofu,3344601,5,9,7,16,0
5_3013915,noop_locale_lamb_oregon,3013915,5,51,56,107,0
5_4451660,locale_lamb_goias,4451660,5,24,12,36,0
5_1490852,noop_eats_okra_wonderbread,1490852,5,1,1,2,0
5_3694793,noop_harmony_achievement_saturn,3694793,5,25,38,63,0
5_1568911,noop_harmony_love_vulcan,1568911,5,121,180,301,0
5_6343879,noop_craves_learning_onion,6343879,5,90,110,200,0
5_3758745,noop_craves_grief_wonderbread,3758745,5,419,496,915,0
5_1202794,noop_fears_sciatica_achievement,1202794,5,252,357,609,0
5_6828741,noop_fears_abrasion_entertainment,6828741,5,598,916,1514,0
5_666864,noop_fears_depression_achievement,666864,5,130,105,235,0
5_3074745,noop_harmony_lubricity_vulcan,3074745,5,290,464,754,0
5_2726012,noop_fears_grief_love,2726012,5,399,548,947,0
5_5659255,noop_eats_snickers_wonderbread,5659255,5,1,1,2,0
5_331103,noop_craves_sciatica_bacon,331103,5,80,125,205,0
5_5602305,noop_craves_aesthetics_lobster,5602305,5,205,329,534,0
5_6769458,noop_craves_laceration_beef,6769458,5,146,203,349,0
5_211454,noop_craves_jealousy_bacon,211454,5,568,883,1451,0
5_3523745,noop_fears_sciatica_stimulation,3523745,5,454,582,1036,0
5_2987815,noop_fears_depression_stimulation,2987815,5,469,590,1059,0
5_2434796,noop_fears_hangover_lubricity,2434796,5,453,603,1056,0
5_6074345,noop_fears_jealousy_stimulation,6074345,5,222,296,518,0
5_1981432,noop_eats_tofu_onion,1981432,5,1,1,2,0
5_2791656,noop_planet_vulcan,2791656,5,1,1,2,0
5_2174354,noop_pleasure_learning,2174354,5,1,1,2,0
5_5895206,noop_fears_depression_learning,5895206,5,74,92,166,0
5_172118,noop_harmony_expectation_vulcan,172118,5,75,96,171,0
5_1203432,noop_craves_love_marzipan,1203432,5,441,691,1132,0
5_3000496,noop_craves_laceration_marzipan,3000496,5,359,272,631,0
5_5725342,noop_craves_laceration_lemon,5725342,5,368,245,613,0
5_1057855,noop_craves_hangover_onion,1057855,5,189,250,439,0
5_3536665,noop_locale_ham_pennsylvania,3536665,5,689,47,736,0
5_5040992,noop_fears_dread_stimulation,5040992,5,397,554,951,0
5_5844016,noop_fears_sciatica_entertainment,5844016,5,303,433,736,0
5_1002897,noop_fears_abrasion_lubricity,1002897,5,216,248,464,0
5_7866860,noop_fears_dread_aesthetics,7866860,5,215,350,565,0
5_5254932,noop_locale_lemon_manitoba,5254932,5,308,506,814,0
5_6447545,locale_lemon_bavaria,6447545,5,13,1,14,0
5_4085983,noop_eats_wonderbread_bacon,4085983,5,1,1,2,0
5_2029468,noop_eats_lobster_bacon,2029468,5,1,1,2,0
5_6630041,noop_fears_jealousy_love,6630041,5,209,335,544,0
5_5504547,noop_harmony_lubricity_saturn,5504547,5,215,411,626,0
5_1451630,noop_craves_aesthetics_wonderbread,1451630,5,178,303,481,0
5_1639546,noop_craves_aesthetics_flounder,1639546,5,609,846,1455,0
5_7879475,noop_craves_abrasion_marzipan,7879475,5,96,195,291,0
5_3226658,noop_craves_entertainment_lamb,3226658,5,507,800,1307,0
5_5520783,noop_eats_ham_flounder,5520783,5,1,1,2,0
5_2167967,noop_harmony_entertainment_uranus,2167967,5,81,129,210,0
5_6057461,noop_craves_lubricity_lemon,6057461,5,262,473,735,0
5_5221458,noop_planet_saturn,5221458,5,1,1,2,0
5_3418815,noop_pain_prostatitis,3418815,5,1,1,2,0
5_7276459,noop_food_lemon,7276459,5,1,1,2,0
5_325406,noop_craves_expectation_snickers,325406,5,77,96,173,0
5_2266958,noop_harmony_aesthetics_uranus,2266958,5,164,293,457,0
5_7842983,noop_craves_boils_beef,7842983,5,274,179,453,0
5_7630048,noop_fears_hangover_achievement,7630048,5,114,93,207,0
5_2927018,noop_fears_hangover_entertainment,2927018,5,489,673,1162,0
5_6264297,noop_eats_marzipan_beef,6264297,5,1,1,2,0
5_2749009,noop_pain_jealousy,2749009,5,1,1,2,0
5_5373533,noop_pain_dread,5373533,5,1,1,2,0
5_5747312,noop_pleasure_achievement,5747312,5,1,1,2,0
5_4169649,noop_craves_stimulation_bacon,4169649,5,758,1214,1972,0
5_2616621,noop_province_goias,2616621,5,1,1,2,0
5_67286,noop_pleasure_stimulation,67286,5,1,1,2,0
5_405072,noop_craves_stimulation_haroset,405072,5,282,488,770,0
5_4191586,noop_craves_aesthetics_lamb,4191586,5,607,852,1459,0
5_2087401,noop_craves_learning_snickers,2087401,5,68,84,152,0
5_1408559,noop_eats_flounder_ham,1408559,5,1,1,2,0
5_8709,noop_locale_bacon_manitoba,8709,5,212,341,553,0
5_5395676,locale_bacon_bavaria,5395676,5,9,1,10,0
5_6952736,noop_eats_haroset_flounder,6952736,5,1,1,2,0
5_434518,noop_craves_love_haroset,434518,5,173,241,414,0
5_3813846,noop_craves_jealousy_haroset,3813846,5,109,196,305,0
5_7783167,noop_food_haroset,7783167,5,1,1,2,0
5_3848059,noop_fears_anger_lubricity,3848059,5,324,353,677,0
5_962651,noop_craves_hangover_snickers,962651,5,71,89,160,0
5_4856647,noop_locale_haroset_manitoba,4856647,5,436,691,1127,0
5_7733722,locale_haroset_bavaria,7733722,5,16,1,17,0
5_1669810,noop_province_manitoba,1669810,5,1,1,2,0
5_2384120,noop_harmony_learning_vulcan,2384120,5,69,87,156,0
5_7212115,noop_craves_stimulation_ham,7212115,5,302,494,796,0
5_99639,noop_craves_lubricity_onion,99639,5,364,574,938,0
5_1042911,noop_craves_lubricity_lamb,1042911,5,279,471,750,0
5_1191871,noop_eats_cantelope_marzipan,1191871,5,1,1,2,0
5_5199351,noop_eats_bacon_lobster,5199351,5,1,1,2,0
5_5721688,noop_eats_wonderbread_okra,5721688,5,1,1,2,0
5_7735830,noop_locale_cantelope_bavaria,7735830,5,1,1,2,0
5_7007816,noop_pleasure_entertainment,7007816,5,1,1,2,0
5_1318637,noop_food_onion,1318637,5,1,1,2,0
5_5944252,noop_fears_laceration_lubricity,5944252,5,330,385,715,0
5_6298403,noop_locale_lamb_pennsylvania,6298403,5,51,56,107,0
5_159761,noop_craves_lubricity_tofu,159761,5,339,522,861,0
5_5028303,noop_craves_entertainment_lemon,5028303,5,537,848,1385,0
5_353504,noop_craves_stimulation_lemon,353504,5,292,504,796,0
5_5296267,noop_fears_dread_learning,5296267,5,107,130,237,0
5_1581872,noop_eats_marzipan_cantelope,1581872,5,1,1,2,0
5_534272,noop_harmony_lubricity_earth,534272,5,187,374,561,0
5_5342758,noop_food_okra,5342758,5,1,1,2,0
5_1750704,noop_craves_entertainment_ham,1750704,5,533,802,1335,0
5_6623699,noop_craves_depression_onion,6623699,5,119,150,269,0
5_2979041,noop_craves_angina_flounder,2979041,5,335,107,442,0
5_4173250,noop_craves_sciatica_haroset,4173250,5,394,576,970,0
5_6763242,noop_harmony_aesthetics_vulcan,6763242,5,182,314,496,0
5_7231076,noop_eats_beef_lamb,7231076,5,1,1,2,0
5_7722518,noop_craves_love_flounder,7722518,5,428,686,1114,0
5_3735115,noop_craves_entertainment_beef,3735115,5,532,803,1335,0
5_1518605,noop_craves_laceration_flounder,1518605,5,694,577,1271,0
5_5102592,noop_locale_lamb_manitoba,5102592,5,402,56,458,0
5_6500005,noop_harmony_stimulation_vulcan,6500005,5,281,484,765,0
5_6517750,noop_fears_anger_love,6517750,5,431,725,1156,0
5_3260377,noop_eats_tofu_marzipan,3260377,5,1,1,2,0
5_2484442,noop_pain_laceration,2484442,5,1,1,2,0
5_4700043,noop_craves_aesthetics_beef,4700043,5,626,961,1587,0
5_7819070,noop_fears_prostatitis_love,7819070,5,465,782,1247,0
5_1529215,noop_fears_dread_lubricity,1529215,5,395,570,965,0
5_2533093,noop_fears_anxiety_learning,2533093,5,98,130,228,0
5_3837243,craves_anxiety_onion,3837243,5,13,15,28,0
5_735143,noop_orbits_uranus_saturn,735143,5,1,1,2,0
5_1192067,noop_harmony_aesthetics_saturn,1192067,5,136,266,402,0
5_1284607,noop_craves_lubricity_haroset,1284607,5,298,449,747,0
5_3255443,noop_craves_jealousy_lamb,3255443,5,151,196,347,0
5_5248153,noop_locale_flounder_bavaria,5248153,5,676,39,715,0
5_7424566,noop_fears_depression_entertainment,7424566,5,505,685,1190,0
5_2287477,noop_locale_flounder_pennsylvania,2287477,5,34,34,68,0
5_6227808,noop_locale_beef_pennsylvania,6227808,5,49,49,98,0
5_1232579,noop_locale_lamb_bosnia,1232579,5,411,659,1070,0
5_2832879,noop_eats_lemon_ham,2832879,5,1,1,2,0
5_6935494,noop_pain_loneliness,6935494,5,1,1,2,0
5_1189107,noop_fears_hangover_expectation,1189107,5,68,89,157,0
5_7341957,noop_craves_lubricity_cantelope,7341957,5,308,498,806,0
5_2396659,noop_craves_stimulation_onion,2396659,5,366,588,954,0
5_6512303,noop_fears_dread_love,6512303,5,649,749,1398,0
5_277078,noop_fears_loneliness_stimulation,277078,5,366,546,912,0
5_7286596,noop_craves_aesthetics_haroset,7286596,5,352,555,907,0
5_3340809,noop_craves_expectation_onion,3340809,5,161,165,326,0
5_6721758,noop_craves_stimulation_lobster,6721758,5,650,1103,1753,0
5_6765322,noop_locale_okra_manitoba,6765322,5,77,96,173,0
5_765503,locale_okra_bavaria,765503,5,5,0,5,0
5_3761495,noop_eats_lemon_cantelope,3761495,5,1,1,2,0
5_6659042,noop_fears_prostatitis_stimulation,6659042,5,288,361,649,0
5_2060469,noop_fears_anxiety_expectation,2060469,5,187,237,424,0
5_982246,noop_craves_anxiety_onion,982246,5,14,24,38,0
5_5073604,noop_harmony_love_uranus,5073604,5,96,152,248,0
5_964644,noop_pain_grief,964644,5,1,1,2,0
5_6098876,noop_food_lobster,6098876,5,1,1,2,0
5_6751204,noop_craves_love_lobster,6751204,5,437,692,1129,0
5_1551368,noop_craves_lubricity_beef,1551368,5,285,475,760,0
5_3008246,noop_locale_lobster_bavaria,3008246,5,12,12,24,0
5_2622029,noop_craves_entertainment_haroset,2622029,5,287,479,766,0
5_4290269,noop_craves_boils_flounder,4290269,5,339,525,864,0
5_7205555,noop_fears_boils_love,7205555,5,484,775,1259,0
5_6816796,noop_fears_grief_lubricity,6816796,5,576,647,1223,0
5_3809309,noop_craves_entertainment_wonderbread,3809309,5,352,492,844,0
5_7656944,noop_craves_entertainment_flounder,7656944,5,500,797,1297,0
5_6938998,noop_eats_wonderbread_snickers,6938998,5,1,1,2,0
5_3235111,noop_attacks_bavaria_manitoba,3235111,5,1,1,2,0
5_3551919,noop_craves_angina_ham,3551919,5,44,83,127,0
5_737720,noop_eats_lemon_beef,737720,5,1,1,2,0
5_4745869,noop_fears_angina_love,4745869,5,465,729,1194,0
5_3295483,noop_eats_snickers_okra,3295483,5,1,1,2,0
5_3676811,noop_harmony_expectation_uranus,3676811,5,60,90,150,0
5_3592548,noop_locale_lemon_bavaria,3592548,5,14,17,31,0
5_1417649,noop_fears_anger_aesthetics,1417649,5,628,871,1499,0
5_5554132,noop_fears_jealousy_entertainment,5554132,5,298,449,747,0
5_556463,noop_locale_snickers_manitoba,556463,5,93,120,213,0
5_2639657,locale_snickers_bavaria,2639657,5,7,1,8,0
5_4634499,noop_locale_marzipan_oregon,4634499,5,112,244,356,0
5_7514601,locale_marzipan_manitoba,7514601,5,35,19,54,0
5_3763900,noop_craves_jealousy_beef,3763900,5,484,244,728,0
5_6317512,noop_locale_beef_oregon,6317512,5,244,457,701,0
5_7650497,noop_attacks_manitoba_pennsylvania,7650497,5,1,1,2,0
5_7543600,noop_province_bosnia,7543600,5,1,1,2,0
5_2312224,noop_fears_anger_entertainment,2312224,5,539,844,1383,0
5_4124722,noop_craves_sciatica_wonderbread,4124722,5,223,221,444,0
5_4741415,noop_fears_jealousy_lubricity,4741415,5,350,429,779,0
5_6512278,noop_attacks_goias_bosnia,6512278,5,1,1,2,0
5_2443351,noop_eats_bacon_wonderbread,2443351,5,1,1,2,0
5_3159359,noop_pleasure_aesthetics,3159359,5,1,1,2,0
5_2224484,noop_locale_marzipan_pennsylvania,2224484,5,67,80,147,0
5_4892132,noop_craves_boils_ham,4892132,5,304,182,486,0
5_7601293,noop_craves_lubricity_lobster,7601293,5,688,1136,1824,0
5_170733,noop_fears_hangover_love,170733,5,709,795,1504,0
5_2417187,noop_pleasure_lubricity,2417187,5,1,1,2,0
5_335752,noop_craves_lubricity_ham,335752,5,289,482,771,0
5_1205284,noop_fears_boils_stimulation,1205284,5,331,398,729,0
5_6239897,province_bosnia,6239897,5,1,0,1,0
4_3763900,noop_craves_jealousy_beef,3763900,4,0,484,484,0
3_6618897,craves_jealousy_beef,6618897,3,0,7,7,0
4_4173250,noop_craves_sciatica_haroset,4173250,4,0,394,394,0
3_582138,craves_sciatica_haroset,582138,3,0,7,7,0
5_7650924,eats_onion_tofu,7650924,5,1,0,1,0
4_1737150,noop_fears_boils_entertainment,1737150,4,0,702,702,0
3_3359573,fears_boils_entertainment,3359573,3,0,2,2,0
4_6474100,succumb_boils_lubricity_lemon_vulcan_uranus,6474100,4,6,333,339,0
3_3862428,harmony_lubricity_vulcan,3862428,3,0,8,8,0
4_2952150,succumb_laceration_stimulation_ham_saturn_earth,2952150,4,7,366,373,0
5_2833922,craves_laceration_ham,2833922,5,1,51,52,0
4_2399150,succumb_sciatica_stimulation_bacon_saturn_earth,2399150,4,6,815,821,0
3_2813229,fears_sciatica_stimulation,2813229,3,0,4,4,0
4_3457300,succumb_depression_learning_onion_saturn_earth,3457300,4,7,139,146,0
5_2299014,harmony_learning_earth,2299014,5,9,21,30,0
4_4236000,succumb_anger_lubricity_flounder_uranus_saturn,4236000,4,7,371,378,0
4_3934300,overcome_anger_stimulation_flounder_vulcan_uranus,3934300,4,9,367,376,0
4_5486650,overcome_grief_stimulation_bacon_saturn_earth,5486650,4,9,790,799,0
5_4679598,eats_bacon_wonderbread,4679598,5,1,5,6,0
5_1221736,eats_bacon_lobster,1221736,5,1,5,6,0
5_5978126,eats_lamb_haroset,5978126,5,1,25,26,0
4_3529601,succumb_boils_love_beef_vulcan_uranus,3529601,4,6,511,517,0
3_1497644,fears_boils_love,1497644,3,0,3,3,0
4_3351501,feast_aesthetics_ham_lemon_pennsylvania_oregon,3351501,4,6,647,653,0
3_2544554,craves_aesthetics_ham,2544554,3,0,8,8,0
5_428472,craves_aesthetics_lemon,428472,5,6,114,120,0
4_7392701,feast_aesthetics_ham_flounder_oregon_goias,7392701,4,7,647,654,0
4_2715751,feast_entertainment_ham_lemon_pennsylvania_oregon,2715751,4,7,558,565,0
4_7597451,overcome_boils_love_lamb_vulcan_uranus,7597451,4,8,701,709,0
3_2287124,craves_boils_lamb,2287124,3,0,8,8,0
4_7263151,overcome_boils_stimulation_flounder_vulcan_uranus,7263151,4,8,613,621,0
3_7080594,craves_boils_flounder,7080594,3,0,8,8,0
4_6646951,overcome_boils_aesthetics_lamb_saturn_earth,6646951,4,9,869,878,0
5_5962620,fears_boils_aesthetics,5962620,5,6,126,132,0
4_5138251,overcome_sciatica_entertainment_wonderbread_vulcan_uranus,5138251,4,9,408,417,0
4_5422951,overcome_abrasion_lubricity_lemon_vulcan_uranus,5422951,4,8,367,375,0
3_6559853,craves_abrasion_lemon,6559853,3,0,8,8,0
4_7035101,overcome_anger_aesthetics_haroset_saturn_earth,7035101,4,8,615,623,0
3_6590502,craves_anger_haroset,6590502,3,0,10,10,0
4_5118301,overcome_jealousy_stimulation_ham_uranus_saturn,5118301,4,8,707,715,0
3_2574568,craves_jealousy_ham,2574568,3,0,6,6,0
4_6825601,overcome_jealousy_lubricity_beef_saturn_earth,6825601,4,9,723,732,0
4_7213551,overcome_grief_expectation_wonderbread_uranus_saturn,7213551,4,8,488,496,0
3_4546428,craves_grief_wonderbread,4546428,3,0,12,12,0
5_5283511,fears_grief_expectation,5283511,5,2,80,82,0
4_2985251,overcome_grief_stimulation_wonderbread_uranus_saturn,2985251,4,9,680,689,0
5_4281177,eats_okra_wonderbread,4281177,5,1,2,3,0
4_7140002,noop_fears_depression_aesthetics,7140002,4,0,299,299,0
3_1269400,fears_depression_aesthetics,1269400,3,0,3,3,0
4_2666152,succumb_loneliness_stimulation_tofu_saturn_earth,2666152,4,6,372,378,0
3_1586642,fears_loneliness_stimulation,1586642,3,0,1,1,0
4_5714052,feast_love_ham_flounder_manitoba_pennsylvania,5714052,4,6,714,720,0
3_7946530,locale_ham_pennsylvania,7946530,3,0,2,2,0
5_5323336,locale_ham_manitoba,5323336,5,2,110,112,0
4_806102,feast_entertainment_lemon_ham_bavaria_manitoba,806102,4,6,773,779,0
3_4317787,craves_entertainment_lemon,4317787,3,0,7,7,0
4_1872702,overcome_boils_aesthetics_lamb_uranus_saturn,1872702,4,9,867,876,0
4_3201202,overcome_anger_lubricity_haroset_saturn_earth,3201202,4,9,699,708,0
4_1933352,overcome_laceration_lubricity_marzipan_vulcan_uranus,1933352,4,8,630,638,0
3_2289980,craves_laceration_marzipan,2289980,3,0,6,6,0
4_4527202,overcome_grief_achievement_wonderbread_vulcan_uranus,4527202,4,9,437,446,0
5_3723475,fears_grief_achievement,3723475,5,2,73,75,0
4_4925402,overcome_grief_entertainment_flounder_vulcan_uranus,4925402,4,8,559,567,0
3_941502,craves_grief_flounder,941502,3,0,7,7,0
4_6512303,noop_fears_dread_love,6512303,4,0,649,649,0
3_804392,fears_dread_love,804392,3,0,1,1,0
4_5248153,noop_locale_flounder_bavaria,5248153,4,0,676,676,0
3_1657041,locale_flounder_bavaria,1657041,3,0,0,0,0
4_5028303,noop_craves_entertainment_lemon,5028303,4,1,537,538,0
4_5619303,succumb_boils_lubricity_wonderbread_saturn_earth,5619303,4,7,369,376,0
5_4117151,craves_boils_wonderbread,4117151,5,1,46,47,0
4_1203153,succumb_angina_entertainment_ham_vulcan_uranus,1203153,4,6,577,583,0
3_828927,fears_angina_entertainment,828927,3,0,1,1,0
4_5976703,succumb_grief_love_wonderbread_vulcan_uranus,5976703,4,7,497,504,0
4_5922653,succumb_depression_stimulation_wonderbread_saturn_earth,5922653,4,6,477,483,0
3_4297379,fears_depression_stimulation,4297379,3,0,1,1,0
4_3581103,succumb_jealousy_stimulation_lobster_uranus_saturn,3581103,4,7,709,716,0
4_3934553,succumb_anger_entertainment_haroset_vulcan_uranus,3934553,4,7,557,564,0
4_2997853,feast_aesthetics_ham_lemon_oregon_goias,2997853,4,7,647,654,0
4_3339403,feast_aesthetics_flounder_ham_bavaria_manitoba,3339403,4,7,637,644,0
4_2703653,feast_entertainment_flounder_ham_bavaria_manitoba,2703653,4,7,526,533,0
4_6924903,overcome_boils_lubricity_ham_uranus_saturn,6924903,4,9,344,353,0
4_1009853,overcome_sciatica_stimulation_lobster_vulcan_uranus,1009853,4,9,758,767,0
4_4271803,overcome_angina_stimulation_flounder_vulcan_uranus,4271803,4,8,616,624,0
3_5215288,craves_angina_flounder,5215288,3,0,8,8,0
4_5221003,overcome_depression_learning_okra_vulcan_uranus,5221003,4,9,139,148,0
4_3537053,overcome_depression_stimulation_onion_saturn_earth,3537053,4,8,481,489,0
3_3184342,craves_stimulation_onion,3184342,3,0,3,3,0
4_4296003,overcome_jealousy_lubricity_flounder_vulcan_uranus,4296003,4,9,702,711,0
4_4850203,overcome_laceration_stimulation_lemon_saturn_earth,4850203,4,8,378,386,0
3_2134230,craves_laceration_lemon,2134230,3,0,6,6,0
4_269703,overcome_grief_lubricity_haroset_uranus_saturn,269703,4,9,526,535,0
4_7794353,overcome_grief_lubricity_lamb_vulcan_uranus,7794353,4,8,788,796,0
3_5808558,craves_grief_lamb,5808558,3,0,7,7,0
5_5127929,pleasure_learning,5127929,5,1,88,89,0
4_211454,noop_craves_jealousy_bacon,211454,4,0,568,568,0
3_3001779,craves_jealousy_bacon,3001779,3,0,4,4,0
5_1567476,pain_anger,1567476,5,1,80,81,0
4_6712104,noop_craves_love_cantelope,6712104,4,0,441,441,0
3_1501452,craves_love_cantelope,1501452,3,0,1,1,0
4_6152154,noop_craves_grief_flounder,6152154,4,1,546,547,0
5_7563751,eats_cantelope_lemon,7563751,5,1,0,1,0
4_7889354,succumb_abrasion_stimulation_cantelope_saturn_earth,7889354,4,7,382,389,0
5_5192457,craves_abrasion_cantelope,5192457,5,3,17,20,0
4_7861454,succumb_jealousy_stimulation_ham_saturn_earth,7861454,4,7,399,406,0
4_6463954,succumb_boils_love_ham_vulcan_uranus,6463954,4,7,510,517,0
4_311154,succumb_angina_love_flounder_vulcan_uranus,311154,4,7,483,490,0
4_5459904,feast_aesthetics_ham_lemon_goias_bosnia,5459904,4,7,663,670,0
4_6656804,overcome_boils_stimulation_lamb_uranus_saturn,6656804,4,9,601,610,0
4_5249454,overcome_boils_aesthetics_flounder_uranus_saturn,5249454,4,9,870,879,0
4_7205555,noop_fears_boils_love,7205555,4,1,484,485,0
4_6500005,noop_harmony_stimulation_vulcan,6500005,4,0,281,281,0
3_5789489,harmony_stimulation_vulcan,5789489,3,0,11,11,0
4_1518605,noop_craves_laceration_flounder,1518605,4,0,694,694,0
3_808089,craves_laceration_flounder,808089,3,0,4,4,0
4_1057855,noop_craves_hangover_onion,1057855,4,0,189,189,0
3_3848180,craves_hangover_onion,3848180,3,0,3,3,0
5_7281678,eats_snickers_wonderbread,7281678,5,1,2,3,0
5_4730552,eats_beef_lemon,4730552,5,1,0,1,0
4_3735505,noop_craves_anger_haroset,3735505,4,1,455,456,0
4_4104655,succumb_depression_aesthetics_wonderbread_vulcan_uranus,4104655,4,6,339,345,0
3_384688,harmony_aesthetics_vulcan,384688,3,0,9,9,0
4_1013755,succumb_hangover_aesthetics_wonderbread_uranus_saturn,1013755,4,6,311,317,0
3_1288709,fears_hangover_aesthetics,1288709,3,0,3,3,0
4_7283805,succumb_jealousy_stimulation_beef_saturn_earth,7283805,4,7,396,403,0
4_7921455,succumb_jealousy_stimulation_bacon_saturn_earth,7921455,4,7,783,790,0
4_5523505,feast_aesthetics_beef_lamb_bavaria_manitoba,5523505,4,6,654,660,0
3_6936290,craves_aesthetics_beef,6936290,3,0,12,12,0
4_4714755,overcome_anxiety_stimulation_onion_saturn_earth,4714755,4,9,384,393,0
5_4443807,fears_anxiety_stimulation,4443807,5,1,46,47,0
4_2434455,overcome_abrasion_entertainment_marzipan_vulcan_uranus,2434455,4,7,618,625,0
3_345208,craves_entertainment_marzipan,345208,3,0,16,16,0
3_666181,craves_abrasion_marzipan,666181,3,0,8,8,0
4_7869405,overcome_anger_lubricity_haroset_uranus_saturn,7869405,4,9,696,705,0
4_3877455,overcome_prostatitis_stimulation_marzipan_vulcan_uranus,3877455,4,9,350,359,0
4_573955,overcome_grief_stimulation_flounder_saturn_earth,573955,4,9,771,780,0
5_3976229,planet_vulcan,3976229,5,1,331,332,0
4_7755206,noop_craves_aesthetics_ham,7755206,4,1,627,628,0
4_5891006,succumb_jealousy_aesthetics_flounder_saturn_earth,5891006,4,7,660,667,0
4_2557256,succumb_boils_lubricity_haroset_saturn_earth,2557256,4,7,340,347,0
5_2557270,craves_boils_haroset,2557270,5,1,49,50,0
4_2315706,succumb_sciatica_stimulation_wonderbread_saturn_earth,2315706,4,7,485,492,0
4_3647706,succumb_jealousy_stimulation_haroset_vulcan_uranus,3647706,4,7,395,402,0
4_6674006,succumb_abrasion_lubricity_haroset_saturn_earth,6674006,4,7,376,383,0
5_2026364,craves_abrasion_haroset,2026364,5,4,21,25,0
4_2475506,feast_love_lamb_beef_bavaria_manitoba,2475506,4,6,507,513,0
3_7957589,locale_lamb_manitoba,7957589,3,0,6,6,0
5_71424,locale_lamb_bavaria,71424,5,6,49,55,0
4_6576356,overcome_boils_aesthetics_beef_saturn_earth,6576356,4,9,823,832,0
4_2143556,overcome_boils_lubricity_beef_uranus_saturn,2143556,4,9,343,352,0
4_2550606,overcome_abrasion_love_lamb_vulcan_uranus,2550606,4,8,507,515,0
3_1294904,craves_abrasion_lamb,1294904,3,0,10,10,0
4_123356,overcome_laceration_love_lemon_vulcan_uranus,123356,4,9,705,714,0
4_2057606,overcome_laceration_lubricity_flounder_vulcan_uranus,2057606,4,9,898,907,0
4_4064356,overcome_loneliness_lubricity_tofu_uranus_saturn,4064356,4,9,356,365,0
4_7593006,overcome_grief_lubricity_lobster_saturn_earth,7593006,4,8,743,751,0
3_387999,craves_lubricity_lobster,387999,3,0,5,5,0
5_3933873,province_bavaria,3933873,5,1,0,1,0
5_4177969,food_cantelope,4177969,5,1,66,67,0
4_3585207,succumb_boils_lubricity_lamb_uranus_saturn,3585207,4,7,342,349,0
4_7807157,succumb_prostatitis_lubricity_cantelope_uranus_saturn,7807157,4,7,354,361,0
5_7047677,craves_prostatitis_cantelope,7047677,5,3,17,20,0
4_6249407,succumb_sciatica_aesthetics_haroset_uranus_saturn,6249407,4,7,403,410,0
4_6103957,overcome_laceration_lubricity_marzipan_uranus_saturn,6103957,4,9,623,632,0
5_6133837,food_okra,6133837,5,1,30,31,0
5_6406031,planet_saturn,6406031,5,1,464,465,0
4_1137858,noop_craves_entertainment_marzipan,1137858,4,1,549,550,0
4_1733858,succumb_depression_aesthetics_wonderbread_saturn_earth,1733858,4,7,317,324,0
4_1437108,succumb_sciatica_expectation_wonderbread_uranus_saturn,1437108,4,6,311,317,0
3_2052314,fears_sciatica_expectation,2052314,3,0,2,2,0
4_5779958,succumb_depression_expectation_okra_saturn_earth,5779958,4,7,143,150,0
5_1739057,harmony_expectation_earth,1739057,5,9,22,31,0
4_4517208,succumb_abrasion_love_marzipan_vulcan_uranus,4517208,4,7,519,526,0
4_497708,succumb_sciatica_aesthetics_wonderbread_vulcan_uranus,497708,4,7,256,263,0
4_3190658,overcome_depression_expectation_onion_vulcan_uranus,3190658,4,9,198,207,0
4_2343108,overcome_jealousy_entertainment_lamb_vulcan_uranus,2343108,4,9,557,566,0
4_849158,overcome_jealousy_lubricity_lobster_saturn_earth,849158,4,9,736,745,0
4_2894358,overcome_laceration_stimulation_haroset_uranus_saturn,2894358,4,9,363,372,0
4_85508,overcome_laceration_lubricity_lamb_vulcan_uranus,85508,4,9,401,410,0
4_1937258,overcome_grief_learning_wonderbread_uranus_saturn,1937258,4,9,504,513,0
5_7765619,fears_grief_learning,7765619,5,2,83,85,0
4_4113858,overcome_grief_lubricity_wonderbread_saturn_earth,4113858,4,9,717,726,0
5_1013998,pleasure_aesthetics,1013998,5,1,286,287,0
4_2396659,noop_craves_stimulation_onion,2396659,4,1,366,367,0
5_4362134,eats_flounder_ham,4362134,5,1,15,16,0
5_3933582,pain_jealousy,3933582,5,1,181,182,0
5_1767281,food_lemon,1767281,5,1,153,154,0
5_20256,province_oregon,20256,5,1,0,1,0
4_4810109,succumb_anger_stimulation_ham_saturn_earth,4810109,4,7,705,712,0
4_2567359,succumb_depression_love_wonderbread_vulcan_uranus,2567359,4,6,729,735,0
3_7179962,fears_depression_love,7179962,3,0,1,1,0
4_2582709,succumb_laceration_aesthetics_haroset_saturn_earth,2582709,4,6,499,505,0
3_4107973,fears_laceration_aesthetics,4107973,3,0,3,3,0
4_5136109,feast_stimulation_flounder_haroset_bavaria_manitoba,5136109,4,7,357,364,0
4_706209,overcome_boils_stimulation_lemon_vulcan_uranus,706209,4,9,385,394,0
4_5530959,overcome_boils_lubricity_lamb_saturn_earth,5530959,4,9,357,366,0
4_1184359,overcome_anger_entertainment_haroset_vulcan_uranus,1184359,4,9,541,550,0
4_1870259,overcome_prostatitis_entertainment_marzipan_vulcan_uranus,1870259,4,9,580,589,0
5_2810155,fears_prostatitis_entertainment,2810155,5,1,96,97,0
4_2113359,overcome_grief_stimulation_lobster_vulcan_uranus,2113359,4,9,725,734,0
5_4623385,province_manitoba,4623385,5,1,0,1,0
4_5772160,noop_craves_boils_marzipan,5772160,4,0,338,338,0
3_561508,craves_boils_marzipan,561508,3,0,6,6,0
4_7430410,succumb_jealousy_aesthetics_lobster_vulcan_uranus,7430410,4,7,437,444,0
4_2756810,succumb_grief_entertainment_beef_vulcan_uranus,2756810,4,7,564,571,0
5_6317015,craves_grief_beef,6317015,5,1,98,99,0
4_1553760,succumb_laceration_aesthetics_haroset_uranus_saturn,1553760,4,7,499,506,0
4_1751860,succumb_abrasion_stimulation_wonderbread_saturn_earth,1751860,4,7,370,377,0
5_7207743,craves_abrasion_wonderbread,7207743,5,2,32,34,0
4_3306360,succumb_abrasion_stimulation_lemon_uranus_saturn,3306360,4,7,370,377,0
4_7051960,succumb_grief_stimulation_bacon_saturn_earth,7051960,4,7,789,796,0
4_7744760,succumb_prostatitis_stimulation_marzipan_uranus_saturn,7744760,4,7,350,357,0
4_6905910,succumb_prostatitis_stimulation_beef_saturn_earth,6905910,4,7,350,357,0
5_5125653,craves_prostatitis_beef,5125653,5,4,8,12,0
4_3289810,feast_entertainment_marzipan_wonderbread_bavaria_manitoba,3289810,4,6,583,589,0
3_7514601,locale_marzipan_manitoba,7514601,3,0,16,16,0
5_5445350,locale_marzipan_bavaria,5445350,5,16,0,16,0
4_6538810,feast_love_ham_lemon_manitoba_pennsylvania,6538810,4,7,714,721,0
4_5206710,feast_love_marzipan_cantelope_bavaria_manitoba,5206710,4,7,479,486,0
4_7872060,overcome_boils_stimulation_ham_uranus_saturn,7872060,4,9,578,587,0
4_2362010,overcome_boils_entertainment_lamb_vulcan_uranus,2362010,4,9,776,785,0
4_7454060,overcome_abrasion_lubricity_marzipan_vulcan_uranus,7454060,4,9,390,399,0
4_3710110,overcome_jealousy_stimulation_beef_uranus_saturn,3710110,4,9,697,706,0
4_7120510,overcome_laceration_entertainment_lemon_vulcan_uranus,7120510,4,9,785,794,0
5_4022794,attacks_bavaria_manitoba,4022794,5,1,125,126,0
4_96811,succumb_loneliness_lubricity_tofu_saturn_earth,96811,4,6,370,376,0
3_6847927,fears_loneliness_lubricity,6847927,3,0,1,1,0
4_157361,succumb_abrasion_lubricity_lamb_uranus_saturn,157361,4,7,376,383,0
4_1098361,feast_lubricity_flounder_ham_bavaria_manitoba,1098361,4,7,322,329,0
4_2484961,feast_love_marzipan_wonderbread_bavaria_manitoba,2484961,4,7,479,486,0
4_6571661,feast_aesthetics_flounder_haroset_bavaria_manitoba,6571661,4,7,637,644,0
4_5247061,overcome_sciatica_stimulation_haroset_vulcan_uranus,5247061,4,9,669,678,0
4_3160211,overcome_abrasion_stimulation_lamb_uranus_saturn,3160211,4,9,361,370,0
4_3352561,overcome_laceration_aesthetics_lobster_saturn_earth,3352561,4,8,833,841,0
3_6130372,craves_laceration_lobster,6130372,3,0,5,5,0
4_6228211,overcome_laceration_lubricity_flounder_uranus_saturn,6228211,4,9,897,906,0
4_7995211,overcome_grief_stimulation_wonderbread_saturn_earth,7995211,4,9,684,693,0
5_601332,pleasure_achievement,601332,5,1,34,35,0
4_54362,noop_fears_sciatica_learning,54362,4,0,313,313,0
3_4464227,fears_sciatica_learning,4464227,3,0,2,2,0
5_6456524,eats_lamb_beef,6456524,5,1,25,26,0
5_3715801,orbits_saturn_earth,3715801,5,1,67,68,0
4_6679712,succumb_grief_entertainment_ham_vulcan_uranus,6679712,4,7,564,571,0
5_3385988,craves_grief_ham,3385988,5,1,100,101,0
4_4766512,succumb_anger_lubricity_haroset_saturn_earth,4766512,4,7,371,378,0
4_3653762,overcome_jealousy_stimulation_beef_saturn_earth,3653762,4,9,699,708,0
4_3431612,overcome_jealousy_lubricity_beef_vulcan_uranus,3431612,4,9,726,735,0
4_1613712,overcome_grief_love_bacon_vulcan_uranus,1613712,4,9,547,556,0
4_1238012,overcome_grief_entertainment_wonderbread_vulcan_uranus,1238012,4,9,426,435,0
4_7667263,noop_fears_hangover_aesthetics,7667263,4,1,283,284,0
4_5371763,succumb_angina_lubricity_haroset_saturn_earth,5371763,4,7,337,344,0
5_4362705,craves_angina_haroset,4362705,5,1,46,47,0
4_5345213,succumb_boils_lubricity_beef_vulcan_uranus,5345213,4,7,343,350,0
4_2521913,succumb_depression_expectation_snickers_saturn_earth,2521913,4,7,146,153,0
4_2068663,feast_stimulation_marzipan_cantelope_bavaria_manitoba,2068663,4,7,363,370,0
4_4615413,feast_lubricity_lamb_beef_bavaria_manitoba,4615413,4,7,640,647,0
4_7375813,feast_entertainment_lemon_cantelope_bavaria_manitoba,7375813,4,7,773,780,0
5_3033139,craves_entertainment_cantelope,3033139,5,4,94,98,0
4_7361263,overcome_depression_expectation_onion_uranus_saturn,7361263,4,9,198,207,0
4_289163,overcome_jealousy_lubricity_ham_uranus_saturn,289163,4,9,730,739,0
4_6533463,overcome_laceration_love_marzipan_vulcan_uranus,6533463,4,9,697,706,0
4_666864,noop_fears_depression_achievement,666864,4,0,130,130,0
3_1976428,fears_depression_achievement,1976428,3,0,2,2,0
5_4615811,locale_onion_bavaria,4615811,5,1,0,1,0
4_3205064,succumb_laceration_stimulation_lobster_uranus_saturn,3205064,4,7,705,712,0
4_2921364,succumb_sciatica_achievement_wonderbread_uranus_saturn,2921364,4,6,262,268,0
3_492278,fears_sciatica_achievement,492278,3,0,2,2,0
4_5558314,succumb_jealousy_lubricity_flounder_saturn_earth,5558314,4,6,411,417,0
3_5529098,fears_jealousy_lubricity,5529098,3,0,5,5,0
4_3159714,overcome_boils_aesthetics_flounder_saturn_earth,3159714,4,9,872,881,0
4_4551164,overcome_sciatica_stimulation_haroset_saturn_earth,4551164,4,9,671,680,0
4_7246414,overcome_angina_lubricity_lemon_uranus_saturn,7246414,4,8,340,348,0
3_894524,craves_angina_lemon,894524,3,0,7,7,0
4_2829614,overcome_hangover_lubricity_onion_saturn_earth,2829614,4,8,543,551,0
3_2335886,craves_lubricity_onion,2335886,3,0,3,3,0
4_5343764,overcome_jealousy_aesthetics_bacon_vulcan_uranus,5343764,4,9,641,650,0
4_6937064,overcome_dread_stimulation_wonderbread_uranus_saturn,6937064,4,9,355,364,0
4_4741415,noop_fears_jealousy_lubricity,4741415,4,1,350,351,0
4_1529215,noop_fears_dread_lubricity,1529215,4,0,395,395,0
3_4319540,fears_dread_lubricity,4319540,3,0,1,1,0
5_5711881,pain_prostatitis,5711881,5,1,99,100,0
4_3536665,noop_locale_ham_pennsylvania,3536665,4,1,689,690,0
4_2987815,noop_fears_depression_stimulation,2987815,4,1,469,470,0
5_7420512,orbits_vulcan_uranus,7420512,5,1,438,439,0
4_3532515,succumb_abrasion_lubricity_wonderbread_saturn_earth,3532515,4,7,403,410,0
4_4121215,succumb_laceration_lubricity_beef_saturn_earth,4121215,4,7,392,399,0
4_1975165,succumb_boils_stimulation_cantelope_saturn_earth,1975165,4,7,398,405,0
4_7986915,feast_aesthetics_lamb_haroset_manitoba_pennsylvania,7986915,4,7,642,649,0
4_3617415,overcome_jealousy_stimulation_lobster_uranus_saturn,3617415,4,9,709,718,0
4_7424566,noop_fears_depression_entertainment,7424566,4,0,505,505,0
3_4530591,fears_depression_entertainment,4530591,3,0,1,1,0
5_1243086,pleasure_entertainment,1243086,5,1,172,173,0
4_1958866,succumb_dread_expectation_wonderbread_saturn_earth,1958866,4,7,114,121,0
4_4707416,succumb_hangover_lubricity_wonderbread_saturn_earth,4707416,4,6,461,467,0
3_3222479,fears_hangover_lubricity,3222479,3,0,1,1,0
4_354266,succumb_depression_learning_wonderbread_saturn_earth,354266,4,7,138,145,0
4_2342116,succumb_jealousy_lubricity_lamb_uranus_saturn,2342116,4,7,412,419,0
4_6478116,overcome_boils_stimulation_lamb_saturn_earth,6478116,4,9,601,610,0
4_4374366,overcome_sciatica_aesthetics_wonderbread_vulcan_uranus,4374366,4,9,256,265,0
4_988916,overcome_abrasion_lubricity_lemon_saturn_earth,988916,4,9,341,350,0
4_7603566,overcome_anger_stimulation_haroset_vulcan_uranus,7603566,4,9,687,696,0
4_1862416,overcome_anger_lubricity_ham_vulcan_uranus,1862416,4,8,700,708,0
3_587956,craves_anger_ham,587956,3,0,6,6,0
4_2458116,overcome_dread_lubricity_wonderbread_uranus_saturn,2458116,4,9,386,395,0
5_2380884,food_haroset,2380884,5,1,203,204,0
4_6295867,noop_craves_anger_ham,6295867,4,1,456,457,0
4_3271667,succumb_laceration_stimulation_haroset_vulcan_uranus,3271667,4,7,363,370,0
4_5405067,succumb_prostatitis_lubricity_beef_saturn_earth,5405067,4,7,354,361,0
4_526367,succumb_abrasion_stimulation_tofu_saturn_earth,526367,4,7,396,403,0
5_411754,craves_abrasion_tofu,411754,5,2,18,20,0
4_4303167,succumb_sciatica_aesthetics_flounder_saturn_earth,4303167,4,7,626,633,0
5_5508353,craves_sciatica_flounder,5508353,5,1,98,99,0
4_1052017,succumb_abrasion_lubricity_lemon_vulcan_uranus,1052017,4,7,378,385,0
4_1917367,succumb_abrasion_lubricity_beef_vulcan_uranus,1917367,4,7,377,384,0
4_4909767,succumb_dread_lubricity_wonderbread_saturn_earth,4909767,4,7,403,410,0
4_64367,succumb_angina_love_lemon_vulcan_uranus,64367,4,7,483,490,0
4_4692517,feast_entertainment_marzipan_tofu_manitoba_pennsylvania,4692517,4,7,583,590,0
5_3965931,craves_entertainment_tofu,3965931,5,3,100,103,0
4_1955017,feast_stimulation_lamb_beef_bavaria_manitoba,1955017,4,7,593,600,0
4_4042467,feast_lubricity_lamb_haroset_bavaria_manitoba,4042467,4,7,640,647,0
4_146217,overcome_sciatica_love_wonderbread_vulcan_uranus,146217,4,9,570,579,0
4_4495467,overcome_abrasion_stimulation_lamb_saturn_earth,4495467,4,9,361,370,0
4_3116817,overcome_depression_stimulation_wonderbread_uranus_saturn,3116817,4,9,397,406,0
4_7602217,overcome_jealousy_lubricity_beef_uranus_saturn,7602217,4,9,721,730,0
4_2927018,noop_fears_hangover_entertainment,2927018,4,0,489,489,0
3_4236582,fears_hangover_entertainment,4236582,3,0,1,1,0
5_6052830,eats_lobster_bacon,6052830,5,1,5,6,0
4_6726918,noop_locale_marzipan_manitoba,6726918,4,1,67,68,0
4_5774068,succumb_boils_lubricity_tofu_saturn_earth,5774068,4,7,369,376,0
5_1403974,craves_boils_tofu,1403974,5,1,51,52,0
4_5925568,succumb_laceration_stimulation_lemon_uranus_saturn,5925568,4,7,364,371,0
4_7866818,succumb_laceration_aesthetics_lamb_saturn_earth,7866818,4,7,684,691,0
4_1103568,succumb_boils_stimulation_ham_saturn_earth,1103568,4,7,389,396,0
4_2746318,overcome_boils_stimulation_flounder_saturn_earth,2746318,4,9,612,621,0
4_2941918,overcome_sciatica_lubricity_wonderbread_uranus_saturn,2941918,4,9,550,559,0
4_948118,overcome_laceration_stimulation_flounder_saturn_earth,948118,4,9,707,716,0
4_4290269,noop_craves_boils_flounder,4290269,4,1,339,340,0
5_3135358,eats_snickers_onion,3135358,5,1,0,1,0
4_4641119,succumb_angina_lubricity_lemon_vulcan_uranus,4641119,4,7,340,347,0
4_1318319,succumb_depression_lubricity_wonderbread_saturn_earth,1318319,4,6,475,481,0
3_2128520,fears_depression_lubricity,2128520,3,0,1,1,0
4_4841569,feast_entertainment_flounder_haroset_bavaria_manitoba,4841569,4,7,526,533,0
4_422019,overcome_boils_lubricity_flounder_saturn_earth,422019,4,9,353,362,0
4_5625419,overcome_abrasion_entertainment_lamb_vulcan_uranus,5625419,4,9,584,593,0
4_939869,overcome_angina_love_flounder_vulcan_uranus,939869,4,9,697,706,0
4_3542269,overcome_angina_stimulation_ham_uranus_saturn,3542269,4,9,355,364,0
4_3735719,overcome_laceration_entertainment_marzipan_vulcan_uranus,3735719,4,9,776,785,0
4_2441819,overcome_laceration_aesthetics_lobster_vulcan_uranus,2441819,4,9,832,841,0
5_7434994,eats_lemon_beef,7434994,5,1,5,6,0
4_7819070,noop_fears_prostatitis_love,7819070,4,0,465,465,0
3_2054340,fears_prostatitis_love,2054340,3,0,1,1,0
5_3163114,planet_earth,3163114,5,1,238,239,0
4_1121570,succumb_angina_lubricity_flounder_uranus_saturn,1121570,4,7,338,345,0
4_7571120,succumb_grief_aesthetics_haroset_uranus_saturn,7571120,4,7,412,419,0
4_4950870,succumb_anger_stimulation_haroset_uranus_saturn,4950870,4,7,705,712,0
4_7184120,succumb_dread_achievement_wonderbread_vulcan_uranus,7184120,4,6,59,65,0
3_554475,harmony_achievement_vulcan,554475,3,0,4,4,0
4_1822920,succumb_anxiety_expectation_onion_vulcan_uranus,1822920,4,7,196,203,0
4_6793720,feast_stimulation_marzipan_beef_bavaria_manitoba,6793720,4,7,363,370,0
4_1139120,overcome_boils_aesthetics_ham_saturn_earth,1139120,4,9,857,866,0
4_7249870,overcome_jealousy_entertainment_flounder_vulcan_uranus,7249870,4,9,564,573,0
4_7119920,overcome_jealousy_aesthetics_lamb_uranus_saturn,7119920,4,9,659,668,0
4_4163020,overcome_loneliness_stimulation_tofu_uranus_saturn,4163020,4,9,351,360,0
5_5601736,eats_cantelope_marzipan,5601736,5,1,0,1,0
5_1830183,province_goias,1830183,5,1,0,1,0
4_3765671,noop_fears_sciatica_lubricity,3765671,4,0,581,581,0
3_4553354,fears_sciatica_lubricity,4553354,3,0,1,1,0
4_5842571,succumb_sciatica_aesthetics_lobster_vulcan_uranus,5842571,4,7,257,264,0
4_3697871,succumb_grief_stimulation_haroset_uranus_saturn,3697871,4,7,525,532,0
4_33921,succumb_sciatica_stimulation_lobster_saturn_earth,33921,4,7,764,771,0
4_4101321,succumb_hangover_love_wonderbread_vulcan_uranus,4101321,4,6,713,719,0
3_6026349,fears_hangover_love,6026349,3,0,1,1,0
4_5476021,succumb_boils_stimulation_beef_saturn_earth,5476021,4,7,385,392,0
4_6142471,feast_lubricity_marzipan_wonderbread_bavaria_manitoba,6142471,4,7,358,365,0
4_5039721,feast_stimulation_ham_lemon_pennsylvania_oregon,5039721,4,7,346,353,0
4_6014421,overcome_abrasion_stimulation_marzipan_saturn_earth,6014421,4,9,378,387,0
4_6033021,overcome_anger_lubricity_ham_uranus_saturn,6033021,4,9,696,705,0
4_4672621,overcome_laceration_aesthetics_lamb_uranus_saturn,4672621,4,9,684,693,0
5_5991737,eats_marzipan_cantelope,5991737,5,1,15,16,0
4_1950022,noop_fears_hangover_stimulation,1950022,4,0,455,455,0
3_1239506,fears_hangover_stimulation,1239506,3,0,1,1,0
4_355622,succumb_sciatica_lubricity_wonderbread_saturn_earth,355622,4,7,588,595,0
4_3990322,succumb_boils_lubricity_marzipan_uranus_saturn,3990322,4,7,356,363,0
4_1033722,succumb_abrasion_love_lemon_vulcan_uranus,1033722,4,7,512,519,0
4_495122,succumb_sciatica_love_lobster_vulcan_uranus,495122,4,7,537,544,0
4_4321572,succumb_jealousy_love_lemon_vulcan_uranus,4321572,4,7,495,502,0
5_7186611,craves_jealousy_lemon,7186611,5,1,80,81,0
4_7937322,feast_aesthetics_beef_marzipan_pennsylvania_oregon,7937322,4,7,794,801,0
5_2410921,craves_aesthetics_marzipan,2410921,5,3,125,128,0
4_1277772,overcome_laceration_stimulation_beef_uranus_saturn,1277772,4,9,362,371,0
4_2595573,succumb_boils_lubricity_ham_vulcan_uranus,2595573,4,7,344,351,0
4_450623,succumb_prostatitis_lubricity_cantelope_saturn_earth,450623,4,7,354,361,0
4_6948323,succumb_abrasion_lubricity_tofu_saturn_earth,6948323,4,7,403,410,0
4_3363423,succumb_laceration_lubricity_beef_uranus_saturn,3363423,4,7,402,409,0
4_4836223,feast_entertainment_marzipan_wonderbread_pennsylvania_oregon,4836223,4,7,638,645,0
4_3050273,feast_entertainment_marzipan_tofu_bavaria_manitoba,3050273,4,7,583,590,0
4_1024773,feast_lubricity_marzipan_beef_bavaria_manitoba,1024773,4,7,358,365,0
4_5027623,feast_stimulation_flounder_ham_bavaria_manitoba,5027623,4,7,357,364,0
4_667973,feast_love_marzipan_beef_bavaria_manitoba,667973,4,7,479,486,0
4_3317223,overcome_abrasion_lubricity_lamb_vulcan_uranus,3317223,4,9,376,385,0
4_4713773,overcome_angina_entertainment_flounder_vulcan_uranus,4713773,4,9,767,776,0
4_1056773,overcome_anger_aesthetics_haroset_vulcan_uranus,1056773,4,9,620,629,0
5_1626822,province_pennsylvania,1626822,5,1,0,1,0
4_5237174,succumb_hangover_aesthetics_wonderbread_saturn_earth,5237174,4,7,301,308,0
4_5564124,succumb_depression_expectation_wonderbread_saturn_earth,5564124,4,7,130,137,0
4_433474,succumb_laceration_lubricity_haroset_saturn_earth,433474,4,7,400,407,0
4_5547324,succumb_boils_stimulation_lemon_uranus_saturn,5547324,4,7,385,392,0
4_5452724,feast_entertainment_marzipan_cantelope_bavaria_manitoba,5452724,4,7,583,590,0
4_5438824,overcome_anger_stimulation_ham_saturn_earth,5438824,4,9,687,696,0
4_6612424,overcome_laceration_aesthetics_lobster_uranus_saturn,6612424,4,9,832,841,0
4_7879475,noop_craves_abrasion_marzipan,7879475,4,1,96,97,0
4_6662125,succumb_hangover_stimulation_wonderbread_saturn_earth,6662125,4,7,463,470,0
4_1293775,succumb_laceration_stimulation_wonderbread_saturn_earth,1293775,4,7,363,370,0
5_3146901,craves_laceration_wonderbread,3146901,5,1,7,8,0
4_6432225,succumb_jealousy_love_marzipan_vulcan_uranus,6432225,4,7,507,514,0
5_2993567,craves_jealousy_marzipan,2993567,5,1,86,87,0
4_3468825,succumb_hangover_achievement_wonderbread_uranus_saturn,3468825,4,6,125,131,0
3_6919532,fears_hangover_achievement,6919532,3,0,2,2,0
4_3215825,succumb_jealousy_lubricity_flounder_uranus_saturn,3215825,4,7,412,419,0
4_1853775,feast_aesthetics_ham_flounder_goias_bosnia,1853775,4,7,663,670,0
4_7789525,feast_love_marzipan_tofu_bavaria_manitoba,7789525,4,7,479,486,0
4_2683325,overcome_boils_stimulation_marzipan_saturn_earth,2683325,4,9,605,614,0
4_3308525,overcome_boils_stimulation_marzipan_uranus_saturn,3308525,4,9,608,617,0
4_1687825,overcome_abrasion_stimulation_lemon_vulcan_uranus,1687825,4,9,370,379,0
4_2619075,overcome_angina_aesthetics_flounder_saturn_earth,2619075,4,9,865,874,0
5_223572,fears_angina_aesthetics,223572,5,3,109,112,0
4_5889325,overcome_angina_lubricity_flounder_saturn_earth,5889325,4,9,349,358,0
4_569525,overcome_depression_lubricity_onion_saturn_earth,569525,4,9,479,488,0
4_2505325,overcome_hangover_expectation_snickers_vulcan_uranus,2505325,4,9,123,132,0
4_885125,overcome_laceration_stimulation_marzipan_saturn_earth,885125,4,9,378,387,0
4_3453325,overcome_laceration_lubricity_haroset_uranus_saturn,3453325,4,9,413,422,0
5_696593,food_lobster,696593,5,1,99,100,0
5_6444638,eats_beef_lamb,6444638,5,1,15,16,0
4_7334526,noop_craves_boils_lamb,7334526,4,1,339,340,0
4_4114576,succumb_boils_lubricity_flounder_uranus_saturn,4114576,4,7,342,349,0
4_2386476,succumb_depression_expectation_onion_saturn_earth,2386476,4,7,191,198,0
4_5243076,succumb_jealousy_entertainment_ham_vulcan_uranus,5243076,4,7,584,591,0
4_359026,overcome_boils_lubricity_marzipan_saturn_earth,359026,4,9,357,366,0
4_4662276,overcome_abrasion_stimulation_lemon_saturn_earth,4662276,4,9,365,374,0
4_7436376,overcome_grief_aesthetics_haroset_saturn_earth,7436376,4,9,407,416,0
5_7283739,eats_tofu_marzipan,7283739,5,1,4,5,0
5_5583426,food_bacon,5583426,5,1,66,67,0
5_6905224,attacks_oregon_goias,6905224,5,1,20,21,0
5_4569802,eats_haroset_lamb,4569802,5,1,0,1,0
4_1252677,succumb_angina_stimulation_ham_saturn_earth,1252677,4,6,365,371,0
3_597652,fears_angina_stimulation,597652,3,0,1,1,0
4_4844127,succumb_hangover_aesthetics_wonderbread_vulcan_uranus,4844127,4,7,323,330,0
4_1927727,succumb_laceration_stimulation_lamb_vulcan_uranus,1927727,4,7,355,362,0
4_4740427,succumb_laceration_entertainment_beef_vulcan_uranus,4740427,4,7,609,616,0
4_4549577,feast_stimulation_marzipan_wonderbread_bavaria_manitoba,4549577,4,7,363,370,0
4_2162827,feast_aesthetics_lamb_beef_manitoba_pennsylvania,2162827,4,7,642,649,0
4_3092377,overcome_sciatica_aesthetics_lobster_vulcan_uranus,3092377,4,9,257,266,0
4_6213277,overcome_depression_lubricity_wonderbread_uranus_saturn,6213277,4,9,428,437,0
4_6679027,overcome_laceration_aesthetics_haroset_vulcan_uranus,6679027,4,9,470,479,0
4_3941077,overcome_grief_aesthetics_haroset_uranus_saturn,3941077,4,9,412,421,0
5_1366298,attacks_goias_bosnia,1366298,5,1,20,21,0
4_277078,noop_fears_loneliness_stimulation,277078,4,1,366,367,0
4_3769528,noop_craves_abrasion_lemon,3769528,4,1,80,81,0
5_918250,pain_boils,918250,5,1,8,9,0
4_3989478,succumb_prostatitis_lubricity_beef_uranus_saturn,3989478,4,7,354,361,0
4_3501678,overcome_boils_love_marzipan_vulcan_uranus,3501678,4,9,702,711,0
4_7487828,overcome_abrasion_lubricity_lamb_uranus_saturn,7487828,4,9,366,375,0
4_5227378,overcome_anger_aesthetics_haroset_uranus_saturn,5227378,4,9,620,629,0
4_5501978,overcome_jealousy_lubricity_lamb_vulcan_uranus,5501978,4,9,451,460,0
4_584478,overcome_laceration_entertainment_lobster_vulcan_uranus,584478,4,9,749,758,0
4_5758178,overcome_laceration_lubricity_lemon_saturn_earth,5758178,4,9,613,622,0
4_3150028,overcome_grief_lubricity_flounder_vulcan_uranus,3150028,4,9,792,801,0
5_2046441,eats_lemon_ham,2046441,5,1,5,6,0
5_778475,pain_hangover,778475,5,1,77,78,0
5_1840068,food_wonderbread,1840068,5,1,302,303,0
4_4719929,noop_craves_jealousy_ham,4719929,4,1,493,494,0
4_2162529,succumb_laceration_love_marzipan_vulcan_uranus,2162529,4,7,523,530,0
4_3233979,succumb_sciatica_aesthetics_lamb_saturn_earth,3233979,4,7,625,632,0
5_1579104,craves_sciatica_lamb,1579104,5,1,107,108,0
4_460529,succumb_jealousy_lubricity_lamb_saturn_earth,460529,4,7,412,419,0
4_2040829,feast_love_lamb_haroset_bavaria_manitoba,2040829,4,7,507,514,0
4_7971729,feast_stimulation_lamb_haroset_bavaria_manitoba,7971729,4,7,593,600,0
4_4562129,feast_lubricity_lobster_bacon_bavaria_manitoba,4562129,4,7,763,770,0
5_4108876,craves_lubricity_bacon,4108876,5,1,123,124,0
4_3432779,overcome_boils_stimulation_flounder_uranus_saturn,3432779,4,9,613,622,0
4_4248829,overcome_abrasion_entertainment_lemon_vulcan_uranus,4248829,4,9,606,615,0
4_1592579,overcome_abrasion_lubricity_lemon_uranus_saturn,1592579,4,9,341,350,0
4_4981179,overcome_abrasion_lubricity_lamb_saturn_earth,4981179,4,9,360,369,0
4_2862479,overcome_angina_aesthetics_flounder_uranus_saturn,2862479,4,9,863,872,0
4_4865379,overcome_hangover_lubricity_wonderbread_uranus_saturn,4865379,4,9,421,430,0
4_6279329,overcome_anger_stimulation_haroset_saturn_earth,6279329,4,9,688,697,0
4_4436329,overcome_anger_lubricity_flounder_vulcan_uranus,4436329,4,9,362,371,0
5_522536,locale_cantelope_bavaria,522536,5,1,0,1,0
4_2762830,noop_fears_sciatica_expectation,2762830,4,1,297,298,0
5_2200903,pleasure_love,2200903,5,1,63,64,0
5_4138703,eats_wonderbread_marzipan,4138703,5,1,0,1,0
4_5624880,succumb_grief_aesthetics_flounder_saturn_earth,5624880,4,7,629,636,0
4_1810380,succumb_boils_lubricity_cantelope_uranus_saturn,1810380,4,7,343,350,0
4_5267480,succumb_sciatica_expectation_wonderbread_vulcan_uranus,5267480,4,7,320,327,0
4_1521380,succumb_anxiety_learning_onion_saturn_earth,1521380,4,7,109,116,0
4_1984630,feast_aesthetics_beef_marzipan_bavaria_manitoba,1984630,4,7,654,661,0
4_5663830,overcome_sciatica_love_haroset_vulcan_uranus,5663830,4,9,556,565,0
4_3327830,overcome_sciatica_lubricity_lobster_saturn_earth,3327830,4,9,774,783,0
4_5858430,overcome_abrasion_stimulation_lemon_uranus_saturn,5858430,4,9,370,379,0
4_1919880,overcome_abrasion_aesthetics_lamb_saturn_earth,1919880,4,9,687,696,0
5_2767507,fears_abrasion_aesthetics,2767507,5,3,112,115,0
4_7891030,overcome_abrasion_aesthetics_lamb_uranus_saturn,7891030,4,9,685,694,0
4_6724730,overcome_laceration_stimulation_haroset_vulcan_uranus,6724730,4,9,363,372,0
4_5767630,overcome_grief_learning_wonderbread_vulcan_uranus,5767630,4,9,504,513,0
4_696830,overcome_grief_achievement_wonderbread_uranus_saturn,696830,4,9,440,449,0
5_6588915,locale_wonderbread_bavaria,6588915,5,1,0,1,0
5_3412554,food_marzipan,3412554,5,1,79,80,0
5_6425404,eats_marzipan_wonderbread,6425404,5,1,15,16,0
5_2289801,eats_haroset_lobster,2289801,5,1,0,1,0
4_4606631,succumb_prostatitis_lubricity_wonderbread_saturn_earth,4606631,4,7,367,374,0
5_58194,craves_prostatitis_wonderbread,58194,5,2,28,30,0
4_4170531,succumb_abrasion_stimulation_haroset_saturn_earth,4170531,4,7,370,377,0
4_717181,succumb_jealousy_stimulation_beef_vulcan_uranus,717181,4,7,396,403,0
4_3446381,succumb_prostatitis_love_marzipan_vulcan_uranus,3446381,4,7,481,488,0
4_6911181,succumb_anger_aesthetics_flounder_saturn_earth,6911181,4,6,640,646,0
3_3653896,fears_anger_aesthetics,3653896,3,0,1,1,0
4_7722281,feast_entertainment_marzipan_wonderbread_manitoba_pennsylvania,7722281,4,7,583,590,0
4_441431,overcome_angina_stimulation_flounder_uranus_saturn,441431,4,9,616,625,0
4_6167881,overcome_angina_lubricity_lemon_saturn_earth,6167881,4,9,340,349,0
4_3963981,overcome_grief_lubricity_lamb_uranus_saturn,3963981,4,9,784,793,0
4_1480031,overcome_grief_lubricity_wonderbread_uranus_saturn,1480031,4,9,713,722,0
5_677729,eats_tofu_onion,677729,5,1,4,5,0
4_7835032,noop_locale_beef_bavaria,7835032,4,0,49,49,0
3_5689671,locale_beef_bavaria,5689671,3,0,0,0,0
4_167282,succumb_abrasion_stimulation_lamb_vulcan_uranus,167282,4,7,370,377,0
4_6373882,succumb_abrasion_lubricity_marzipan_uranus_saturn,6373882,4,7,390,397,0
4_4107482,overcome_boils_love_cantelope_vulcan_uranus,4107482,4,9,711,720,0
4_3625932,overcome_boils_love_flounder_vulcan_uranus,3625932,4,9,704,713,0
4_7262982,overcome_sciatica_aesthetics_lobster_uranus_saturn,7262982,4,9,257,266,0
4_7540482,overcome_jealousy_stimulation_beef_vulcan_uranus,7540482,4,9,697,706,0
4_170733,noop_fears_hangover_love,170733,4,1,709,710,0
5_7318845,eats_snickers_okra,7318845,5,1,2,3,0
5_7865332,pain_dread,7865332,5,1,37,38,0
5_473381,eats_ham_flounder,473381,5,1,21,22,0
5_6322230,eats_wonderbread_bacon,6322230,5,1,0,1,0
5_2268262,food_tofu,2268262,5,1,70,71,0
5_3151412,food_lamb,3151412,5,1,133,134,0
4_2854983,noop_craves_grief_lamb,2854983,4,1,543,544,0
4_274283,succumb_depression_aesthetics_wonderbread_uranus_saturn,274283,4,7,327,334,0
4_7192833,succumb_laceration_love_lemon_vulcan_uranus,7192833,4,7,511,518,0
4_3149333,succumb_laceration_stimulation_marzipan_uranus_saturn,3149333,4,7,377,384,0
4_5849983,succumb_anger_lubricity_ham_saturn_earth,5849983,4,7,372,379,0
4_2355633,feast_aesthetics_ham_flounder_pennsylvania_oregon,2355633,4,7,647,654,0
4_917733,overcome_boils_entertainment_lemon_vulcan_uranus,917733,4,9,610,619,0
4_6990583,overcome_abrasion_stimulation_lamb_vulcan_uranus,6990583,4,9,361,370,0
4_6643533,overcome_hangover_stimulation_onion_saturn_earth,6643533,4,9,545,554,0
4_5908383,overcome_jealousy_stimulation_flounder_saturn_earth,5908383,4,9,674,683,0
4_1197133,overcome_grief_entertainment_lamb_vulcan_uranus,1197133,4,9,559,568,0
4_7320633,overcome_grief_lubricity_flounder_uranus_saturn,7320633,4,9,789,798,0
4_6440884,noop_craves_abrasion_lamb,6440884,4,1,80,81,0
4_7164284,succumb_grief_aesthetics_lobster_vulcan_uranus,7164284,4,7,291,298,0
4_556434,succumb_anger_love_lemon_vulcan_uranus,556434,4,7,462,469,0
5_4480323,craves_anger_lemon,4480323,5,1,80,81,0
4_6473534,succumb_hangover_expectation_okra_saturn_earth,6473534,4,7,120,127,0
4_1466434,feast_love_tofu_marzipan_bavaria_manitoba,1466434,4,6,480,486,0
3_2670059,craves_love_tofu,2670059,3,0,3,3,0
4_2447884,feast_lubricity_marzipan_cantelope_bavaria_manitoba,2447884,4,7,358,365,0
4_3794934,overcome_abrasion_stimulation_marzipan_vulcan_uranus,3794934,4,9,383,392,0
4_6454034,overcome_angina_aesthetics_ham_saturn_earth,6454034,4,9,660,669,0
4_2573834,overcome_jealousy_love_bacon_vulcan_uranus,2573834,4,9,576,585,0
4_3039885,noop_craves_angina_lemon,3039885,4,1,328,329,0
5_6088560,attacks_pennsylvania_oregon,6088560,5,1,49,50,0
4_5552835,succumb_anger_stimulation_flounder_uranus_saturn,5552835,4,7,705,712,0
4_7061635,succumb_laceration_stimulation_bacon_saturn_earth,7061635,4,7,782,789,0
5_5950375,craves_laceration_bacon,5950375,5,1,129,130,0
4_999135,succumb_sciatica_aesthetics_bacon_vulcan_uranus,999135,4,7,221,228,0
4_6306235,succumb_depression_learning_snickers_saturn_earth,6306235,4,7,122,129,0
4_4208485,succumb_dread_love_wonderbread_vulcan_uranus,4208485,4,7,653,660,0
4_1111985,feast_entertainment_marzipan_cantelope_pennsylvania_oregon,1111985,4,7,638,645,0
4_5513085,overcome_sciatica_stimulation_wonderbread_uranus_saturn,5513085,4,9,515,524,0
4_1849285,overcome_abrasion_aesthetics_beef_saturn_earth,1849285,4,9,694,703,0
4_6531735,overcome_angina_entertainment_lemon_vulcan_uranus,6531735,4,9,784,793,0
4_4104635,overcome_jealousy_aesthetics_lamb_saturn_earth,4104635,4,9,660,669,0
4_4119535,overcome_jealousy_lubricity_ham_vulcan_uranus,4119535,4,9,734,743,0
4_1507085,overcome_laceration_lubricity_flounder_saturn_earth,1507085,4,9,895,904,0
5_1742084,eats_haroset_flounder,1742084,5,1,5,6,0
5_2922283,pleasure_stimulation,2922283,5,1,451,452,0
4_2839036,noop_fears_depression_lubricity,2839036,4,1,467,468,0
5_4985459,pain_sciatica,4985459,5,1,76,77,0
4_4518386,succumb_laceration_entertainment_haroset_vulcan_uranus,4518386,4,7,396,403,0
4_6751736,succumb_sciatica_achievement_wonderbread_vulcan_uranus,6751736,4,7,288,295,0
4_2016836,succumb_depression_achievement_wonderbread_vulcan_uranus,2016836,4,7,174,181,0
4_4887786,succumb_jealousy_stimulation_beef_uranus_saturn,4887786,4,7,396,403,0
4_3022936,succumb_jealousy_entertainment_beef_vulcan_uranus,3022936,4,7,584,591,0
4_7350636,feast_stimulation_ham_flounder_pennsylvania_oregon,7350636,4,7,346,353,0
4_3205636,overcome_grief_stimulation_flounder_vulcan_uranus,3205636,4,9,771,780,0
4_6501036,overcome_grief_stimulation_lamb_saturn_earth,6501036,4,9,764,773,0
5_6440549,pleasure_lubricity,6440549,5,1,422,423,0
5_3810436,food_onion,3810436,5,1,68,69,0
5_2278622,eats_okra_snickers,2278622,5,1,2,3,0
5_5075412,craves_achievement_wonderbread,5075412,5,1,25,26,0
4_4389637,noop_fears_depression_love,4389637,4,1,725,726,0
4_3273587,succumb_laceration_stimulation_flounder_uranus_saturn,3273587,4,7,373,380,0
4_3921687,succumb_boils_entertainment_beef_vulcan_uranus,3921687,4,7,727,734,0
4_3816737,succumb_abrasion_stimulation_haroset_vulcan_uranus,3816737,4,7,370,377,0
4_3989637,succumb_hangover_learning_okra_saturn_earth,3989637,4,7,154,161,0
4_5981887,succumb_depression_entertainment_wonderbread_vulcan_uranus,5981887,4,7,509,516,0
4_6278437,succumb_anger_entertainment_ham_vulcan_uranus,6278437,4,7,562,569,0
4_5724287,feast_entertainment_ham_flounder_pennsylvania_oregon,5724287,4,7,558,565,0
4_3015587,feast_aesthetics_beef_lamb_manitoba_pennsylvania,3015587,4,7,654,661,0
4_7447787,overcome_jealousy_stimulation_lobster_vulcan_uranus,7447787,4,9,709,718,0
4_652137,overcome_jealousy_stimulation_flounder_vulcan_uranus,652137,4,9,674,683,0
5_511036,eats_wonderbread_okra,511036,5,1,0,1,0
4_6604388,noop_locale_tofu_bavaria,6604388,4,0,59,59,0
3_4459027,locale_tofu_bavaria,4459027,3,0,0,0,0
5_2289523,eats_beef_marzipan,2289523,5,1,15,16,0
4_3600038,succumb_jealousy_aesthetics_lobster_uranus_saturn,3600038,4,7,437,444,0
4_7858338,succumb_laceration_stimulation_beef_vulcan_uranus,7858338,4,7,363,370,0
4_3927488,succumb_abrasion_lubricity_cantelope_uranus_saturn,3927488,4,7,377,384,0
4_3920438,succumb_hangover_expectation_onion_saturn_earth,3920438,4,7,192,199,0
4_5120588,overcome_sciatica_stimulation_bacon_uranus_saturn,5120588,4,9,815,824,0
4_3623688,overcome_abrasion_lubricity_marzipan_uranus_saturn,3623688,4,9,380,389,0
4_478038,overcome_dread_achievement_wonderbread_vulcan_uranus,478038,4,9,59,68,0
4_99639,noop_craves_lubricity_onion,99639,4,1,364,365,0
5_1486223,pain_angina,1486223,5,1,74,75,0
5_6188452,food_ham,6188452,5,1,76,77,0
5_137551,eats_ham_lemon,137551,5,1,0,1,0
4_5433789,succumb_laceration_lubricity_lamb_uranus_saturn,5433789,4,7,401,408,0
4_7754539,succumb_hangover_expectation_snickers_saturn_earth,7754539,4,7,123,130,0
4_7378339,succumb_prostatitis_stimulation_tofu_saturn_earth,7378339,4,7,363,370,0
5_3734046,craves_prostatitis_tofu,3734046,5,2,18,20,0
4_4239139,feast_entertainment_lemon_beef_bavaria_manitoba,4239139,4,7,773,780,0
4_1416689,overcome_sciatica_stimulation_haroset_uranus_saturn,1416689,4,9,669,678,0
4_7965539,overcome_abrasion_stimulation_marzipan_uranus_saturn,7965539,4,9,383,392,0
4_450139,overcome_jealousy_love_ham_vulcan_uranus,450139,4,9,505,514,0
5_895075,eats_marzipan_tofu,895075,5,1,15,16,0
5_3659869,food_beef,3659869,5,1,183,184,0
5_1930663,food_flounder,1930663,5,1,165,166,0
5_6634256,eats_onion_snickers,6634256,5,1,0,1,0
4_7403790,succumb_jealousy_aesthetics_lobster_saturn_earth,7403790,4,7,437,444,0
4_7232890,succumb_prostatitis_lubricity_marzipan_uranus_saturn,7232890,4,7,354,361,0
4_7461640,succumb_grief_stimulation_lobster_uranus_saturn,7461640,4,7,728,735,0
4_2422390,succumb_prostatitis_stimulation_wonderbread_saturn_earth,2422390,4,7,350,357,0
4_4158390,succumb_prostatitis_stimulation_beef_uranus_saturn,4158390,4,7,350,357,0
4_6262540,feast_aesthetics_beef_lemon_bavaria_manitoba,6262540,4,7,654,661,0
4_2594290,overcome_sciatica_lubricity_haroset_saturn_earth,2594290,4,9,677,686,0
4_4330090,overcome_anger_aesthetics_flounder_uranus_saturn,4330090,4,9,637,646,0
4_4972740,overcome_loneliness_love_tofu_vulcan_uranus,4972740,4,9,475,484,0
5_6977933,fears_loneliness_love,6977933,5,1,74,75,0
4_6324440,overcome_grief_lubricity_flounder_saturn_earth,6324440,4,9,781,790,0
4_2979041,noop_craves_angina_flounder,2979041,4,1,335,336,0
4_6828741,noop_fears_abrasion_entertainment,6828741,4,0,598,598,0
3_137328,fears_abrasion_entertainment,137328,3,0,1,1,0
4_1264991,noop_harmony_achievement_vulcan,1264991,4,1,55,56,0
4_777291,succumb_boils_entertainment_ham_vulcan_uranus,777291,4,7,727,734,0
4_6187441,succumb_depression_achievement_wonderbread_uranus_saturn,6187441,4,7,141,148,0
4_20541,feast_aesthetics_beef_lemon_pennsylvania_oregon,20541,4,7,794,801,0
4_528591,feast_aesthetics_beef_marzipan_manitoba_pennsylvania,528591,4,7,654,661,0
4_4231341,feast_aesthetics_beef_lamb_pennsylvania_oregon,4231341,4,7,794,801,0
4_6118241,overcome_hangover_expectation_wonderbread_vulcan_uranus,6118241,4,9,121,130,0
4_7376241,overcome_grief_stimulation_flounder_uranus_saturn,7376241,4,9,771,780,0
5_1180739,pain_laceration,1180739,5,1,186,187,0
4_5102592,noop_locale_lamb_manitoba,5102592,4,1,402,403,0
4_6763242,noop_harmony_aesthetics_vulcan,6763242,4,1,182,183,0
4_5040992,noop_fears_dread_stimulation,5040992,4,0,397,397,0
3_1449880,fears_dread_stimulation,1449880,3,0,1,1,0
4_5725342,noop_craves_laceration_lemon,5725342,4,1,368,369,0
4_7987342,succumb_abrasion_stimulation_haroset_uranus_saturn,7987342,4,7,370,377,0
4_5586892,succumb_hangover_learning_wonderbread_saturn_earth,5586892,4,7,138,145,0
4_7592592,succumb_abrasion_lubricity_cantelope_saturn_earth,7592592,4,7,377,384,0
4_3618692,succumb_dread_learning_wonderbread_saturn_earth,3618692,4,7,130,137,0
4_3291842,overcome_boils_stimulation_cantelope_uranus_saturn,3291842,4,9,623,632,0
4_3684192,overcome_sciatica_aesthetics_haroset_saturn_earth,3684192,4,9,405,414,0
4_1340642,overcome_abrasion_lubricity_marzipan_saturn_earth,1340642,4,9,375,384,0
4_4822742,overcome_jealousy_stimulation_flounder_uranus_saturn,4822742,4,9,674,683,0
4_1513392,overcome_jealousy_aesthetics_bacon_uranus_saturn,1513392,4,9,641,650,0
4_1444092,overcome_laceration_lubricity_marzipan_saturn_earth,1444092,4,9,620,629,0
4_2204542,overcome_laceration_lubricity_lemon_vulcan_uranus,2204542,4,9,632,641,0
4_352742,overcome_grief_stimulation_lamb_vulcan_uranus,352742,4,9,764,773,0
4_7601293,noop_craves_lubricity_lobster,7601293,4,1,688,689,0
5_3590140,orbits_uranus_saturn,3590140,5,1,412,413,0
4_4700043,noop_craves_aesthetics_beef,4700043,4,1,626,627,0
4_7558443,noop_fears_loneliness_lubricity,7558443,4,1,364,365,0
4_1539443,noop_fears_angina_entertainment,1539443,4,1,567,568,0
5_1484863,eats_lobster_haroset,1484863,5,1,2,3,0
5_1370260,pain_anxiety,1370260,5,1,12,13,0
4_376993,noop_craves_love_tofu,376993,4,1,462,463,0
4_4368043,succumb_laceration_stimulation_cantelope_saturn_earth,4368043,4,7,376,383,0
5_4834197,craves_laceration_cantelope,4834197,5,1,50,51,0
4_1323893,succumb_sciatica_love_wonderbread_vulcan_uranus,1323893,4,7,537,544,0
4_6097893,succumb_abrasion_stimulation_beef_vulcan_uranus,6097893,4,7,369,376,0
4_7528243,succumb_grief_stimulation_haroset_vulcan_uranus,7528243,4,7,525,532,0
4_962493,succumb_prostatitis_stimulation_cantelope_saturn_earth,962493,4,7,350,357,0
4_1981143,succumb_boils_stimulation_beef_vulcan_uranus,1981143,4,7,385,392,0
4_6739043,feast_entertainment_lamb_beef_manitoba_pennsylvania,6739043,4,7,538,545,0
4_5633593,overcome_boils_entertainment_marzipan_vulcan_uranus,5633593,4,9,791,800,0
4_2343143,overcome_angina_stimulation_lemon_uranus_saturn,2343143,4,9,609,618,0
4_359343,overcome_angina_stimulation_flounder_saturn_earth,359343,4,9,615,624,0
4_2522443,overcome_hangover_expectation_onion_uranus_saturn,2522443,4,9,195,204,0
4_2611343,overcome_anger_love_ham_vulcan_uranus,2611343,4,9,468,477,0
4_4630293,overcome_anger_stimulation_ham_uranus_saturn,4630293,4,9,685,694,0
4_6872543,overcome_jealousy_stimulation_lobster_saturn_earth,6872543,4,9,706,715,0
4_4411393,overcome_grief_love_wonderbread_vulcan_uranus,4411393,4,9,620,629,0
5_3456443,pain_grief,3456443,5,1,150,151,0
5_5631791,pain_loneliness,5631791,5,1,19,20,0
4_1202794,noop_fears_sciatica_achievement,1202794,4,1,252,253,0
4_2206194,succumb_abrasion_love_lamb_vulcan_uranus,2206194,4,7,512,519,0
4_6670644,succumb_abrasion_stimulation_marzipan_uranus_saturn,6670644,4,7,383,390,0
4_622094,succumb_grief_stimulation_haroset_saturn_earth,622094,4,7,525,532,0
4_2009394,succumb_sciatica_learning_wonderbread_vulcan_uranus,2009394,4,7,336,343,0
4_2533744,succumb_depression_learning_okra_saturn_earth,2533744,4,7,139,146,0
4_5734094,succumb_boils_love_lemon_vulcan_uranus,5734094,4,7,510,517,0
4_1293294,succumb_jealousy_lubricity_haroset_saturn_earth,1293294,4,7,409,416,0
4_1877294,feast_lubricity_flounder_haroset_bavaria_manitoba,1877294,4,7,322,329,0
4_5724494,feast_aesthetics_beef_lemon_manitoba_pennsylvania,5724494,4,7,654,661,0
4_543994,overcome_sciatica_aesthetics_wonderbread_uranus_saturn,543994,4,9,256,265,0
4_3191094,overcome_angina_love_lemon_vulcan_uranus,3191094,4,9,695,704,0
4_2410744,overcome_anger_love_haroset_vulcan_uranus,2410744,4,9,463,472,0
4_3773194,overcome_anger_stimulation_haroset_uranus_saturn,3773194,4,9,687,696,0
4_7190944,overcome_jealousy_stimulation_ham_saturn_earth,7190944,4,9,709,718,0
4_733794,overcome_jealousy_lubricity_ham_saturn_earth,733794,4,9,731,740,0
4_5108144,overcome_laceration_stimulation_beef_vulcan_uranus,5108144,4,9,362,371,0
5_6616492,eats_lemon_cantelope,6616492,5,1,5,6,0
4_3523745,noop_fears_sciatica_stimulation,3523745,4,1,454,455,0
4_3074745,noop_harmony_lubricity_vulcan,3074745,4,1,290,291,0
4_3758745,noop_craves_grief_wonderbread,3758745,4,1,419,420,0
5_4889270,eats_flounder_haroset,4889270,5,1,15,16,0
4_4775145,succumb_jealousy_aesthetics_lamb_saturn_earth,4775145,4,7,659,666,0
4_5651945,succumb_grief_aesthetics_bacon_vulcan_uranus,5651945,4,7,280,287,0
4_5768295,succumb_grief_aesthetics_lamb_saturn_earth,5768295,4,7,628,635,0
4_1908395,succumb_anger_stimulation_haroset_saturn_earth,1908395,4,7,705,712,0
4_2317395,succumb_dread_stimulation_wonderbread_saturn_earth,2317395,4,7,405,412,0
4_7193795,succumb_laceration_lubricity_beef_vulcan_uranus,7193795,4,7,402,409,0
4_3800745,succumb_hangover_expectation_onion_vulcan_uranus,3800745,4,7,191,198,0
4_5914295,feast_stimulation_marzipan_tofu_bavaria_manitoba,5914295,4,7,363,370,0
4_646945,overcome_anxiety_lubricity_onion_saturn_earth,646945,4,9,382,391,0
5_2652512,fears_anxiety_lubricity,2652512,5,1,48,49,0
4_6194395,overcome_anger_lubricity_ham_saturn_earth,6194395,4,9,696,705,0
4_180545,overcome_jealousy_love_beef_vulcan_uranus,180545,4,9,500,509,0
4_871795,overcome_grief_stimulation_bacon_uranus_saturn,871795,4,9,789,798,0
4_6816796,noop_fears_grief_lubricity,6816796,4,0,576,576,0
3_1606144,fears_grief_lubricity,1606144,3,0,1,1,0
4_3000496,noop_craves_laceration_marzipan,3000496,4,1,359,360,0
4_2434796,noop_fears_hangover_lubricity,2434796,4,1,453,454,0
4_7810946,noop_fears_angina_stimulation,7810946,4,1,352,353,0
4_7837246,succumb_jealousy_aesthetics_haroset_uranus_saturn,7837246,4,7,468,475,0
4_3154346,succumb_depression_expectation_onion_vulcan_uranus,3154346,4,7,193,200,0
4_5877496,succumb_prostatitis_lubricity_tofu_saturn_earth,5877496,4,7,367,374,0
4_5144146,succumb_sciatica_stimulation_lobster_uranus_saturn,5144146,4,7,764,771,0
4_5874296,succumb_anger_lubricity_ham_uranus_saturn,5874296,4,7,372,379,0
4_6303596,succumb_hangover_expectation_wonderbread_saturn_earth,6303596,4,7,122,129,0
4_7417196,feast_love_ham_flounder_pennsylvania_oregon,7417196,4,7,435,442,0
4_3429796,feast_lubricity_lobster_haroset_bavaria_manitoba,3429796,4,7,763,770,0
4_4518496,overcome_sciatica_lubricity_haroset_uranus_saturn,4518496,4,9,674,683,0
4_4074396,overcome_depression_learning_onion_vulcan_uranus,4074396,4,9,139,148,0
4_6060546,overcome_hangover_stimulation_wonderbread_uranus_saturn,6060546,4,9,390,399,0
4_82246,overcome_jealousy_aesthetics_bacon_saturn_earth,82246,4,9,641,650,0
4_4634146,overcome_laceration_stimulation_lobster_saturn_earth,4634146,4,9,707,716,0
4_3042946,overcome_grief_expectation_wonderbread_vulcan_uranus,3042946,4,9,488,497,0
4_7686496,overcome_grief_lubricity_lamb_saturn_earth,7686496,4,9,781,790,0
5_6857847,attacks_manitoba_pennsylvania,6857847,5,1,65,66,0
5_2286682,eats_marzipan_beef,2286682,5,1,15,16,0
5_7813070,pain_abrasion,7813070,5,1,163,164,0
4_7440497,succumb_angina_lubricity_ham_vulcan_uranus,7440497,4,7,340,347,0
4_7840197,succumb_hangover_learning_snickers_saturn_earth,7840197,4,7,144,151,0
4_6305247,succumb_abrasion_entertainment_beef_vulcan_uranus,6305247,4,7,611,618,0
4_2787547,succumb_jealousy_stimulation_lamb_vulcan_uranus,2787547,4,7,387,394,0
4_3527847,succumb_jealousy_stimulation_flounder_uranus_saturn,3527847,4,7,405,412,0
4_499397,succumb_dread_aesthetics_wonderbread_vulcan_uranus,499397,4,7,262,269,0
4_7299197,succumb_hangover_achievement_wonderbread_vulcan_uranus,7299197,4,7,158,165,0
4_4519547,succumb_hangover_entertainment_wonderbread_vulcan_uranus,4519547,4,7,493,500,0
4_7138897,overcome_boils_stimulation_marzipan_vulcan_uranus,7138897,4,9,608,617,0
4_5757847,overcome_boils_entertainment_flounder_vulcan_uranus,5757847,4,9,774,783,0
4_1192447,overcome_abrasion_love_lemon_vulcan_uranus,1192447,4,9,506,515,0
4_916447,overcome_jealousy_aesthetics_haroset_vulcan_uranus,916447,4,9,464,473,0
4_2055647,overcome_jealousy_lubricity_haroset_uranus_saturn,2055647,4,9,408,417,0
4_6618547,overcome_laceration_aesthetics_beef_saturn_earth,6618547,4,9,692,701,0
4_6375147,overcome_laceration_lubricity_lemon_uranus_saturn,6375147,4,9,613,622,0
4_4523347,overcome_grief_stimulation_lamb_uranus_saturn,4523347,4,9,764,773,0
5_560444,eats_wonderbread_snickers,560444,5,1,0,1,0
4_7630048,noop_fears_hangover_achievement,7630048,4,1,114,115,0
4_1977598,noop_fears_laceration_aesthetics,1977598,4,1,464,465,0
5_2161368,pleasure_expectation,2161368,5,1,86,87,0
4_6846198,succumb_jealousy_love_wonderbread_vulcan_uranus,6846198,4,7,495,502,0
5_804720,craves_jealousy_wonderbread,804720,5,1,96,97,0
4_6151748,succumb_boils_stimulation_beef_uranus_saturn,6151748,4,7,385,392,0
4_3929698,feast_entertainment_marzipan_beef_bavaria_manitoba,3929698,4,7,583,590,0
4_1109948,feast_entertainment_marzipan_beef_pennsylvania_oregon,1109948,4,7,638,645,0
4_382898,feast_entertainment_marzipan_beef_manitoba_pennsylvania,382898,4,7,583,590,0
4_5864098,feast_entertainment_marzipan_cantelope_manitoba_pennsylvania,5864098,4,7,583,590,0
4_1063198,feast_love_tofu_onion_bavaria_manitoba,1063198,4,7,480,487,0
5_2657767,craves_love_onion,2657767,5,1,79,80,0
4_145348,feast_lubricity_marzipan_tofu_bavaria_manitoba,145348,4,7,358,365,0
4_7109798,feast_love_ham_lemon_pennsylvania_oregon,7109798,4,7,435,442,0
4_5137098,feast_entertainment_lamb_haroset_manitoba_pennsylvania,5137098,4,7,538,545,0
4_2951898,overcome_abrasion_love_marzipan_vulcan_uranus,2951898,4,9,519,528,0
4_6515348,overcome_prostatitis_lubricity_marzipan_vulcan_uranus,6515348,4,9,354,363,0
4_1417649,noop_fears_anger_aesthetics,1417649,4,1,628,629,0
5_7159023,pain_depression,7159023,5,1,80,81,0
5_7835272,food_snickers,7835272,5,1,30,31,0
5_7480922,planet_uranus,7480922,5,1,549,550,0
4_4507949,noop_craves_laceration_lobster,4507949,4,1,698,699,0
4_7127799,succumb_laceration_stimulation_tofu_saturn_earth,7127799,4,7,390,397,0
5_7614098,craves_laceration_tofu,7614098,5,1,52,53,0
4_5676699,succumb_abrasion_stimulation_ham_saturn_earth,5676699,4,7,373,380,0
5_55452,craves_abrasion_ham,55452,5,1,34,35,0
4_6179999,succumb_sciatica_learning_wonderbread_uranus_saturn,6179999,4,7,327,334,0
4_423799,succumb_grief_lubricity_haroset_saturn_earth,423799,4,7,586,593,0
4_3578699,feast_entertainment_marzipan_tofu_pennsylvania_oregon,3578699,4,7,638,645,0
4_2486199,overcome_boils_stimulation_lamb_vulcan_uranus,2486199,4,9,601,610,0
4_3867199,overcome_angina_stimulation_lemon_saturn_earth,3867199,4,9,605,614,0
4_6848749,overcome_depression_learning_wonderbread_vulcan_uranus,6848749,4,9,137,146,0
4_7771449,overcome_grief_aesthetics_haroset_vulcan_uranus,7771449,4,9,412,421,0
6_1035485,noop_locale_marzipan_bavaria,1035485,6,79,0,79,0
6_3534048,locale_marzipan_pennsylvania,3534048,6,44,24,68,0
6_2339897,locale_beef_oregon,2339897,6,60,79,139,0
6_6870746,locale_marzipan_oregon,6870746,6,45,58,103,0
6_7514601,locale_marzipan_manitoba,7514601,6,44,3,47,0
6_162853,noop_craves_boils_cantelope,162853,6,178,0,178,0
6_4107482,overcome_boils_love_cantelope_vulcan_uranus,4107482,6,841,0,841,0
6_7122214,overcome_boils_stimulation_cantelope_vulcan_uranus,7122214,6,686,0,686,0
6_4527235,overcome_boils_stimulation_cantelope_saturn_earth,4527235,6,681,0,681,0
6_3291842,overcome_boils_stimulation_cantelope_uranus_saturn,3291842,6,687,0,687,0
6_5811286,overcome_boils_entertainment_cantelope_vulcan_uranus,5811286,6,996,0,996,0
6_4463076,overcome_boils_lubricity_cantelope_vulcan_uranus,4463076,6,608,0,608,0
6_632704,overcome_boils_lubricity_cantelope_uranus_saturn,632704,6,608,0,608,0
6_1578989,overcome_boils_lubricity_cantelope_saturn_earth,1578989,6,609,0,609,0
6_5615149,fears_boils_stimulation,5615149,6,80,44,124,0
6_7185198,craves_boils_ham,7185198,6,33,30,63,0
6_7080594,craves_boils_flounder,7080594,6,56,29,85,0
6_1497644,fears_boils_love,1497644,6,89,52,141,0
6_1403974,craves_boils_tofu,1403974,6,53,51,104,0
6_5962620,fears_boils_aesthetics,5962620,6,144,28,172,0
6_2557270,craves_boils_haroset,2557270,6,51,46,97,0
6_4117151,craves_boils_wonderbread,4117151,6,64,34,98,0
6_4536909,craves_boils_lemon,4536909,6,31,21,52,0
6_5022204,fears_boils_lubricity,5022204,6,66,19,85,0
6_561508,craves_boils_marzipan,561508,6,54,22,76,0
6_3359573,fears_boils_entertainment,3359573,6,106,66,172,0
6_2287124,craves_boils_lamb,2287124,6,58,23,81,0
6_2795581,craves_boils_beef,2795581,6,33,26,59,0
6_6427428,noop_pain_boils,6427428,6,0,0,0,0
6_3990322,succumb_boils_lubricity_marzipan_uranus_saturn,3990322,6,617,0,617,0
6_7820694,succumb_boils_lubricity_marzipan_vulcan_uranus,7820694,6,618,0,618,0
6_1029536,succumb_boils_lubricity_marzipan_saturn_earth,1029536,6,617,0,617,0
6_2827055,succumb_boils_lubricity_wonderbread_uranus_saturn,2827055,6,631,0,631,0
6_5619303,succumb_boils_lubricity_wonderbread_saturn_earth,5619303,6,631,0,631,0
6_4114576,succumb_boils_lubricity_flounder_uranus_saturn,4114576,6,601,0,601,0
6_7944948,succumb_boils_lubricity_flounder_vulcan_uranus,7944948,6,602,0,602,0
6_1092529,succumb_boils_lubricity_flounder_saturn_earth,1092529,6,601,0,601,0
6_2643728,succumb_boils_lubricity_lemon_uranus_saturn,2643728,6,589,0,589,0
6_6474100,succumb_boils_lubricity_lemon_vulcan_uranus,6474100,6,590,0,590,0
6_5087272,succumb_boils_lubricity_lemon_saturn_earth,5087272,6,589,0,589,0
6_2442010,succumb_boils_lubricity_tofu_uranus_saturn,2442010,6,635,0,635,0
6_5774068,succumb_boils_lubricity_tofu_saturn_earth,5774068,6,635,0,635,0
6_3585207,succumb_boils_lubricity_lamb_uranus_saturn,3585207,6,601,0,601,0
6_7415579,succumb_boils_lubricity_lamb_vulcan_uranus,7415579,6,601,0,601,0
6_5372234,succumb_boils_lubricity_lamb_saturn_earth,5372234,6,601,0,601,0
6_7193141,succumb_boils_lubricity_onion_saturn_earth,7193141,6,659,0,659,0
6_3038769,succumb_boils_lubricity_haroset_uranus_saturn,3038769,6,600,0,600,0
6_2557256,succumb_boils_lubricity_haroset_saturn_earth,2557256,6,600,0,600,0
6_1810380,succumb_boils_lubricity_cantelope_uranus_saturn,1810380,6,606,0,606,0
6_5640752,succumb_boils_lubricity_cantelope_vulcan_uranus,5640752,6,606,0,606,0
6_5209032,succumb_boils_lubricity_cantelope_saturn_earth,5209032,6,606,0,606,0
6_1514841,succumb_boils_lubricity_beef_uranus_saturn,1514841,6,604,0,604,0
6_5345213,succumb_boils_lubricity_beef_vulcan_uranus,5345213,6,604,0,604,0
6_5301639,succumb_boils_lubricity_beef_saturn_earth,5301639,6,604,0,604,0
6_6766178,succumb_boils_lubricity_ham_uranus_saturn,6766178,6,604,0,604,0
6_2595573,succumb_boils_lubricity_ham_vulcan_uranus,2595573,6,605,0,605,0
6_7541173,succumb_boils_lubricity_ham_saturn_earth,7541173,6,604,0,604,0
6_3290796,succumb_boils_lubricity_lobster_saturn_earth,3290796,6,1193,0,1193,0
6_980395,succumb_boils_aesthetics_ham_saturn_earth,980395,6,1189,0,1189,0
6_6427130,succumb_boils_aesthetics_flounder_uranus_saturn,6427130,6,1183,0,1183,0
6_6789757,succumb_boils_aesthetics_flounder_saturn_earth,6789757,6,1183,0,1183,0
6_941202,succumb_boils_aesthetics_lamb_uranus_saturn,941202,6,1184,0,1184,0
6_6018236,succumb_boils_aesthetics_lamb_saturn_earth,6018236,6,1184,0,1184,0
6_5947641,succumb_boils_aesthetics_beef_saturn_earth,5947641,6,1189,0,1189,0
6_5597281,succumb_boils_entertainment_marzipan_vulcan_uranus,5597281,6,1006,0,1006,0
6_5992053,succumb_boils_entertainment_lamb_vulcan_uranus,5992053,6,954,0,954,0
6_777291,succumb_boils_entertainment_ham_vulcan_uranus,777291,6,954,0,954,0
6_2095409,succumb_boils_entertainment_lemon_vulcan_uranus,2095409,6,994,0,994,0
6_3921687,succumb_boils_entertainment_beef_vulcan_uranus,3921687,6,954,0,954,0
6_5721535,succumb_boils_entertainment_flounder_vulcan_uranus,5721535,6,954,0,954,0
6_3478767,succumb_boils_love_cantelope_vulcan_uranus,3478767,6,838,0,838,0
6_5599967,succumb_boils_love_lamb_vulcan_uranus,5599967,6,838,0,838,0
6_5734094,succumb_boils_love_lemon_vulcan_uranus,5734094,6,835,0,835,0
6_3529601,succumb_boils_love_beef_vulcan_uranus,3529601,6,838,0,838,0
6_6463954,succumb_boils_love_ham_vulcan_uranus,6463954,6,838,0,838,0
6_3342953,succumb_boils_love_marzipan_vulcan_uranus,3342953,6,845,0,845,0
6_3467207,succumb_boils_love_flounder_vulcan_uranus,3467207,6,835,0,835,0
6_756455,succumb_boils_stimulation_marzipan_uranus_saturn,756455,6,696,0,696,0
6_3861001,succumb_boils_stimulation_marzipan_saturn_earth,3861001,6,696,0,696,0
6_4586827,succumb_boils_stimulation_marzipan_vulcan_uranus,4586827,6,696,0,696,0
6_221137,succumb_boils_stimulation_lamb_uranus_saturn,221137,6,674,0,674,0
6_5546616,succumb_boils_stimulation_lamb_saturn_earth,5546616,6,674,0,674,0
6_4051509,succumb_boils_stimulation_lamb_vulcan_uranus,4051509,6,674,0,674,0
6_880709,succumb_boils_stimulation_flounder_uranus_saturn,880709,6,685,0,685,0
6_3923994,succumb_boils_stimulation_flounder_saturn_earth,3923994,6,676,0,676,0
6_4711081,succumb_boils_stimulation_flounder_vulcan_uranus,4711081,6,685,0,685,0
6_6042036,succumb_boils_stimulation_cantelope_uranus_saturn,6042036,6,684,0,684,0
6_1975165,succumb_boils_stimulation_cantelope_saturn_earth,1975165,6,684,0,684,0
6_6151748,succumb_boils_stimulation_beef_uranus_saturn,6151748,6,683,0,683,0
6_5476021,succumb_boils_stimulation_beef_saturn_earth,5476021,6,683,0,683,0
6_1981143,succumb_boils_stimulation_beef_vulcan_uranus,1981143,6,683,0,683,0
6_6940560,succumb_boils_stimulation_ham_uranus_saturn,6940560,6,685,0,685,0
6_1103568,succumb_boils_stimulation_ham_saturn_earth,1103568,6,676,0,676,0
6_5547324,succumb_boils_stimulation_lemon_uranus_saturn,5547324,6,681,0,681,0
6_1723202,succumb_boils_stimulation_lemon_saturn_earth,1723202,6,681,0,681,0
6_1376719,succumb_boils_stimulation_lemon_vulcan_uranus,1376719,6,681,0,681,0
6_6544850,overcome_boils_love_wonderbread_vulcan_uranus,6544850,6,1174,0,1174,0
6_3501678,overcome_boils_love_marzipan_vulcan_uranus,3501678,6,1110,0,1110,0
6_5027470,overcome_boils_love_lemon_vulcan_uranus,5027470,6,823,0,823,0
6_4101934,overcome_boils_love_haroset_vulcan_uranus,4101934,6,822,0,822,0
6_6454254,overcome_boils_love_tofu_vulcan_uranus,6454254,6,1200,0,1200,0
6_7597451,overcome_boils_love_lamb_vulcan_uranus,7597451,6,1133,0,1133,0
6_5527085,overcome_boils_love_beef_vulcan_uranus,5527085,6,840,0,840,0
6_3625932,overcome_boils_love_flounder_vulcan_uranus,3625932,6,1128,0,1128,0
6_7096833,overcome_boils_love_ham_vulcan_uranus,7096833,6,840,0,840,0
6_4293092,overcome_boils_expectation_wonderbread_uranus_saturn,4293092,6,732,0,732,0
6_468150,overcome_boils_expectation_wonderbread_saturn_earth,468150,6,733,0,733,0
6_122487,overcome_boils_expectation_wonderbread_vulcan_uranus,122487,6,731,0,731,0
6_1824168,overcome_boils_learning_wonderbread_vulcan_uranus,1824168,6,753,0,753,0
6_5994773,overcome_boils_learning_wonderbread_uranus_saturn,5994773,6,754,0,754,0
6_5444154,overcome_boils_learning_wonderbread_saturn_earth,5444154,6,755,0,755,0
6_1606743,overcome_boils_achievement_wonderbread_vulcan_uranus,1606743,6,663,0,663,0
6_5777348,overcome_boils_achievement_wonderbread_uranus_saturn,5777348,6,664,0,664,0
6_3895164,overcome_boils_stimulation_wonderbread_vulcan_uranus,3895164,6,1090,0,1090,0
6_826679,overcome_boils_stimulation_wonderbread_saturn_earth,826679,6,1078,0,1078,0
6_64792,overcome_boils_stimulation_wonderbread_uranus_saturn,64792,6,1090,0,1090,0
6_7138897,overcome_boils_stimulation_marzipan_vulcan_uranus,7138897,6,1007,0,1007,0
6_2683325,overcome_boils_stimulation_marzipan_saturn_earth,2683325,6,1008,0,1008,0
6_3308525,overcome_boils_stimulation_marzipan_uranus_saturn,3308525,6,1007,0,1007,0
6_706209,overcome_boils_stimulation_lemon_vulcan_uranus,706209,6,683,0,683,0
6_157892,overcome_boils_stimulation_lemon_saturn_earth,157892,6,684,0,684,0
6_4876814,overcome_boils_stimulation_lemon_uranus_saturn,4876814,6,683,0,683,0
6_521953,overcome_boils_stimulation_haroset_vulcan_uranus,521953,6,1066,0,1066,0
6_6157905,overcome_boils_stimulation_haroset_saturn_earth,6157905,6,1055,0,1055,0
6_4692558,overcome_boils_stimulation_haroset_uranus_saturn,4692558,6,1055,0,1055,0
6_1343002,overcome_boils_stimulation_tofu_vulcan_uranus,1343002,6,1098,0,1098,0
6_6879950,overcome_boils_stimulation_tofu_saturn_earth,6879950,6,1095,0,1095,0
6_5513607,overcome_boils_stimulation_tofu_uranus_saturn,5513607,6,1098,0,1098,0
6_2486199,overcome_boils_stimulation_lamb_vulcan_uranus,2486199,6,1002,0,1002,0
6_6478116,overcome_boils_stimulation_lamb_saturn_earth,6478116,6,1002,0,1002,0
6_6656804,overcome_boils_stimulation_lamb_uranus_saturn,6656804,6,1002,0,1002,0
6_415833,overcome_boils_stimulation_beef_vulcan_uranus,415833,6,685,0,685,0
6_6407521,overcome_boils_stimulation_beef_saturn_earth,6407521,6,685,0,685,0
6_4586438,overcome_boils_stimulation_beef_uranus_saturn,4586438,6,685,0,685,0
6_7263151,overcome_boils_stimulation_flounder_vulcan_uranus,7263151,6,1012,0,1012,0
6_2746318,overcome_boils_stimulation_flounder_saturn_earth,2746318,6,1005,0,1005,0
6_3432779,overcome_boils_stimulation_flounder_uranus_saturn,3432779,6,1004,0,1004,0
6_3701455,overcome_boils_stimulation_ham_vulcan_uranus,3701455,6,687,0,687,0
6_1732283,overcome_boils_stimulation_ham_saturn_earth,1732283,6,663,0,663,0
6_7872060,overcome_boils_stimulation_ham_uranus_saturn,7872060,6,678,0,678,0
6_5408782,overcome_boils_entertainment_wonderbread_vulcan_uranus,5408782,6,1050,0,1050,0
6_5633593,overcome_boils_entertainment_marzipan_vulcan_uranus,5633593,6,1254,0,1254,0
6_917733,overcome_boils_entertainment_lemon_vulcan_uranus,917733,6,996,0,996,0
6_5266653,overcome_boils_entertainment_haroset_vulcan_uranus,5266653,6,1022,0,1022,0
6_1218813,overcome_boils_entertainment_tofu_vulcan_uranus,1218813,6,1333,0,1333,0
6_2362010,overcome_boils_entertainment_lamb_vulcan_uranus,2362010,6,1232,0,1232,0
6_291644,overcome_boils_entertainment_beef_vulcan_uranus,291644,6,949,0,949,0
6_5757847,overcome_boils_entertainment_flounder_vulcan_uranus,5757847,6,1230,0,1230,0
6_106781,overcome_boils_entertainment_ham_vulcan_uranus,106781,6,949,0,949,0
6_3901719,overcome_boils_aesthetics_wonderbread_saturn_earth,3901719,6,930,0,930,0
6_7009658,overcome_boils_aesthetics_wonderbread_vulcan_uranus,7009658,6,930,0,930,0
6_3179286,overcome_boils_aesthetics_wonderbread_uranus_saturn,3179286,6,930,0,930,0
6_3096721,overcome_boils_aesthetics_marzipan_saturn_earth,3096721,6,1357,0,1357,0
6_3374767,overcome_boils_aesthetics_lemon_saturn_earth,3374767,6,1105,0,1105,0
6_1533955,overcome_boils_aesthetics_haroset_saturn_earth,1533955,6,1115,0,1115,0
6_935349,overcome_boils_aesthetics_haroset_vulcan_uranus,935349,6,1120,0,1120,0
6_5105954,overcome_boils_aesthetics_haroset_uranus_saturn,5105954,6,1114,0,1114,0
6_6646951,overcome_boils_aesthetics_lamb_saturn_earth,6646951,6,1299,0,1299,0
6_5703074,overcome_boils_aesthetics_lamb_vulcan_uranus,5703074,6,1311,0,1311,0
6_1872702,overcome_boils_aesthetics_lamb_uranus_saturn,1872702,6,1304,0,1304,0
6_6576356,overcome_boils_aesthetics_beef_saturn_earth,6576356,6,1106,0,1106,0
6_7803313,overcome_boils_aesthetics_beef_uranus_saturn,7803313,6,1105,0,1105,0
6_3159714,overcome_boils_aesthetics_flounder_saturn_earth,3159714,6,1297,0,1297,0
6_1078849,overcome_boils_aesthetics_flounder_vulcan_uranus,1078849,6,1308,0,1308,0
6_5249454,overcome_boils_aesthetics_flounder_uranus_saturn,5249454,6,1301,0,1301,0
6_1139120,overcome_boils_aesthetics_ham_saturn_earth,1139120,6,1107,0,1107,0
6_39918,overcome_boils_aesthetics_ham_uranus_saturn,39918,6,1105,0,1105,0
6_170396,overcome_boils_lubricity_wonderbread_saturn_earth,170396,6,638,0,638,0
6_360279,overcome_boils_lubricity_marzipan_uranus_saturn,360279,6,620,0,620,0
6_359026,overcome_boils_lubricity_marzipan_saturn_earth,359026,6,620,0,620,0
6_7405600,overcome_boils_lubricity_lemon_vulcan_uranus,7405600,6,591,0,591,0
6_3575228,overcome_boils_lubricity_lemon_uranus_saturn,3575228,6,591,0,591,0
6_5715987,overcome_boils_lubricity_lemon_saturn_earth,5715987,6,591,0,591,0
6_991946,overcome_boils_lubricity_haroset_saturn_earth,991946,6,605,0,605,0
6_5932793,overcome_boils_lubricity_tofu_saturn_earth,5932793,6,638,0,638,0
6_4213922,overcome_boils_lubricity_lamb_uranus_saturn,4213922,6,606,0,606,0
6_5530959,overcome_boils_lubricity_lamb_saturn_earth,5530959,6,607,0,607,0
6_5973928,overcome_boils_lubricity_beef_vulcan_uranus,5973928,6,606,0,606,0
6_2143556,overcome_boils_lubricity_beef_uranus_saturn,2143556,6,606,0,606,0
6_5460364,overcome_boils_lubricity_beef_saturn_earth,5460364,6,606,0,606,0
6_484533,overcome_boils_lubricity_flounder_uranus_saturn,484533,6,604,0,604,0
6_422019,overcome_boils_lubricity_flounder_saturn_earth,422019,6,605,0,605,0
6_2754298,overcome_boils_lubricity_ham_vulcan_uranus,2754298,6,607,0,607,0
6_6924903,overcome_boils_lubricity_ham_uranus_saturn,6924903,6,607,0,607,0
6_7885585,overcome_boils_lubricity_ham_saturn_earth,7885585,6,607,0,607,0
6_191203,noop_locale_tofu_manitoba,191203,6,43,0,43,0
6_1063198,feast_love_tofu_onion_bavaria_manitoba,1063198,6,764,0,764,0
6_1466434,feast_love_tofu_marzipan_bavaria_manitoba,1466434,6,764,0,764,0
6_3834623,feast_stimulation_tofu_onion_bavaria_manitoba,3834623,6,604,0,604,0
6_7592181,feast_stimulation_tofu_marzipan_bavaria_manitoba,7592181,6,604,0,604,0
6_6721903,feast_entertainment_tofu_onion_bavaria_manitoba,6721903,6,929,0,929,0
6_4728159,feast_entertainment_tofu_marzipan_bavaria_manitoba,4728159,6,929,0,929,0
6_4812954,feast_lubricity_tofu_onion_bavaria_manitoba,4812954,6,576,0,576,0
6_1823234,feast_lubricity_tofu_marzipan_bavaria_manitoba,1823234,6,576,0,576,0
6_3184342,craves_stimulation_onion,3184342,6,37,34,71,0
6_2335886,craves_lubricity_onion,2335886,6,38,41,79,0
6_2657767,craves_love_onion,2657767,6,77,77,154,0
6_2652512,fears_anxiety_lubricity,2652512,6,50,49,99,0
6_4443807,fears_anxiety_stimulation,4443807,6,50,42,92,0
6_4459027,locale_tofu_bavaria,4459027,6,11,3,14,0
6_13203,noop_fears_angina_lubricity,13203,6,348,0,348,0
6_1121570,succumb_angina_lubricity_flounder_uranus_saturn,1121570,6,580,0,580,0
6_4951942,succumb_angina_lubricity_flounder_vulcan_uranus,4951942,6,586,0,586,0
6_1518391,succumb_angina_lubricity_flounder_saturn_earth,1518391,6,571,0,571,0
6_810747,succumb_angina_lubricity_lemon_uranus_saturn,810747,6,582,0,582,0
6_4641119,succumb_angina_lubricity_lemon_vulcan_uranus,4641119,6,589,0,589,0
6_5236381,succumb_angina_lubricity_lemon_saturn_earth,5236381,6,582,0,582,0
6_3734316,succumb_angina_lubricity_lamb_uranus_saturn,3734316,6,579,0,579,0
6_7564688,succumb_angina_lubricity_lamb_vulcan_uranus,7564688,6,586,0,586,0
6_2216181,succumb_angina_lubricity_lamb_saturn_earth,2216181,6,579,0,579,0
6_3464631,succumb_angina_lubricity_haroset_uranus_saturn,3464631,6,578,0,578,0
6_5371763,succumb_angina_lubricity_haroset_saturn_earth,5371763,6,570,0,570,0
6_3610125,succumb_angina_lubricity_ham_uranus_saturn,3610125,6,583,0,583,0
6_7440497,succumb_angina_lubricity_ham_vulcan_uranus,7440497,6,590,0,590,0
6_1684381,succumb_angina_lubricity_ham_saturn_earth,1684381,6,574,0,574,0
6_6105303,succumb_angina_lubricity_lobster_saturn_earth,6105303,6,1170,0,1170,0
6_6505494,craves_angina_ham,6505494,6,26,22,48,0
6_7699444,fears_angina_love,7699444,6,78,48,126,0
6_4341693,craves_lubricity_beef,4341693,6,46,37,83,0
6_6631441,craves_lubricity_cantelope,6631441,6,35,35,70,0
6_4319540,fears_dread_lubricity,4319540,6,45,38,83,0
6_5215288,craves_angina_flounder,5215288,6,32,22,54,0
6_2950086,craves_lubricity_tofu,2950086,6,37,38,75,0
6_5323336,locale_ham_manitoba,5323336,6,120,5,125,0
6_4108876,craves_lubricity_bacon,4108876,6,123,112,235,0
6_223572,fears_angina_aesthetics,223572,6,118,59,177,0
6_4362705,craves_angina_haroset,4362705,6,54,17,71,0
6_4422260,craves_lubricity_marzipan,4422260,6,46,38,84,0
6_597652,fears_angina_stimulation,597652,6,56,25,81,0
6_4947268,craves_lubricity_wonderbread,4947268,6,32,25,57,0
6_2128520,fears_depression_lubricity,2128520,6,50,35,85,0
6_3194470,fears_prostatitis_lubricity,3194470,6,58,28,86,0
6_894524,craves_angina_lemon,894524,6,28,18,46,0
6_828927,fears_angina_entertainment,828927,6,95,60,155,0
6_6847927,fears_loneliness_lubricity,6847927,6,45,34,79,0
6_3222479,fears_hangover_lubricity,3222479,6,50,36,86,0
6_44280,locale_lemon_manitoba,44280,6,48,39,87,0
6_7140002,noop_fears_depression_aesthetics,7140002,6,408,0,408,0
6_274283,succumb_depression_aesthetics_wonderbread_uranus_saturn,274283,6,455,0,455,0
6_4104655,succumb_depression_aesthetics_wonderbread_vulcan_uranus,4104655,6,455,0,455,0
6_1733858,succumb_depression_aesthetics_wonderbread_saturn_earth,1733858,6,455,0,455,0
6_3653896,fears_anger_aesthetics,3653896,6,102,65,167,0
6_908042,craves_aesthetics_haroset,908042,6,65,52,117,0
6_3682892,fears_anxiety_expectation,3682892,6,36,31,67,0
6_4530591,fears_depression_entertainment,4530591,6,70,62,132,0
6_6936290,craves_aesthetics_beef,6936290,6,119,93,212,0
6_582138,craves_sciatica_haroset,582138,6,80,26,106,0
6_3032587,craves_depression_onion,3032587,6,36,20,56,0
6_2799034,locale_bacon_manitoba,2799034,6,40,33,73,0
6_6427833,craves_aesthetics_lamb,6427833,6,98,90,188,0
6_3723475,fears_grief_achievement,3723475,6,75,39,114,0
6_428472,craves_aesthetics_lemon,428472,6,117,112,229,0
6_2410921,craves_aesthetics_marzipan,2410921,6,124,119,243,0
6_7765619,fears_grief_learning,7765619,6,86,45,131,0
6_5283511,fears_grief_expectation,5283511,6,83,42,125,0
6_2767507,fears_abrasion_aesthetics,2767507,6,129,27,156,0
6_1579104,craves_sciatica_lamb,1579104,6,113,104,217,0
6_5508353,craves_sciatica_flounder,5508353,6,114,85,199,0
6_7711852,fears_jealousy_aesthetics,7711852,6,77,29,106,0
6_3557753,fears_grief_aesthetics,3557753,6,56,18,74,0
6_2544554,craves_aesthetics_ham,2544554,6,113,89,202,0
6_7412205,craves_depression_okra,7412205,6,25,13,38,0
6_7179962,fears_depression_love,7179962,6,83,79,162,0
6_3536464,fears_depression_expectation,3536464,6,35,15,50,0
6_4244617,craves_aesthetics_bacon,4244617,6,23,23,46,0
6_4561120,craves_depression_wonderbread,4561120,6,50,21,71,0
6_4107973,fears_laceration_aesthetics,4107973,6,91,23,114,0
6_4700324,craves_depression_snickers,4700324,6,23,16,39,0
6_5623675,fears_dread_entertainment,5623675,6,65,59,124,0
6_1976428,fears_depression_achievement,1976428,6,18,14,32,0
6_7224728,craves_aesthetics_lobster,7224728,6,32,26,58,0
6_4297379,fears_depression_stimulation,4297379,6,47,29,76,0
6_7517629,fears_depression_learning,7517629,6,35,19,54,0
6_3848180,craves_hangover_onion,3848180,6,49,15,64,0
6_929030,craves_aesthetics_flounder,929030,6,94,89,183,0
6_4236582,fears_hangover_entertainment,4236582,6,69,62,131,0
6_3329468,noop_craves_boils_wonderbread,3329468,6,620,0,620,0
6_387999,craves_lubricity_lobster,387999,6,98,88,186,0
6_3190749,craves_lubricity_ham,3190749,6,43,43,86,0
6_5529098,fears_jealousy_lubricity,5529098,6,72,41,113,0
6_1606144,fears_grief_lubricity,1606144,6,82,49,131,0
6_2072290,craves_lubricity_haroset,2072290,6,35,33,68,0
6_3833236,craves_lubricity_lamb,3833236,6,40,32,72,0
6_5233736,fears_laceration_lubricity,5233736,6,78,42,120,0
6_6638384,fears_anger_lubricity,6638384,6,53,43,96,0
6_292731,craves_lubricity_lemon,292731,6,38,34,72,0
6_6292230,harmony_lubricity_saturn,6292230,6,277,101,378,0
6_3862428,harmony_lubricity_vulcan,3862428,6,118,36,154,0
6_7367121,harmony_lubricity_uranus,7367121,6,232,69,301,0
6_2940369,craves_lubricity_flounder,2940369,6,38,34,72,0
6_4553354,fears_sciatica_lubricity,4553354,6,67,34,101,0
6_2249450,fears_angina_lubricity,2249450,6,52,8,60,0
6_2399100,craves_boils_cantelope,2399100,6,28,7,35,0
6_3939551,noop_craves_laceration_wonderbread,3939551,6,630,0,630,0
6_3236184,overcome_laceration_love_wonderbread_vulcan_uranus,3236184,6,1169,0,1169,0
6_6496945,overcome_laceration_expectation_wonderbread_uranus_saturn,6496945,6,742,0,742,0
6_6571253,overcome_laceration_expectation_wonderbread_saturn_earth,6571253,6,743,0,743,0
6_2326340,overcome_laceration_expectation_wonderbread_vulcan_uranus,2326340,6,741,0,741,0
6_5541634,overcome_laceration_learning_wonderbread_vulcan_uranus,5541634,6,763,0,763,0
6_1711262,overcome_laceration_learning_wonderbread_uranus_saturn,1711262,6,764,0,764,0
6_3645954,overcome_laceration_learning_wonderbread_saturn_earth,3645954,6,765,0,765,0
6_3810596,overcome_laceration_achievement_wonderbread_vulcan_uranus,3810596,6,673,0,673,0
6_7981201,overcome_laceration_achievement_wonderbread_uranus_saturn,7981201,6,674,0,674,0
6_6929782,overcome_laceration_stimulation_wonderbread_saturn_earth,6929782,6,648,0,648,0
6_3482186,overcome_laceration_entertainment_wonderbread_vulcan_uranus,3482186,6,1050,0,1050,0
6_3456752,overcome_laceration_aesthetics_wonderbread_saturn_earth,3456752,6,938,0,938,0
6_5111784,overcome_laceration_aesthetics_wonderbread_vulcan_uranus,5111784,6,938,0,938,0
6_1281412,overcome_laceration_aesthetics_wonderbread_uranus_saturn,1281412,6,938,0,938,0
6_3462266,overcome_laceration_lubricity_wonderbread_vulcan_uranus,3462266,6,1108,0,1108,0
6_7632871,overcome_laceration_lubricity_wonderbread_uranus_saturn,7632871,6,1104,0,1104,0
6_3887862,overcome_laceration_lubricity_wonderbread_saturn_earth,3887862,6,1094,0,1094,0
6_7614098,craves_laceration_tofu,7614098,6,55,31,86,0
6_4834197,craves_laceration_cantelope,4834197,6,53,28,81,0
6_1586642,fears_loneliness_stimulation,1586642,6,44,30,74,0
6_6011242,craves_stimulation_lobster,6011242,6,97,95,192,0
6_5255941,locale_lamb_bosnia,5255941,6,56,52,108,0
6_808089,craves_laceration_flounder,808089,6,61,29,90,0
6_5789489,harmony_stimulation_vulcan,5789489,6,127,42,169,0
6_1141187,craves_stimulation_lemon,1141187,6,38,28,66,0
6_1447385,craves_stimulation_ham,1447385,6,40,33,73,0
6_7695533,craves_stimulation_haroset,7695533,6,39,23,62,0
6_4957332,craves_stimulation_bacon,4957332,6,110,110,220,0
6_2289980,craves_laceration_marzipan,2289980,6,37,26,63,0
6_2134230,craves_laceration_lemon,2134230,6,35,25,60,0
6_1449880,fears_dread_stimulation,1449880,6,42,29,71,0
6_5363829,fears_jealousy_stimulation,5363829,6,82,42,124,0
6_1004728,craves_laceration_beef,1004728,6,35,25,60,0
6_6044426,fears_grief_stimulation,6044426,6,86,47,133,0
6_5591775,fears_laceration_entertainment,5591775,6,72,53,125,0
6_5950375,craves_laceration_bacon,5950375,6,131,129,260,0
6_6130372,craves_laceration_lobster,6130372,6,117,45,162,0
6_2833922,craves_laceration_ham,2833922,6,54,26,80,0
6_496271,craves_laceration_lamb,496271,6,37,24,61,0
6_6095221,craves_stimulation_beef,6095221,6,48,26,74,0
6_6484069,craves_stimulation_cantelope,6484069,6,35,24,59,0
6_2314717,craves_stimulation_flounder,2314717,6,39,27,66,0
6_5586764,craves_stimulation_lamb,5586764,6,42,25,67,0
6_218314,harmony_stimulation_saturn,218314,6,298,52,350,0
6_4703614,craves_stimulation_tofu,4703614,6,38,30,68,0
6_7814663,craves_laceration_haroset,7814663,6,37,22,59,0
6_2883160,fears_laceration_stimulation,2883160,6,73,32,105,0
6_3796608,craves_stimulation_marzipan,3796608,6,46,31,77,0
6_1239506,fears_hangover_stimulation,1239506,6,47,14,61,0
6_1293205,harmony_stimulation_uranus,1293205,6,256,25,281,0
6_3246453,fears_laceration_love,3246453,6,58,39,97,0
6_6654103,fears_anger_stimulation,6654103,6,55,29,84,0
6_55452,craves_abrasion_ham,55452,6,58,9,67,0
6_5888813,noop_harmony_learning_uranus,5888813,6,86,0,86,0
6_7386165,succumb_grief_learning_wonderbread_uranus_saturn,7386165,6,829,0,829,0
6_2530816,succumb_hangover_learning_wonderbread_uranus_saturn,2530816,6,194,0,194,0
6_1683363,succumb_hangover_learning_okra_uranus_saturn,1683363,6,197,0,197,0
6_3174623,succumb_hangover_learning_onion_uranus_saturn,3174623,6,190,0,190,0
6_3306552,succumb_hangover_learning_snickers_uranus_saturn,3306552,6,173,0,173,0
6_6179999,succumb_sciatica_learning_wonderbread_uranus_saturn,6179999,6,487,0,487,0
6_7142696,succumb_depression_learning_wonderbread_uranus_saturn,7142696,6,194,0,194,0
6_5020674,succumb_depression_learning_okra_uranus_saturn,5020674,6,197,0,197,0
6_1421700,succumb_depression_learning_onion_uranus_saturn,1421700,6,196,0,196,0
6_2660153,succumb_depression_learning_snickers_uranus_saturn,2660153,6,173,0,173,0
6_2733167,succumb_dread_learning_wonderbread_uranus_saturn,2733167,6,178,0,178,0
6_1886754,succumb_anxiety_learning_onion_uranus_saturn,1886754,6,146,0,146,0
6_3304289,overcome_sciatica_learning_wonderbread_vulcan_uranus,3304289,6,353,0,353,0
6_4151816,overcome_anxiety_learning_onion_vulcan_uranus,4151816,6,147,0,147,0
6_6481182,overcome_abrasion_learning_wonderbread_vulcan_uranus,6481182,6,315,0,315,0
6_5221003,overcome_depression_learning_okra_vulcan_uranus,5221003,6,199,0,199,0
6_6848749,overcome_depression_learning_wonderbread_vulcan_uranus,6848749,6,196,0,196,0
6_6526837,overcome_depression_learning_snickers_vulcan_uranus,6526837,6,175,0,175,0
6_4074396,overcome_depression_learning_onion_vulcan_uranus,4074396,6,198,0,198,0
6_3948425,overcome_hangover_learning_okra_vulcan_uranus,3948425,6,199,0,199,0
6_7656083,overcome_hangover_learning_wonderbread_vulcan_uranus,7656083,6,196,0,196,0
6_1688017,overcome_hangover_learning_snickers_vulcan_uranus,1688017,6,175,0,175,0
6_6563703,overcome_prostatitis_learning_wonderbread_vulcan_uranus,6563703,6,260,0,260,0
6_1114632,overcome_dread_learning_wonderbread_vulcan_uranus,1114632,6,180,0,180,0
6_3214131,overcome_jealousy_learning_wonderbread_vulcan_uranus,3214131,6,927,0,927,0
6_5767630,overcome_grief_learning_wonderbread_vulcan_uranus,5767630,6,631,0,631,0
6_6793985,harmony_learning_vulcan,6793985,6,31,13,44,0
6_2299014,harmony_learning_earth,2299014,6,32,14,46,0
6_1222810,harmony_learning_saturn,1222810,6,59,7,66,0
6_1108354,noop_craves_loneliness_tofu,1108354,6,22,0,22,0
6_4972740,overcome_loneliness_love_tofu_vulcan_uranus,4972740,6,755,0,755,0
6_7993392,overcome_loneliness_stimulation_tofu_vulcan_uranus,7993392,6,601,0,601,0
6_5218222,overcome_loneliness_stimulation_tofu_saturn_earth,5218222,6,596,0,596,0
6_4163020,overcome_loneliness_stimulation_tofu_uranus_saturn,4163020,6,602,0,602,0
6_3957732,overcome_loneliness_entertainment_tofu_vulcan_uranus,3957732,6,914,0,914,0
6_7894728,overcome_loneliness_lubricity_tofu_vulcan_uranus,7894728,6,580,0,580,0
6_4064356,overcome_loneliness_lubricity_tofu_uranus_saturn,4064356,6,574,0,574,0
6_4467745,overcome_loneliness_lubricity_tofu_saturn_earth,4467745,6,568,0,568,0
6_6977933,fears_loneliness_love,6977933,6,75,79,154,0
6_4708754,noop_eats_cantelope_lemon,4708754,6,0,0,0,0
6_923989,noop_eats_ham_lemon,923989,6,0,0,0,0
6_3351501,feast_aesthetics_ham_lemon_pennsylvania_oregon,3351501,6,1002,0,1002,0
6_2997853,feast_aesthetics_ham_lemon_oregon_goias,2997853,6,1002,0,1002,0
6_5459904,feast_aesthetics_ham_lemon_goias_bosnia,5459904,6,1002,0,1002,0
6_4862586,feast_aesthetics_ham_lemon_manitoba_pennsylvania,4862586,6,1002,0,1002,0
6_7109798,feast_love_ham_lemon_pennsylvania_oregon,7109798,6,725,0,725,0
6_4932716,feast_love_ham_lemon_oregon_goias,4932716,6,725,0,725,0
6_7394767,feast_love_ham_lemon_goias_bosnia,7394767,6,725,0,725,0
6_6538810,feast_love_ham_lemon_manitoba_pennsylvania,6538810,6,725,0,725,0
6_5039721,feast_stimulation_ham_lemon_pennsylvania_oregon,5039721,6,564,0,564,0
6_2625063,feast_stimulation_ham_lemon_oregon_goias,2625063,6,564,0,564,0
6_5087114,feast_stimulation_ham_lemon_goias_bosnia,5087114,6,564,0,564,0
6_6538550,feast_stimulation_ham_lemon_manitoba_pennsylvania,6538550,6,564,0,564,0
6_2715751,feast_entertainment_ham_lemon_pennsylvania_oregon,2715751,6,839,0,839,0
6_1601758,feast_entertainment_ham_lemon_oregon_goias,1601758,6,839,0,839,0
6_4063809,feast_entertainment_ham_lemon_goias_bosnia,4063809,6,839,0,839,0
6_1437825,feast_entertainment_ham_lemon_manitoba_pennsylvania,1437825,6,839,0,839,0
6_1110459,feast_lubricity_ham_lemon_pennsylvania_oregon,1110459,6,557,0,557,0
6_3134141,feast_lubricity_ham_lemon_oregon_goias,3134141,6,557,0,557,0
6_5596192,feast_lubricity_ham_lemon_goias_bosnia,5596192,6,557,0,557,0
6_1867886,feast_lubricity_ham_lemon_manitoba_pennsylvania,1867886,6,557,0,557,0
6_2304645,feast_lubricity_ham_lemon_bavaria_manitoba,2304645,6,1247,0,1247,0
6_7435781,noop_eats_haroset_lobster,7435781,6,0,0,0,0
6_7068455,feast_stimulation_haroset_lobster_bavaria_manitoba,7068455,6,1119,0,1119,0
6_7135015,feast_love_haroset_lobster_bavaria_manitoba,7135015,6,709,0,709,0
6_3524044,feast_lubricity_haroset_lobster_bavaria_manitoba,3524044,6,1109,0,1109,0
6_2073452,feast_aesthetics_haroset_lobster_bavaria_manitoba,2073452,6,883,0,883,0
6_5442106,feast_entertainment_haroset_lobster_bavaria_manitoba,5442106,6,800,0,800,0
6_5861162,noop_orbits_saturn_earth,5861162,6,0,0,0,0
6_4069667,succumb_jealousy_aesthetics_ham_saturn_earth,4069667,6,1060,0,1060,0
6_3712289,succumb_jealousy_aesthetics_bacon_saturn_earth,3712289,6,631,0,631,0
6_7403790,succumb_jealousy_aesthetics_lobster_saturn_earth,7403790,6,643,0,643,0
6_5891006,succumb_jealousy_aesthetics_flounder_saturn_earth,5891006,6,974,0,974,0
6_4775145,succumb_jealousy_aesthetics_lamb_saturn_earth,4775145,6,975,0,975,0
6_4704550,succumb_jealousy_aesthetics_beef_saturn_earth,4704550,6,1060,0,1060,0
6_6670250,succumb_jealousy_aesthetics_haroset_saturn_earth,6670250,6,738,0,738,0
6_5808250,succumb_angina_stimulation_flounder_saturn_earth,5808250,6,609,0,609,0
6_1252677,succumb_angina_stimulation_ham_saturn_earth,1252677,6,609,0,609,0
6_4537709,succumb_angina_stimulation_lemon_saturn_earth,4537709,6,618,0,618,0
6_3004630,succumb_anger_stimulation_flounder_saturn_earth,3004630,6,613,0,613,0
6_1908395,succumb_anger_stimulation_haroset_saturn_earth,1908395,6,614,0,614,0
6_4810109,succumb_anger_stimulation_ham_saturn_earth,4810109,6,614,0,614,0
6_3932458,succumb_anger_stimulation_lemon_saturn_earth,3932458,6,623,0,623,0
6_3135932,succumb_grief_aesthetics_ham_saturn_earth,3135932,6,988,0,988,0
6_1927425,succumb_grief_aesthetics_bacon_saturn_earth,1927425,6,464,0,464,0
6_839449,succumb_grief_aesthetics_lobster_saturn_earth,839449,6,482,0,482,0
6_5624880,succumb_grief_aesthetics_flounder_saturn_earth,5624880,6,938,0,938,0
6_54106,succumb_grief_aesthetics_wonderbread_saturn_earth,54106,6,480,0,480,0
6_5768295,succumb_grief_aesthetics_lamb_saturn_earth,5768295,6,939,0,939,0
6_5697700,succumb_grief_aesthetics_beef_saturn_earth,5697700,6,988,0,988,0
6_105909,succumb_grief_aesthetics_haroset_saturn_earth,105909,6,670,0,670,0
6_355622,succumb_sciatica_lubricity_wonderbread_saturn_earth,355622,6,750,0,750,0
6_3771966,succumb_sciatica_lubricity_haroset_saturn_earth,3771966,6,727,0,727,0
6_4505506,succumb_sciatica_lubricity_lobster_saturn_earth,4505506,6,1238,0,1238,0
6_2964786,succumb_dread_achievement_wonderbread_saturn_earth,2964786,6,84,0,84,0
6_6662125,succumb_hangover_stimulation_wonderbread_saturn_earth,6662125,6,631,0,631,0
6_7821209,succumb_hangover_stimulation_onion_saturn_earth,7821209,6,686,0,686,0
6_343821,succumb_anxiety_stimulation_onion_saturn_earth,343821,6,630,0,630,0
6_2590390,succumb_abrasion_aesthetics_lamb_saturn_earth,2590390,6,1104,0,1104,0
6_2519795,succumb_abrasion_aesthetics_beef_saturn_earth,2519795,6,1109,0,1109,0
6_5237174,succumb_hangover_aesthetics_wonderbread_saturn_earth,5237174,6,442,0,442,0
6_5433039,succumb_laceration_stimulation_marzipan_saturn_earth,5433039,6,657,0,657,0
6_7127799,succumb_laceration_stimulation_tofu_saturn_earth,7127799,6,676,0,676,0
6_6725965,succumb_laceration_stimulation_lamb_saturn_earth,6725965,6,635,0,635,0
6_1293775,succumb_laceration_stimulation_wonderbread_saturn_earth,1293775,6,641,0,641,0
6_5496032,succumb_laceration_stimulation_flounder_saturn_earth,5496032,6,646,0,646,0
6_4368043,succumb_laceration_stimulation_cantelope_saturn_earth,4368043,6,646,0,646,0
6_6655370,succumb_laceration_stimulation_beef_saturn_earth,6655370,6,645,0,645,0
6_7061635,succumb_laceration_stimulation_bacon_saturn_earth,7061635,6,1288,0,1288,0
6_2605711,succumb_laceration_stimulation_haroset_saturn_earth,2605711,6,644,0,644,0
6_2952150,succumb_laceration_stimulation_ham_saturn_earth,2952150,6,647,0,647,0
6_7600397,succumb_laceration_stimulation_lemon_saturn_earth,7600397,6,643,0,643,0
6_3339251,succumb_laceration_stimulation_lobster_saturn_earth,3339251,6,1190,0,1190,0
6_1705289,succumb_laceration_stimulation_onion_saturn_earth,1705289,6,700,0,700,0
6_2212255,succumb_anxiety_lubricity_onion_saturn_earth,2212255,6,615,0,615,0
6_5564124,succumb_depression_expectation_wonderbread_saturn_earth,5564124,6,182,0,182,0
6_5779958,succumb_depression_expectation_okra_saturn_earth,5779958,6,181,0,181,0
6_2521913,succumb_depression_expectation_snickers_saturn_earth,2521913,6,184,0,184,0
6_2386476,succumb_depression_expectation_onion_saturn_earth,2386476,6,241,0,241,0
6_1957177,succumb_sciatica_expectation_wonderbread_saturn_earth,1957177,6,462,0,462,0
6_1958866,succumb_dread_expectation_wonderbread_saturn_earth,1958866,6,154,0,154,0
6_2792416,succumb_prostatitis_lubricity_marzipan_saturn_earth,2792416,6,611,0,611,0
6_4606631,succumb_prostatitis_lubricity_wonderbread_saturn_earth,4606631,6,625,0,625,0
6_7561909,succumb_prostatitis_lubricity_lemon_saturn_earth,7561909,6,619,0,619,0
6_5877496,succumb_prostatitis_lubricity_tofu_saturn_earth,5877496,6,629,0,629,0
6_5475662,succumb_prostatitis_lubricity_lamb_saturn_earth,5475662,6,617,0,617,0
6_1666801,succumb_prostatitis_lubricity_onion_saturn_earth,1666801,6,666,0,666,0
6_450623,succumb_prostatitis_lubricity_cantelope_saturn_earth,450623,6,613,0,613,0
6_5405067,succumb_prostatitis_lubricity_beef_saturn_earth,5405067,6,611,0,611,0
6_1318319,succumb_depression_lubricity_wonderbread_saturn_earth,1318319,6,650,0,650,0
6_1747201,succumb_depression_lubricity_onion_saturn_earth,1747201,6,675,0,675,0
6_5825319,succumb_angina_aesthetics_ham_saturn_earth,5825319,6,1035,0,1035,0
6_3796751,succumb_angina_aesthetics_flounder_saturn_earth,3796751,6,1030,0,1030,0
6_3316249,succumb_laceration_aesthetics_lobster_saturn_earth,3316249,6,702,0,702,0
6_7608497,succumb_laceration_aesthetics_flounder_saturn_earth,7608497,6,1020,0,1020,0
6_7866818,succumb_laceration_aesthetics_lamb_saturn_earth,7866818,6,1013,0,1013,0
6_7796223,succumb_laceration_aesthetics_beef_saturn_earth,7796223,6,1102,0,1102,0
6_2582709,succumb_laceration_aesthetics_haroset_saturn_earth,2582709,6,749,0,749,0
6_2500956,succumb_sciatica_aesthetics_ham_saturn_earth,2500956,6,985,0,985,0
6_1221666,succumb_sciatica_aesthetics_bacon_saturn_earth,1221666,6,406,0,406,0
6_1865662,succumb_sciatica_aesthetics_lobster_saturn_earth,1865662,6,429,0,429,0
6_4303167,succumb_sciatica_aesthetics_flounder_saturn_earth,4303167,6,935,0,935,0
6_3313713,succumb_sciatica_aesthetics_wonderbread_saturn_earth,3313713,6,428,0,428,0
6_3233979,succumb_sciatica_aesthetics_lamb_saturn_earth,3233979,6,936,0,936,0
6_3163384,succumb_sciatica_aesthetics_beef_saturn_earth,3163384,6,985,0,985,0
6_1132122,succumb_sciatica_aesthetics_haroset_saturn_earth,1132122,6,656,0,656,0
6_5978109,succumb_abrasion_stimulation_marzipan_saturn_earth,5978109,6,681,0,681,0
6_526367,succumb_abrasion_stimulation_tofu_saturn_earth,526367,6,700,0,700,0
6_124533,succumb_abrasion_stimulation_lamb_saturn_earth,124533,6,659,0,659,0
6_1751860,succumb_abrasion_stimulation_wonderbread_saturn_earth,1751860,6,665,0,665,0
6_6041102,succumb_abrasion_stimulation_flounder_saturn_earth,6041102,6,670,0,670,0
6_7889354,succumb_abrasion_stimulation_cantelope_saturn_earth,7889354,6,670,0,670,0
6_53938,succumb_abrasion_stimulation_beef_saturn_earth,53938,6,669,0,669,0
6_4170531,succumb_abrasion_stimulation_haroset_saturn_earth,4170531,6,668,0,668,0
6_5676699,succumb_abrasion_stimulation_ham_saturn_earth,5676699,6,671,0,671,0
6_5839952,succumb_abrasion_stimulation_lemon_saturn_earth,5839952,6,667,0,667,0
6_4904071,succumb_abrasion_stimulation_lobster_saturn_earth,4904071,6,1218,0,1218,0
6_7945821,succumb_abrasion_stimulation_onion_saturn_earth,7945821,6,723,0,723,0
6_5569536,succumb_grief_stimulation_lamb_saturn_earth,5569536,6,811,0,811,0
6_7958899,succumb_grief_stimulation_wonderbread_saturn_earth,7958899,6,816,0,816,0
6_1751631,succumb_grief_stimulation_flounder_saturn_earth,1751631,6,823,0,823,0
6_7051960,succumb_grief_stimulation_bacon_saturn_earth,7051960,6,1283,0,1283,0
6_622094,succumb_grief_stimulation_haroset_saturn_earth,622094,6,814,0,814,0
6_1355634,succumb_grief_stimulation_lobster_saturn_earth,1355634,6,1213,0,1213,0
6_5586892,succumb_hangover_learning_wonderbread_saturn_earth,5586892,6,194,0,194,0
6_3989637,succumb_hangover_learning_okra_saturn_earth,3989637,6,196,0,196,0
6_119989,succumb_hangover_learning_onion_saturn_earth,119989,6,190,0,190,0
6_7840197,succumb_hangover_learning_snickers_saturn_earth,7840197,6,172,0,172,0
6_6615430,succumb_loneliness_lubricity_marzipan_saturn_earth,6615430,6,585,0,585,0
6_96811,succumb_loneliness_lubricity_tofu_saturn_earth,96811,6,585,0,585,0
6_1992186,succumb_loneliness_lubricity_onion_saturn_earth,1992186,6,610,0,610,0
6_2131973,succumb_sciatica_learning_wonderbread_saturn_earth,2131973,6,486,0,486,0
6_6570044,succumb_depression_achievement_wonderbread_saturn_earth,6570044,6,143,0,143,0
6_2963097,succumb_sciatica_achievement_wonderbread_saturn_earth,2963097,6,392,0,392,0
6_354266,succumb_depression_learning_wonderbread_saturn_earth,354266,6,194,0,194,0
6_2533744,succumb_depression_learning_okra_saturn_earth,2533744,6,196,0,196,0
6_3457300,succumb_depression_learning_onion_saturn_earth,3457300,6,195,0,195,0
6_6306235,succumb_depression_learning_snickers_saturn_earth,6306235,6,172,0,172,0
6_5809078,succumb_jealousy_stimulation_marzipan_saturn_earth,5809078,6,705,0,705,0
6_7354400,succumb_jealousy_stimulation_lamb_saturn_earth,7354400,6,682,0,682,0
6_6443021,succumb_jealousy_stimulation_wonderbread_saturn_earth,6443021,6,691,0,691,0
6_5872071,succumb_jealousy_stimulation_flounder_saturn_earth,5872071,6,684,0,684,0
6_7283805,succumb_jealousy_stimulation_beef_saturn_earth,7283805,6,692,0,692,0
6_7921455,succumb_jealousy_stimulation_bacon_saturn_earth,7921455,6,1292,0,1292,0
6_888220,succumb_jealousy_stimulation_haroset_saturn_earth,888220,6,677,0,677,0
6_7861454,succumb_jealousy_stimulation_ham_saturn_earth,7861454,6,685,0,685,0
6_459240,succumb_jealousy_stimulation_lemon_saturn_earth,459240,6,690,0,690,0
6_1621760,succumb_jealousy_stimulation_lobster_saturn_earth,1621760,6,1191,0,1191,0
6_4707416,succumb_hangover_lubricity_wonderbread_saturn_earth,4707416,6,647,0,647,0
6_3500124,succumb_hangover_lubricity_onion_saturn_earth,3500124,6,672,0,672,0
6_5922653,succumb_depression_stimulation_wonderbread_saturn_earth,5922653,6,634,0,634,0
6_6287247,succumb_depression_stimulation_onion_saturn_earth,6287247,6,689,0,689,0
6_2315706,succumb_sciatica_stimulation_wonderbread_saturn_earth,2315706,6,738,0,738,0
6_2399150,succumb_sciatica_stimulation_bacon_saturn_earth,2399150,6,1297,0,1297,0
6_7301358,succumb_sciatica_stimulation_haroset_saturn_earth,7301358,6,736,0,736,0
6_33921,succumb_sciatica_stimulation_lobster_saturn_earth,33921,6,1217,0,1217,0
6_1032191,succumb_dread_aesthetics_wonderbread_saturn_earth,1032191,6,395,0,395,0
6_6789549,succumb_abrasion_lubricity_marzipan_saturn_earth,6789549,6,664,0,664,0
6_3532515,succumb_abrasion_lubricity_wonderbread_saturn_earth,3532515,6,678,0,678,0
6_6852542,succumb_abrasion_lubricity_flounder_saturn_earth,6852542,6,655,0,655,0
6_1659426,succumb_abrasion_lubricity_lemon_saturn_earth,1659426,6,643,0,643,0
6_6948323,succumb_abrasion_lubricity_tofu_saturn_earth,6948323,6,682,0,682,0
6_6546489,succumb_abrasion_lubricity_lamb_saturn_earth,6546489,6,646,0,646,0
6_3765295,succumb_abrasion_lubricity_onion_saturn_earth,3765295,6,719,0,719,0
6_6674006,succumb_abrasion_lubricity_haroset_saturn_earth,6674006,6,645,0,645,0
6_7592592,succumb_abrasion_lubricity_cantelope_saturn_earth,7592592,6,653,0,653,0
6_6475894,succumb_abrasion_lubricity_beef_saturn_earth,6475894,6,642,0,642,0
6_7407546,succumb_abrasion_lubricity_lobster_saturn_earth,7407546,6,1236,0,1236,0
6_2317395,succumb_dread_stimulation_wonderbread_saturn_earth,2317395,6,591,0,591,0
6_7309516,succumb_hangover_achievement_wonderbread_saturn_earth,7309516,6,131,0,131,0
6_6593675,succumb_anger_lubricity_flounder_saturn_earth,6593675,6,583,0,583,0
6_792836,succumb_anger_lubricity_lemon_saturn_earth,792836,6,594,0,594,0
6_4480352,succumb_anger_lubricity_lamb_saturn_earth,4480352,6,593,0,593,0
6_4766512,succumb_anger_lubricity_haroset_saturn_earth,4766512,6,582,0,582,0
6_5849983,succumb_anger_lubricity_ham_saturn_earth,5849983,6,586,0,586,0
6_5500052,succumb_anger_lubricity_lobster_saturn_earth,5500052,6,1173,0,1173,0
6_1407780,succumb_laceration_lubricity_marzipan_saturn_earth,1407780,6,694,0,694,0
6_1470773,succumb_laceration_lubricity_flounder_saturn_earth,1470773,6,675,0,675,0
6_6935854,succumb_laceration_lubricity_lemon_saturn_earth,6935854,6,672,0,672,0
6_4191810,succumb_laceration_lubricity_lamb_saturn_earth,4191810,6,675,0,675,0
6_433474,succumb_laceration_lubricity_haroset_saturn_earth,433474,6,665,0,665,0
6_4121215,succumb_laceration_lubricity_beef_saturn_earth,4121215,6,671,0,671,0
6_1167014,succumb_laceration_lubricity_lobster_saturn_earth,1167014,6,1245,0,1245,0
6_3618692,succumb_dread_learning_wonderbread_saturn_earth,3618692,6,178,0,178,0
6_1521380,succumb_anxiety_learning_onion_saturn_earth,1521380,6,145,0,145,0
6_4909767,succumb_dread_lubricity_wonderbread_saturn_earth,4909767,6,607,0,607,0
6_6303596,succumb_hangover_expectation_wonderbread_saturn_earth,6303596,6,173,0,173,0
6_6473534,succumb_hangover_expectation_okra_saturn_earth,6473534,6,172,0,172,0
6_7754539,succumb_hangover_expectation_snickers_saturn_earth,7754539,6,175,0,175,0
6_3920438,succumb_hangover_expectation_onion_saturn_earth,3920438,6,241,0,241,0
6_4444027,succumb_anxiety_expectation_onion_saturn_earth,4444027,6,255,0,255,0
6_1856801,succumb_prostatitis_stimulation_marzipan_saturn_earth,1856801,6,639,0,639,0
6_7378339,succumb_prostatitis_stimulation_tofu_saturn_earth,7378339,6,658,0,658,0
6_6976505,succumb_prostatitis_stimulation_lamb_saturn_earth,6976505,6,639,0,639,0
6_2422390,succumb_prostatitis_stimulation_wonderbread_saturn_earth,2422390,6,636,0,636,0
6_962493,succumb_prostatitis_stimulation_cantelope_saturn_earth,962493,6,641,0,641,0
6_6905910,succumb_prostatitis_stimulation_beef_saturn_earth,6905910,6,640,0,640,0
6_7730821,succumb_prostatitis_stimulation_lemon_saturn_earth,7730821,6,640,0,640,0
6_1835713,succumb_prostatitis_stimulation_onion_saturn_earth,1835713,6,681,0,681,0
6_4308527,succumb_loneliness_stimulation_marzipan_saturn_earth,4308527,6,599,0,599,0
6_2666152,succumb_loneliness_stimulation_tofu_saturn_earth,2666152,6,599,0,599,0
6_3663368,succumb_loneliness_stimulation_onion_saturn_earth,3663368,6,624,0,624,0
6_1561788,succumb_grief_lubricity_wonderbread_saturn_earth,1561788,6,834,0,834,0
6_6994950,succumb_grief_lubricity_flounder_saturn_earth,6994950,6,806,0,806,0
6_7527771,succumb_grief_lubricity_lamb_saturn_earth,7527771,6,805,0,805,0
6_423799,succumb_grief_lubricity_haroset_saturn_earth,423799,6,797,0,797,0
6_1157339,succumb_grief_lubricity_lobster_saturn_earth,1157339,6,1234,0,1234,0
6_88513,succumb_anger_aesthetics_ham_saturn_earth,88513,6,1033,0,1033,0
6_6911181,succumb_anger_aesthetics_flounder_saturn_earth,6911181,6,950,0,950,0
6_7705611,succumb_anger_aesthetics_haroset_saturn_earth,7705611,6,952,0,952,0
6_5558314,succumb_jealousy_lubricity_flounder_saturn_earth,5558314,6,676,0,676,0
6_460529,succumb_jealousy_lubricity_lamb_saturn_earth,460529,6,675,0,675,0
6_1293294,succumb_jealousy_lubricity_haroset_saturn_earth,1293294,6,666,0,666,0
6_389934,succumb_jealousy_lubricity_beef_saturn_earth,389934,6,678,0,678,0
6_7803271,succumb_jealousy_lubricity_ham_saturn_earth,7803271,6,679,0,679,0
6_2026834,succumb_jealousy_lubricity_lobster_saturn_earth,2026834,6,1226,0,1226,0
6_5833835,overcome_sciatica_expectation_wonderbread_saturn_earth,5833835,6,328,0,328,0
6_2168285,overcome_sciatica_learning_wonderbread_saturn_earth,2168285,6,352,0,352,0
6_7471426,overcome_sciatica_stimulation_flounder_saturn_earth,7471426,6,1366,0,1366,0
6_1233734,overcome_sciatica_stimulation_lamb_saturn_earth,1233734,6,1363,0,1363,0
6_5284704,overcome_sciatica_stimulation_lobster_saturn_earth,5284704,6,1225,0,1225,0
6_1221474,overcome_sciatica_stimulation_bacon_saturn_earth,1221474,6,1295,0,1295,0
6_4551164,overcome_sciatica_stimulation_haroset_saturn_earth,4551164,6,1040,0,1040,0
6_6192364,overcome_sciatica_stimulation_wonderbread_saturn_earth,6192364,6,726,0,726,0
6_1552973,overcome_sciatica_aesthetics_flounder_saturn_earth,1552973,6,985,0,985,0
6_2563469,overcome_sciatica_aesthetics_lamb_saturn_earth,2563469,6,984,0,984,0
6_4417732,overcome_sciatica_aesthetics_lobster_saturn_earth,4417732,6,431,0,431,0
6_5592600,overcome_sciatica_aesthetics_bacon_saturn_earth,5592600,6,408,0,408,0
6_3684192,overcome_sciatica_aesthetics_haroset_saturn_earth,3684192,6,660,0,660,0
6_6766776,overcome_sciatica_aesthetics_wonderbread_saturn_earth,6766776,6,430,0,430,0
6_2572256,overcome_sciatica_lubricity_flounder_saturn_earth,2572256,6,1372,0,1372,0
6_5327485,overcome_sciatica_lubricity_lamb_saturn_earth,5327485,6,1367,0,1367,0
6_3327830,overcome_sciatica_lubricity_lobster_saturn_earth,3327830,6,1246,0,1246,0
6_1093743,overcome_sciatica_lubricity_bacon_saturn_earth,1093743,6,1324,0,1324,0
6_2594290,overcome_sciatica_lubricity_haroset_saturn_earth,2594290,6,1020,0,1020,0
6_1650517,overcome_sciatica_lubricity_wonderbread_saturn_earth,1650517,6,732,0,732,0
6_813984,overcome_anxiety_expectation_onion_saturn_earth,813984,6,204,0,204,0
6_2452880,overcome_anxiety_learning_onion_saturn_earth,2452880,6,146,0,146,0
6_4714755,overcome_anxiety_stimulation_onion_saturn_earth,4714755,6,628,0,628,0
6_646945,overcome_anxiety_lubricity_onion_saturn_earth,646945,6,614,0,614,0
6_5269989,overcome_abrasion_expectation_wonderbread_saturn_earth,5269989,6,293,0,293,0
6_774273,overcome_abrasion_learning_wonderbread_saturn_earth,774273,6,317,0,317,0
6_5006189,overcome_abrasion_stimulation_ham_saturn_earth,5006189,6,675,0,675,0
6_4662276,overcome_abrasion_stimulation_lemon_saturn_earth,4662276,6,670,0,670,0
6_4897301,overcome_abrasion_stimulation_tofu_saturn_earth,4897301,6,697,0,697,0
6_4495467,overcome_abrasion_stimulation_lamb_saturn_earth,4495467,6,661,0,661,0
6_1183272,overcome_abrasion_stimulation_cantelope_saturn_earth,1183272,6,666,0,666,0
6_4424872,overcome_abrasion_stimulation_beef_saturn_earth,4424872,6,671,0,671,0
6_1420337,overcome_abrasion_stimulation_haroset_saturn_earth,1420337,6,656,0,656,0
6_6014421,overcome_abrasion_stimulation_marzipan_saturn_earth,6014421,6,684,0,684,0
6_5628518,overcome_abrasion_stimulation_wonderbread_saturn_earth,5628518,6,653,0,653,0
6_589340,overcome_abrasion_aesthetics_ham_saturn_earth,589340,6,1439,0,1439,0
6_1392118,overcome_abrasion_aesthetics_lemon_saturn_earth,1392118,6,1110,0,1110,0
6_1919880,overcome_abrasion_aesthetics_lamb_saturn_earth,1919880,6,1015,0,1015,0
6_1849285,overcome_abrasion_aesthetics_beef_saturn_earth,1849285,6,1111,0,1111,0
6_2515571,overcome_abrasion_aesthetics_haroset_saturn_earth,2515571,6,750,0,750,0
6_6360130,overcome_abrasion_aesthetics_marzipan_saturn_earth,6360130,6,1122,0,1122,0
6_3951730,overcome_abrasion_aesthetics_wonderbread_saturn_earth,3951730,6,518,0,518,0
6_2507781,overcome_abrasion_lubricity_ham_saturn_earth,2507781,6,1085,0,1085,0
6_988916,overcome_abrasion_lubricity_lemon_saturn_earth,988916,6,645,0,645,0
6_5383013,overcome_abrasion_lubricity_tofu_saturn_earth,5383013,6,679,0,679,0
6_4981179,overcome_abrasion_lubricity_lamb_saturn_earth,4981179,6,649,0,649,0
6_4842398,overcome_abrasion_lubricity_cantelope_saturn_earth,4842398,6,655,0,655,0
6_4910584,overcome_abrasion_lubricity_beef_saturn_earth,4910584,6,644,0,644,0
6_5496330,overcome_abrasion_lubricity_haroset_saturn_earth,5496330,6,622,0,622,0
6_1340642,overcome_abrasion_lubricity_marzipan_saturn_earth,1340642,6,667,0,667,0
6_4827410,overcome_abrasion_lubricity_wonderbread_saturn_earth,4827410,6,668,0,668,0
6_331051,overcome_depression_expectation_okra_saturn_earth,331051,6,183,0,183,0
6_3199154,overcome_depression_expectation_wonderbread_saturn_earth,3199154,6,185,0,185,0
6_5974976,overcome_depression_expectation_snickers_saturn_earth,5974976,6,186,0,186,0
6_7637259,overcome_depression_expectation_onion_saturn_earth,7637259,6,244,0,244,0
6_1863234,overcome_depression_learning_okra_saturn_earth,1863234,6,198,0,198,0
6_3807329,overcome_depression_learning_wonderbread_saturn_earth,3807329,6,197,0,197,0
6_3556041,overcome_depression_learning_snickers_saturn_earth,3556041,6,174,0,174,0
6_7828234,overcome_depression_learning_onion_saturn_earth,7828234,6,197,0,197,0
6_3557683,overcome_depression_stimulation_wonderbread_saturn_earth,3557683,6,631,0,631,0
6_3537053,overcome_depression_stimulation_onion_saturn_earth,3537053,6,747,0,747,0
6_2037158,overcome_depression_aesthetics_wonderbread_saturn_earth,2037158,6,455,0,455,0
6_5194977,overcome_depression_lubricity_wonderbread_saturn_earth,5194977,6,636,0,636,0
6_569525,overcome_depression_lubricity_onion_saturn_earth,569525,6,733,0,733,0
6_5617266,overcome_angina_stimulation_haroset_saturn_earth,5617266,6,1055,0,1055,0
6_3867199,overcome_angina_stimulation_lemon_saturn_earth,3867199,6,640,0,640,0
6_359343,overcome_angina_stimulation_flounder_saturn_earth,359343,6,631,0,631,0
6_2184177,overcome_angina_stimulation_ham_saturn_earth,2184177,6,595,0,595,0
6_7001261,overcome_angina_aesthetics_haroset_saturn_earth,7001261,6,1100,0,1100,0
6_7045953,overcome_angina_aesthetics_lemon_saturn_earth,7045953,6,1036,0,1036,0
6_2619075,overcome_angina_aesthetics_flounder_saturn_earth,2619075,6,941,0,941,0
6_6454034,overcome_angina_aesthetics_ham_saturn_earth,6454034,6,1038,0,1038,0
6_4701253,overcome_angina_lubricity_haroset_saturn_earth,4701253,6,591,0,591,0
6_6167881,overcome_angina_lubricity_lemon_saturn_earth,6167881,6,569,0,569,0
6_5889325,overcome_angina_lubricity_flounder_saturn_earth,5889325,6,573,0,573,0
6_1843106,overcome_angina_lubricity_ham_saturn_earth,1843106,6,574,0,574,0
6_2843491,overcome_hangover_expectation_okra_saturn_earth,2843491,6,174,0,174,0
6_2179277,overcome_hangover_expectation_wonderbread_saturn_earth,2179277,6,176,0,176,0
6_2742762,overcome_hangover_expectation_onion_saturn_earth,2742762,6,271,0,271,0
6_7790851,overcome_hangover_expectation_snickers_saturn_earth,7790851,6,177,0,177,0
6_4921137,overcome_hangover_learning_okra_saturn_earth,4921137,6,198,0,198,0
6_5623204,overcome_hangover_learning_wonderbread_saturn_earth,5623204,6,197,0,197,0
6_6662521,overcome_hangover_learning_snickers_saturn_earth,6662521,6,174,0,174,0
6_2537806,overcome_hangover_stimulation_wonderbread_saturn_earth,2537806,6,621,0,621,0
6_6643533,overcome_hangover_stimulation_onion_saturn_earth,6643533,6,841,0,841,0
6_689260,overcome_hangover_aesthetics_wonderbread_saturn_earth,689260,6,443,0,443,0
6_6002311,overcome_hangover_lubricity_wonderbread_saturn_earth,6002311,6,626,0,626,0
6_2829614,overcome_hangover_lubricity_onion_saturn_earth,2829614,6,827,0,827,0
6_6279329,overcome_anger_stimulation_haroset_saturn_earth,6279329,6,638,0,638,0
6_1826954,overcome_anger_stimulation_flounder_saturn_earth,1826954,6,615,0,615,0
6_5438824,overcome_anger_stimulation_ham_saturn_earth,5438824,6,628,0,628,0
6_2367148,overcome_anger_stimulation_lemon_saturn_earth,2367148,6,1169,0,1169,0
6_7035101,overcome_anger_aesthetics_haroset_saturn_earth,7035101,6,688,0,688,0
6_3281138,overcome_anger_aesthetics_flounder_saturn_earth,3281138,6,940,0,940,0
6_247238,overcome_anger_aesthetics_ham_saturn_earth,247238,6,1037,0,1037,0
6_3201202,overcome_anger_lubricity_haroset_saturn_earth,3201202,6,567,0,567,0
6_5923165,overcome_anger_lubricity_flounder_saturn_earth,5923165,6,586,0,586,0
6_6194395,overcome_anger_lubricity_ham_saturn_earth,6194395,6,596,0,596,0
6_1421551,overcome_anger_lubricity_lemon_saturn_earth,1421551,6,1173,0,1173,0
6_4705793,overcome_prostatitis_expectation_wonderbread_saturn_earth,4705793,6,238,0,238,0
6_493311,overcome_prostatitis_learning_wonderbread_saturn_earth,493311,6,262,0,262,0
6_4155716,overcome_prostatitis_stimulation_beef_saturn_earth,4155716,6,642,0,642,0
6_5733459,overcome_prostatitis_stimulation_marzipan_saturn_earth,5733459,6,642,0,642,0
6_1265793,overcome_prostatitis_stimulation_cantelope_saturn_earth,1265793,6,637,0,637,0
6_5064322,overcome_prostatitis_stimulation_wonderbread_saturn_earth,5064322,6,624,0,624,0
6_4628145,overcome_prostatitis_stimulation_tofu_saturn_earth,4628145,6,655,0,655,0
6_2973371,overcome_prostatitis_aesthetics_beef_saturn_earth,2973371,6,1078,0,1078,0
6_5421418,overcome_prostatitis_aesthetics_marzipan_saturn_earth,5421418,6,1082,0,1082,0
6_1074175,overcome_prostatitis_aesthetics_wonderbread_saturn_earth,1074175,6,473,0,473,0
6_4227391,overcome_prostatitis_lubricity_beef_saturn_earth,4227391,6,604,0,604,0
6_4087311,overcome_prostatitis_lubricity_marzipan_saturn_earth,4087311,6,614,0,614,0
6_3903686,overcome_prostatitis_lubricity_cantelope_saturn_earth,3903686,6,615,0,615,0
6_4909931,overcome_prostatitis_lubricity_wonderbread_saturn_earth,4909931,6,615,0,615,0
6_4699820,overcome_prostatitis_lubricity_tofu_saturn_earth,4699820,6,626,0,626,0
6_1995178,overcome_dread_expectation_wonderbread_saturn_earth,1995178,6,157,0,157,0
6_2441016,overcome_dread_learning_wonderbread_saturn_earth,2441016,6,181,0,181,0
6_2353707,overcome_dread_stimulation_wonderbread_saturn_earth,2353707,6,577,0,577,0
6_6282974,overcome_dread_aesthetics_wonderbread_saturn_earth,6282974,6,396,0,396,0
6_7461837,overcome_dread_lubricity_wonderbread_saturn_earth,7461837,6,582,0,582,0
6_1960173,overcome_jealousy_expectation_wonderbread_saturn_earth,1960173,6,906,0,906,0
6_605242,overcome_jealousy_learning_wonderbread_saturn_earth,605242,6,929,0,929,0
6_7282541,overcome_jealousy_stimulation_lemon_saturn_earth,7282541,6,1195,0,1195,0
6_5845390,overcome_jealousy_stimulation_marzipan_saturn_earth,5845390,6,1191,0,1191,0
6_7190944,overcome_jealousy_stimulation_ham_saturn_earth,7190944,6,672,0,672,0
6_2318702,overcome_jealousy_stimulation_wonderbread_saturn_earth,2318702,6,1177,0,1177,0
6_6872543,overcome_jealousy_stimulation_lobster_saturn_earth,6872543,6,1193,0,1193,0
6_5908383,overcome_jealousy_stimulation_flounder_saturn_earth,5908383,6,687,0,687,0
6_6743779,overcome_jealousy_stimulation_bacon_saturn_earth,6743779,6,1323,0,1323,0
6_6139003,overcome_jealousy_stimulation_haroset_saturn_earth,6139003,6,679,0,679,0
6_3724357,overcome_jealousy_stimulation_lamb_saturn_earth,3724357,6,684,0,684,0
6_3653762,overcome_jealousy_stimulation_beef_saturn_earth,3653762,6,694,0,694,0
6_2504357,overcome_jealousy_aesthetics_ham_saturn_earth,2504357,6,1065,0,1065,0
6_7689259,overcome_jealousy_aesthetics_wonderbread_saturn_earth,7689259,6,935,0,935,0
6_1954883,overcome_jealousy_aesthetics_lobster_saturn_earth,1954883,6,649,0,649,0
6_3140812,overcome_jealousy_aesthetics_flounder_saturn_earth,3140812,6,972,0,972,0
6_82246,overcome_jealousy_aesthetics_bacon_saturn_earth,82246,6,964,0,964,0
6_1221343,overcome_jealousy_aesthetics_haroset_saturn_earth,1221343,6,741,0,741,0
6_4104635,overcome_jealousy_aesthetics_lamb_saturn_earth,4104635,6,972,0,972,0
6_4034040,overcome_jealousy_aesthetics_beef_saturn_earth,4034040,6,1064,0,1064,0
6_3173671,overcome_jealousy_lubricity_lemon_saturn_earth,3173671,6,1209,0,1209,0
6_46414,overcome_jealousy_lubricity_marzipan_saturn_earth,46414,6,1209,0,1209,0
6_733794,overcome_jealousy_lubricity_ham_saturn_earth,733794,6,729,0,729,0
6_1560359,overcome_jealousy_lubricity_wonderbread_saturn_earth,1560359,6,1203,0,1203,0
6_849158,overcome_jealousy_lubricity_lobster_saturn_earth,849158,6,1230,0,1230,0
6_109407,overcome_jealousy_lubricity_flounder_saturn_earth,109407,6,679,0,679,0
6_115618,overcome_jealousy_lubricity_haroset_saturn_earth,115618,6,651,0,651,0
6_6896196,overcome_jealousy_lubricity_lamb_saturn_earth,6896196,6,678,0,678,0
6_6825601,overcome_jealousy_lubricity_beef_saturn_earth,6825601,6,721,0,721,0
6_3900606,overcome_laceration_stimulation_haroset_saturn_earth,3900606,6,646,0,646,0
6_1277058,overcome_laceration_stimulation_lamb_saturn_earth,1277058,6,637,0,637,0
6_1774474,overcome_laceration_stimulation_ham_saturn_earth,1774474,6,650,0,650,0
6_4634146,overcome_laceration_stimulation_lobster_saturn_earth,4634146,6,1193,0,1193,0
6_4311441,overcome_laceration_stimulation_bacon_saturn_earth,4311441,6,1326,0,1326,0
6_1206463,overcome_laceration_stimulation_beef_saturn_earth,1206463,6,647,0,647,0
6_4850203,overcome_laceration_stimulation_lemon_saturn_earth,4850203,6,646,0,646,0
6_885125,overcome_laceration_stimulation_marzipan_saturn_earth,885125,6,660,0,660,0
6_948118,overcome_laceration_stimulation_flounder_saturn_earth,948118,6,652,0,652,0
6_243724,overcome_laceration_stimulation_cantelope_saturn_earth,243724,6,661,0,661,0
6_1678892,overcome_laceration_stimulation_tofu_saturn_earth,1678892,6,679,0,679,0
6_2619021,overcome_laceration_aesthetics_haroset_saturn_earth,2619021,6,752,0,752,0
6_6689142,overcome_laceration_aesthetics_lamb_saturn_earth,6689142,6,1010,0,1010,0
6_4170905,overcome_laceration_aesthetics_ham_saturn_earth,4170905,6,1412,0,1412,0
6_3352561,overcome_laceration_aesthetics_lobster_saturn_earth,3352561,6,1299,0,1299,0
6_5635924,overcome_laceration_aesthetics_bacon_saturn_earth,5635924,6,1392,0,1392,0
6_6618547,overcome_laceration_aesthetics_beef_saturn_earth,6618547,6,1106,0,1106,0
6_6174686,overcome_laceration_aesthetics_lemon_saturn_earth,6174686,6,1104,0,1104,0
6_839422,overcome_laceration_aesthetics_marzipan_saturn_earth,839422,6,1116,0,1116,0
6_902415,overcome_laceration_aesthetics_flounder_saturn_earth,902415,6,1302,0,1302,0
6_5684257,overcome_laceration_lubricity_haroset_saturn_earth,5684257,6,651,0,651,0
6_561767,overcome_laceration_lubricity_lamb_saturn_earth,561767,6,678,0,678,0
6_3115594,overcome_laceration_lubricity_ham_saturn_earth,3115594,6,1077,0,1077,0
6_491172,overcome_laceration_lubricity_beef_saturn_earth,491172,6,673,0,673,0
6_5758178,overcome_laceration_lubricity_lemon_saturn_earth,5758178,6,716,0,716,0
6_1444092,overcome_laceration_lubricity_marzipan_saturn_earth,1444092,6,747,0,747,0
6_1507085,overcome_laceration_lubricity_flounder_saturn_earth,1507085,6,1028,0,1028,0
6_7322667,overcome_laceration_lubricity_cantelope_saturn_earth,7322667,6,1101,0,1101,0
6_963601,overcome_laceration_lubricity_tofu_saturn_earth,963601,6,1109,0,1109,0
6_7636682,overcome_grief_expectation_wonderbread_saturn_earth,7636682,6,607,0,607,0
6_3271791,overcome_grief_learning_wonderbread_saturn_earth,3271791,6,631,0,631,0
6_573955,overcome_grief_stimulation_flounder_saturn_earth,573955,6,1219,0,1219,0
6_4993028,overcome_grief_stimulation_haroset_saturn_earth,4993028,6,812,0,812,0
6_5486650,overcome_grief_stimulation_bacon_saturn_earth,5486650,6,1281,0,1281,0
6_6501036,overcome_grief_stimulation_lamb_saturn_earth,6501036,6,1202,0,1202,0
6_5726568,overcome_grief_stimulation_lobster_saturn_earth,5726568,6,1215,0,1215,0
6_6430441,overcome_grief_stimulation_beef_saturn_earth,6430441,6,1286,0,1286,0
6_7995211,overcome_grief_stimulation_wonderbread_saturn_earth,7995211,6,951,0,951,0
6_1482342,overcome_grief_stimulation_ham_saturn_earth,1482342,6,1277,0,1277,0
6_1994837,overcome_grief_aesthetics_flounder_saturn_earth,1994837,6,960,0,960,0
6_7436376,overcome_grief_aesthetics_haroset_saturn_earth,7436376,6,673,0,673,0
6_2858925,overcome_grief_aesthetics_bacon_saturn_earth,2858925,6,466,0,466,0
6_6397010,overcome_grief_aesthetics_lamb_saturn_earth,6397010,6,957,0,957,0
6_168939,overcome_grief_aesthetics_lobster_saturn_earth,168939,6,484,0,484,0
6_5304889,overcome_grief_aesthetics_wonderbread_saturn_earth,5304889,6,631,0,631,0
6_6324440,overcome_grief_lubricity_flounder_saturn_earth,6324440,6,1224,0,1224,0
6_6859466,overcome_grief_lubricity_haroset_saturn_earth,6859466,6,780,0,780,0
6_4927284,overcome_grief_lubricity_bacon_saturn_earth,4927284,6,1310,0,1310,0
6_7686496,overcome_grief_lubricity_lamb_saturn_earth,7686496,6,1207,0,1207,0
6_7593006,overcome_grief_lubricity_lobster_saturn_earth,7593006,6,1236,0,1236,0
6_7615901,overcome_grief_lubricity_beef_saturn_earth,7615901,6,1287,0,1287,0
6_4113858,overcome_grief_lubricity_wonderbread_saturn_earth,4113858,6,966,0,966,0
6_5862507,overcome_grief_lubricity_ham_saturn_earth,5862507,6,1292,0,1292,0
6_6726918,noop_locale_marzipan_manitoba,6726918,6,79,0,79,0
6_4549577,feast_stimulation_marzipan_wonderbread_bavaria_manitoba,4549577,6,615,0,615,0
6_5914295,feast_stimulation_marzipan_tofu_bavaria_manitoba,5914295,6,615,0,615,0
6_6793720,feast_stimulation_marzipan_beef_bavaria_manitoba,6793720,6,615,0,615,0
6_2068663,feast_stimulation_marzipan_cantelope_bavaria_manitoba,2068663,6,615,0,615,0
6_3289810,feast_entertainment_marzipan_wonderbread_bavaria_manitoba,3289810,6,906,0,906,0
6_3050273,feast_entertainment_marzipan_tofu_bavaria_manitoba,3050273,6,906,0,906,0
6_3929698,feast_entertainment_marzipan_beef_bavaria_manitoba,3929698,6,906,0,906,0
6_5452724,feast_entertainment_marzipan_cantelope_bavaria_manitoba,5452724,6,906,0,906,0
6_6142471,feast_lubricity_marzipan_wonderbread_bavaria_manitoba,6142471,6,588,0,588,0
6_145348,feast_lubricity_marzipan_tofu_bavaria_manitoba,145348,6,588,0,588,0
6_1024773,feast_lubricity_marzipan_beef_bavaria_manitoba,1024773,6,588,0,588,0
6_2447884,feast_lubricity_marzipan_cantelope_bavaria_manitoba,2447884,6,588,0,588,0
6_331992,feast_aesthetics_marzipan_wonderbread_bavaria_manitoba,331992,6,1024,0,1024,0
6_5782733,feast_aesthetics_marzipan_tofu_bavaria_manitoba,5782733,6,1024,0,1024,0
6_6662158,feast_aesthetics_marzipan_beef_bavaria_manitoba,6662158,6,1024,0,1024,0
6_6916969,feast_aesthetics_marzipan_cantelope_bavaria_manitoba,6916969,6,1024,0,1024,0
6_2484961,feast_love_marzipan_wonderbread_bavaria_manitoba,2484961,6,735,0,735,0
6_7789525,feast_love_marzipan_tofu_bavaria_manitoba,7789525,6,735,0,735,0
6_667973,feast_love_marzipan_beef_bavaria_manitoba,667973,6,735,0,735,0
6_5206710,feast_love_marzipan_cantelope_bavaria_manitoba,5206710,6,735,0,735,0
6_5445350,locale_marzipan_bavaria,5445350,6,24,0,24,0
6_2200813,noop_craves_abrasion_ham,2200813,6,653,0,653,0
6_4483052,overcome_abrasion_love_ham_vulcan_uranus,4483052,6,1208,0,1208,0
6_1088397,overcome_abrasion_entertainment_ham_vulcan_uranus,1088397,6,1315,0,1315,0
6_3313824,overcome_abrasion_aesthetics_ham_uranus_saturn,3313824,6,1436,0,1436,0
6_2204518,overcome_abrasion_lubricity_ham_vulcan_uranus,2204518,6,1091,0,1091,0
6_6375123,overcome_abrasion_lubricity_ham_uranus_saturn,6375123,6,1085,0,1085,0
6_7207743,craves_abrasion_wonderbread,7207743,6,37,37,74,0
6_5866392,fears_prostatitis_stimulation,5866392,6,57,40,97,0
6_666181,craves_abrasion_marzipan,666181,6,31,26,57,0
6_1790580,fears_abrasion_lubricity,1790580,6,71,35,106,0
6_2813229,fears_sciatica_stimulation,2813229,6,70,37,107,0
6_137328,fears_abrasion_entertainment,137328,6,105,62,167,0
6_3765875,fears_abrasion_stimulation,3765875,6,73,43,116,0
6_7670121,fears_abrasion_love,7670121,6,88,41,129,0
6_3955115,craves_stimulation_wonderbread,3955115,6,30,17,47,0
6_2026364,craves_abrasion_haroset,2026364,6,30,22,52,0
6_1803361,craves_abrasion_beef,1803361,6,32,21,53,0
6_5192457,craves_abrasion_cantelope,5192457,6,27,21,48,0
6_1294904,craves_abrasion_lamb,1294904,6,34,19,53,0
6_411754,craves_abrasion_tofu,411754,6,28,21,49,0
6_6559853,craves_abrasion_lemon,6559853,6,30,18,48,0
6_3146901,craves_laceration_wonderbread,3146901,6,63,7,70,0
6_6089429,noop_fears_jealousy_aesthetics,6089429,6,407,0,407,0
6_2691068,succumb_jealousy_aesthetics_bacon_uranus_saturn,2691068,6,631,0,631,0
6_6521440,succumb_jealousy_aesthetics_bacon_vulcan_uranus,6521440,6,631,0,631,0
6_3600038,succumb_jealousy_aesthetics_lobster_uranus_saturn,3600038,6,652,0,652,0
6_7430410,succumb_jealousy_aesthetics_lobster_vulcan_uranus,7430410,6,652,0,652,0
6_374230,succumb_jealousy_aesthetics_flounder_uranus_saturn,374230,6,982,0,982,0
6_2748986,succumb_jealousy_aesthetics_lamb_uranus_saturn,2748986,6,983,0,983,0
6_7837246,succumb_jealousy_aesthetics_haroset_uranus_saturn,7837246,6,747,0,747,0
6_3666641,succumb_jealousy_aesthetics_haroset_vulcan_uranus,3666641,6,746,0,746,0
6_6618897,craves_jealousy_beef,6618897,6,37,29,66,0
6_6863696,fears_jealousy_entertainment,6863696,6,61,50,111,0
6_7423494,craves_entertainment_wonderbread,7423494,6,48,39,87,0
6_6110440,craves_jealousy_lamb,6110440,6,35,29,64,0
6_3033139,craves_entertainment_cantelope,3033139,6,94,89,183,0
6_5357538,craves_entertainment_beef,5357538,6,96,82,178,0
6_3385988,craves_grief_ham,3385988,6,102,94,196,0
6_4317787,craves_entertainment_lemon,4317787,6,92,84,176,0
6_2538387,craves_entertainment_ham,2538387,6,90,88,178,0
6_222734,craves_jealousy_haroset,222734,6,35,27,62,0
6_3965931,craves_entertainment_tofu,3965931,6,98,95,193,0
6_804720,craves_jealousy_wonderbread,804720,6,99,32,131,0
6_2993567,craves_jealousy_marzipan,2993567,6,91,26,117,0
6_6317015,craves_grief_beef,6317015,6,102,92,194,0
6_7186611,craves_jealousy_lemon,7186611,6,89,24,113,0
6_2810155,fears_prostatitis_entertainment,2810155,6,104,59,163,0
6_345208,craves_entertainment_marzipan,345208,6,101,88,189,0
6_1288709,fears_hangover_aesthetics,1288709,6,43,29,72,0
6_2574568,craves_jealousy_ham,2574568,6,37,23,60,0
6_6539420,craves_jealousy_lobster,6539420,6,57,39,96,0
6_1511676,craves_jealousy_flounder,1511676,6,36,25,61,0
6_3001779,craves_jealousy_bacon,3001779,6,102,52,154,0
6_2102130,fears_dread_aesthetics,2102130,6,39,26,65,0
6_4484680,fears_jealousy_love,4484680,6,52,50,102,0
6_658980,craves_aesthetics_wonderbread,658980,6,29,18,47,0
6_1269400,fears_depression_aesthetics,1269400,6,44,12,56,0
6_1903589,noop_food_ham,1903589,6,0,0,0,0
6_5107579,succumb_angina_stimulation_ham_uranus_saturn,5107579,6,618,0,618,0
6_3698793,succumb_anger_stimulation_ham_uranus_saturn,3698793,6,623,0,623,0
6_3314788,succumb_laceration_love_ham_vulcan_uranus,3314788,6,845,0,845,0
6_118932,succumb_laceration_stimulation_ham_uranus_saturn,118932,6,647,0,647,0
6_6679712,succumb_grief_entertainment_ham_vulcan_uranus,6679712,6,890,0,890,0
6_1356325,succumb_abrasion_love_ham_vulcan_uranus,1356325,6,843,0,843,0
6_1518477,succumb_abrasion_stimulation_ham_uranus_saturn,1518477,6,671,0,671,0
6_1203153,succumb_angina_entertainment_ham_vulcan_uranus,1203153,6,882,0,882,0
6_747367,succumb_jealousy_stimulation_ham_uranus_saturn,747367,6,694,0,694,0
6_5324389,succumb_jealousy_love_ham_vulcan_uranus,5324389,6,808,0,808,0
6_5874296,succumb_anger_lubricity_ham_uranus_saturn,5874296,6,595,0,595,0
6_1703691,succumb_anger_lubricity_ham_vulcan_uranus,1703691,6,603,0,603,0
6_1978464,succumb_anger_love_ham_vulcan_uranus,1978464,6,765,0,765,0
6_5531991,succumb_angina_love_ham_vulcan_uranus,5531991,6,765,0,765,0
6_5243076,succumb_jealousy_entertainment_ham_vulcan_uranus,5243076,6,915,0,915,0
6_6278437,succumb_anger_entertainment_ham_vulcan_uranus,6278437,6,881,0,881,0
6_1854473,succumb_jealousy_lubricity_ham_uranus_saturn,1854473,6,688,0,688,0
6_5684845,succumb_jealousy_lubricity_ham_vulcan_uranus,5684845,6,695,0,695,0
6_2355633,feast_aesthetics_ham_flounder_pennsylvania_oregon,2355633,6,1002,0,1002,0
6_7392701,feast_aesthetics_ham_flounder_oregon_goias,7392701,6,1002,0,1002,0
6_1853775,feast_aesthetics_ham_flounder_goias_bosnia,1853775,6,1002,0,1002,0
6_3626727,feast_aesthetics_ham_flounder_manitoba_pennsylvania,3626727,6,1002,0,1002,0
6_4815740,feast_love_lemon_ham_bavaria_manitoba,4815740,6,1111,0,1111,0
6_5027623,feast_stimulation_flounder_ham_bavaria_manitoba,5027623,6,569,0,569,0
6_4704130,feast_stimulation_flounder_ham_pennsylvania_oregon,4704130,6,597,0,597,0
6_7932547,feast_stimulation_flounder_ham_manitoba_pennsylvania,7932547,6,569,0,569,0
6_1098361,feast_lubricity_flounder_ham_bavaria_manitoba,1098361,6,545,0,545,0
6_1159719,feast_lubricity_flounder_ham_pennsylvania_oregon,1159719,6,578,0,578,0
6_5777515,feast_lubricity_flounder_ham_manitoba_pennsylvania,5777515,6,545,0,545,0
6_5563455,feast_aesthetics_lemon_ham_bavaria_manitoba,5563455,6,1366,0,1366,0
6_7417196,feast_love_ham_flounder_pennsylvania_oregon,7417196,6,725,0,725,0
6_1982870,feast_love_ham_flounder_oregon_goias,1982870,6,725,0,725,0
6_4444921,feast_love_ham_flounder_goias_bosnia,4444921,6,725,0,725,0
6_5714052,feast_love_ham_flounder_manitoba_pennsylvania,5714052,6,725,0,725,0
6_3339403,feast_aesthetics_flounder_ham_bavaria_manitoba,3339403,6,900,0,900,0
6_7710104,feast_aesthetics_flounder_ham_pennsylvania_oregon,7710104,6,900,0,900,0
6_7388917,feast_aesthetics_flounder_ham_manitoba_pennsylvania,7388917,6,900,0,900,0
6_6955647,feast_lubricity_lemon_ham_bavaria_manitoba,6955647,6,539,0,539,0
6_7350636,feast_stimulation_ham_flounder_pennsylvania_oregon,7350636,6,564,0,564,0
6_761938,feast_stimulation_ham_flounder_oregon_goias,761938,6,564,0,564,0
6_3223989,feast_stimulation_ham_flounder_goias_bosnia,3223989,6,564,0,564,0
6_4170357,feast_stimulation_ham_flounder_manitoba_pennsylvania,4170357,6,564,0,564,0
6_5724287,feast_entertainment_ham_flounder_pennsylvania_oregon,5724287,6,839,0,839,0
6_154486,feast_entertainment_ham_flounder_oregon_goias,154486,6,839,0,839,0
6_2616537,feast_entertainment_ham_flounder_goias_bosnia,2616537,6,839,0,839,0
6_776910,feast_entertainment_ham_flounder_manitoba_pennsylvania,776910,6,839,0,839,0
6_4295251,feast_stimulation_lemon_ham_bavaria_manitoba,4295251,6,1010,0,1010,0
6_806102,feast_entertainment_lemon_ham_bavaria_manitoba,806102,6,1257,0,1257,0
6_7097700,feast_love_flounder_ham_bavaria_manitoba,7097700,6,718,0,718,0
6_4770690,feast_love_flounder_ham_pennsylvania_oregon,4770690,6,721,0,721,0
6_1475265,feast_love_flounder_ham_manitoba_pennsylvania,1475265,6,718,0,718,0
6_2703653,feast_entertainment_flounder_ham_bavaria_manitoba,2703653,6,830,0,830,0
6_3077781,feast_entertainment_flounder_ham_pennsylvania_oregon,3077781,6,830,0,830,0
6_4539100,feast_entertainment_flounder_ham_manitoba_pennsylvania,4539100,6,830,0,830,0
6_3806225,feast_lubricity_ham_flounder_pennsylvania_oregon,3806225,6,557,0,557,0
6_5397895,feast_lubricity_ham_flounder_oregon_goias,5397895,6,557,0,557,0
6_7859946,feast_lubricity_ham_flounder_goias_bosnia,7859946,6,557,0,557,0
6_2015325,feast_lubricity_ham_flounder_manitoba_pennsylvania,2015325,6,557,0,557,0
6_716016,feast_lubricity_ham_flounder_bavaria_manitoba,716016,6,1247,0,1247,0
6_7529475,overcome_angina_love_ham_vulcan_uranus,7529475,6,767,0,767,0
6_7372641,overcome_angina_stimulation_ham_vulcan_uranus,7372641,6,620,0,620,0
6_3542269,overcome_angina_stimulation_ham_uranus_saturn,3542269,6,611,0,611,0
6_5574087,overcome_angina_entertainment_ham_vulcan_uranus,5574087,6,877,0,877,0
6_491812,overcome_angina_aesthetics_ham_uranus_saturn,491812,6,1036,0,1036,0
6_68235,overcome_angina_lubricity_ham_vulcan_uranus,68235,6,583,0,583,0
6_4238840,overcome_angina_lubricity_ham_uranus_saturn,4238840,6,574,0,574,0
6_2611343,overcome_anger_love_ham_vulcan_uranus,2611343,6,766,0,766,0
6_459688,overcome_anger_stimulation_ham_vulcan_uranus,459688,6,652,0,652,0
6_4630293,overcome_anger_stimulation_ham_uranus_saturn,4630293,6,643,0,643,0
6_5607927,overcome_anger_entertainment_ham_vulcan_uranus,5607927,6,876,0,876,0
6_3746459,overcome_anger_aesthetics_ham_uranus_saturn,3746459,6,1036,0,1036,0
6_1862416,overcome_anger_lubricity_ham_vulcan_uranus,1862416,6,605,0,605,0
6_6033021,overcome_anger_lubricity_ham_uranus_saturn,6033021,6,596,0,596,0
6_450139,overcome_jealousy_love_ham_vulcan_uranus,450139,6,810,0,810,0
6_947696,overcome_jealousy_stimulation_ham_vulcan_uranus,947696,6,696,0,696,0
6_5118301,overcome_jealousy_stimulation_ham_uranus_saturn,5118301,6,687,0,687,0
6_7795146,overcome_jealousy_entertainment_ham_vulcan_uranus,7795146,6,903,0,903,0
6_5498579,overcome_jealousy_aesthetics_ham_uranus_saturn,5498579,6,1062,0,1062,0
6_4119535,overcome_jealousy_lubricity_ham_vulcan_uranus,4119535,6,738,0,738,0
6_289163,overcome_jealousy_lubricity_ham_uranus_saturn,289163,6,729,0,729,0
6_3473513,overcome_laceration_love_ham_vulcan_uranus,3473513,6,1185,0,1185,0
6_1191847,overcome_laceration_entertainment_ham_vulcan_uranus,1191847,6,1285,0,1285,0
6_82109,overcome_laceration_aesthetics_ham_uranus_saturn,82109,6,1409,0,1409,0
6_5786083,overcome_laceration_lubricity_ham_vulcan_uranus,5786083,6,1083,0,1083,0
6_1955711,overcome_laceration_lubricity_ham_uranus_saturn,1955711,6,1077,0,1077,0
6_3724375,overcome_grief_stimulation_ham_vulcan_uranus,3724375,6,1290,0,1290,0
6_7894980,overcome_grief_stimulation_ham_uranus_saturn,7894980,6,1286,0,1286,0
6_6009202,overcome_grief_entertainment_ham_vulcan_uranus,6009202,6,897,0,897,0
6_4909835,overcome_grief_lubricity_ham_vulcan_uranus,4909835,6,1296,0,1296,0
6_1079463,overcome_grief_lubricity_ham_uranus_saturn,1079463,6,1292,0,1292,0
6_6034255,noop_eats_beef_lemon,6034255,6,0,0,0,0
6_6870948,feast_love_beef_lemon_bavaria_manitoba,6870948,6,726,0,726,0
6_2785080,feast_love_beef_lemon_manitoba_pennsylvania,2785080,6,726,0,726,0
6_2027333,feast_love_beef_lemon_pennsylvania_oregon,2027333,6,1021,0,1021,0
6_1641396,feast_stimulation_beef_lemon_bavaria_manitoba,1641396,6,590,0,590,0
6_2718520,feast_stimulation_beef_lemon_manitoba_pennsylvania,2718520,6,590,0,590,0
6_152103,feast_stimulation_beef_lemon_pennsylvania_oregon,152103,6,872,0,872,0
6_4528676,feast_entertainment_beef_lemon_bavaria_manitoba,4528676,6,841,0,841,0
6_1092171,feast_entertainment_beef_lemon_manitoba_pennsylvania,1092171,6,841,0,841,0
6_5289058,feast_entertainment_beef_lemon_pennsylvania_oregon,5289058,6,1130,0,1130,0
6_6262540,feast_aesthetics_beef_lemon_bavaria_manitoba,6262540,6,1004,0,1004,0
6_5724494,feast_aesthetics_beef_lemon_manitoba_pennsylvania,5724494,6,1004,0,1004,0
6_20541,feast_aesthetics_beef_lemon_pennsylvania_oregon,20541,6,1280,0,1280,0
6_2619727,feast_lubricity_beef_lemon_bavaria_manitoba,2619727,6,553,0,553,0
6_7175086,feast_lubricity_beef_lemon_manitoba_pennsylvania,7175086,6,553,0,553,0
6_2384133,feast_lubricity_beef_lemon_pennsylvania_oregon,2384133,6,788,0,788,0
6_1616227,noop_eats_haroset_lamb,1616227,6,0,0,0,0
6_3042773,feast_stimulation_haroset_lamb_bavaria_manitoba,3042773,6,1119,0,1119,0
6_5112850,feast_love_haroset_lamb_bavaria_manitoba,5112850,6,709,0,709,0
6_7114488,feast_lubricity_haroset_lamb_bavaria_manitoba,7114488,6,1109,0,1109,0
6_1354553,feast_aesthetics_haroset_lamb_bavaria_manitoba,1354553,6,883,0,883,0
6_718803,feast_entertainment_haroset_lamb_bavaria_manitoba,718803,6,800,0,800,0
6_937738,noop_craves_entertainment_lobster,937738,6,206,0,206,0
6_5182809,succumb_grief_entertainment_lobster_vulcan_uranus,5182809,6,349,0,349,0
6_281178,succumb_laceration_entertainment_lobster_vulcan_uranus,281178,6,598,0,598,0
6_441439,succumb_sciatica_entertainment_lobster_vulcan_uranus,441439,6,449,0,449,0
6_1363922,succumb_jealousy_entertainment_lobster_vulcan_uranus,1363922,6,518,0,518,0
6_5347858,feast_entertainment_lobster_haroset_bavaria_manitoba,5347858,6,513,0,513,0
6_7467054,feast_entertainment_lobster_bacon_bavaria_manitoba,7467054,6,513,0,513,0
6_3894502,overcome_sciatica_entertainment_lobster_vulcan_uranus,3894502,6,431,0,431,0
6_4816985,overcome_jealousy_entertainment_lobster_vulcan_uranus,4816985,6,530,0,530,0
6_584478,overcome_laceration_entertainment_lobster_vulcan_uranus,584478,6,1209,0,1209,0
6_2432615,overcome_grief_entertainment_lobster_vulcan_uranus,2432615,6,351,0,351,0
6_3934647,fears_anger_entertainment,3934647,6,91,61,152,0
6_6864294,craves_entertainment_flounder,6864294,6,87,81,168,0
6_3931593,craves_entertainment_haroset,3931593,6,55,44,99,0
6_132955,craves_entertainment_bacon,132955,6,50,44,94,0
6_4849081,craves_entertainment_lamb,4849081,6,91,80,171,0
6_7810946,noop_fears_angina_stimulation,7810946,6,512,0,512,0
6_3191625,succumb_angina_stimulation_flounder_uranus_saturn,3191625,6,618,0,618,0
6_7021997,succumb_angina_stimulation_flounder_vulcan_uranus,7021997,6,618,0,618,0
6_5973186,succumb_angina_stimulation_lemon_uranus_saturn,5973186,6,618,0,618,0
6_1802581,succumb_angina_stimulation_lemon_vulcan_uranus,1802581,6,618,0,618,0
6_794907,harmony_stimulation_earth,794907,6,160,20,180,0
6_6712104,noop_craves_love_cantelope,6712104,6,687,0,687,0
6_5327349,succumb_laceration_love_cantelope_vulcan_uranus,5327349,6,845,0,845,0
6_50921,succumb_abrasion_love_cantelope_vulcan_uranus,50921,6,843,0,843,0
6_2235676,succumb_jealousy_love_cantelope_vulcan_uranus,2235676,6,808,0,808,0
6_7185308,succumb_anger_love_cantelope_vulcan_uranus,7185308,6,765,0,765,0
6_5953404,succumb_prostatitis_love_cantelope_vulcan_uranus,5953404,6,812,0,812,0
6_3627876,succumb_angina_love_cantelope_vulcan_uranus,3627876,6,765,0,765,0
6_7381388,overcome_abrasion_love_cantelope_vulcan_uranus,7381388,6,845,0,845,0
6_504497,overcome_prostatitis_love_cantelope_vulcan_uranus,504497,6,809,0,809,0
6_4149673,overcome_laceration_love_cantelope_vulcan_uranus,4149673,6,1199,0,1199,0
6_6026349,fears_hangover_love,6026349,6,82,80,162,0
6_4605843,craves_love_lobster,4605843,6,67,70,137,0
6_804392,fears_dread_love,804392,6,77,78,155,0
6_2576538,craves_love_flounder,2576538,6,71,67,138,0
6_1265535,locale_haroset_manitoba,1265535,6,79,69,148,0
6_6290134,craves_love_haroset,6290134,6,35,27,62,0
6_4480323,craves_anger_lemon,4480323,6,88,16,104,0
6_941502,craves_grief_flounder,941502,6,103,16,119,0
6_7041704,craves_love_wonderbread,7041704,6,60,59,119,0
6_4430757,craves_love_bacon,4430757,6,82,83,165,0
6_5808558,craves_grief_lamb,5808558,6,101,29,130,0
6_2670059,craves_love_tofu,2670059,6,70,69,139,0
6_3553209,craves_love_lamb,3553209,6,76,63,139,0
6_614612,craves_love_lemon,614612,6,68,64,132,0
6_4061666,craves_love_beef,4061666,6,78,65,143,0
6_7954321,fears_sciatica_love,7954321,6,78,60,138,0
6_2533325,craves_love_ham,2533325,6,73,68,141,0
6_5019078,fears_grief_love,5019078,6,65,59,124,0
6_4058429,craves_love_marzipan,4058429,6,78,69,147,0
6_3735505,noop_craves_anger_haroset,3735505,6,120,0,120,0
6_2410744,overcome_anger_love_haroset_vulcan_uranus,2410744,6,372,0,372,0
6_7603566,overcome_anger_stimulation_haroset_vulcan_uranus,7603566,6,653,0,653,0
6_3773194,overcome_anger_stimulation_haroset_uranus_saturn,3773194,6,639,0,639,0
6_1184359,overcome_anger_entertainment_haroset_vulcan_uranus,1184359,6,589,0,589,0
6_1056773,overcome_anger_aesthetics_haroset_vulcan_uranus,1056773,6,697,0,697,0
6_5227378,overcome_anger_aesthetics_haroset_uranus_saturn,5227378,6,689,0,689,0
6_3698800,overcome_anger_lubricity_haroset_vulcan_uranus,3698800,6,601,0,601,0
6_7869405,overcome_anger_lubricity_haroset_uranus_saturn,7869405,6,584,0,584,0
6_809839,fears_anger_love,809839,6,77,47,124,0
6_7461953,craves_anger_flounder,7461953,6,29,11,40,0
6_587956,craves_anger_ham,587956,6,30,14,44,0
6_6152154,noop_craves_grief_flounder,6152154,6,804,0,804,0
6_3205636,overcome_grief_stimulation_flounder_vulcan_uranus,3205636,6,1227,0,1227,0
6_7376241,overcome_grief_stimulation_flounder_uranus_saturn,7376241,6,1219,0,1219,0
6_4925402,overcome_grief_entertainment_flounder_vulcan_uranus,4925402,6,886,0,886,0
6_6907463,overcome_grief_aesthetics_flounder_vulcan_uranus,6907463,6,960,0,960,0
6_3077091,overcome_grief_aesthetics_flounder_uranus_saturn,3077091,6,960,0,960,0
6_3150028,overcome_grief_lubricity_flounder_vulcan_uranus,3150028,6,1233,0,1233,0
6_7320633,overcome_grief_lubricity_flounder_uranus_saturn,7320633,6,1225,0,1225,0
6_2054340,fears_prostatitis_love,2054340,6,82,83,165,0
6_71424,locale_lamb_bavaria,71424,6,60,4,64,0
6_1501452,craves_love_cantelope,1501452,6,64,62,126,0
6_7158854,craves_grief_haroset,7158854,6,52,27,79,0
6_5729757,craves_grief_bacon,5729757,6,44,29,73,0
6_5474563,craves_grief_lobster,5474563,6,34,19,53,0
6_5021913,fears_grief_entertainment,5021913,6,47,31,78,0
6_4101071,locale_lobster_manitoba,4101071,6,56,46,102,0
6_4546428,craves_grief_wonderbread,4546428,6,79,35,114,0
6_7153580,fears_sciatica_entertainment,7153580,6,54,47,101,0
6_4720670,noop_craves_sciatica_flounder,4720670,6,965,0,965,0
6_742295,overcome_sciatica_stimulation_flounder_vulcan_uranus,742295,6,1370,0,1370,0
6_4912900,overcome_sciatica_stimulation_flounder_uranus_saturn,4912900,6,1365,0,1365,0
6_2708164,overcome_sciatica_lubricity_flounder_vulcan_uranus,2708164,6,1377,0,1377,0
6_6878769,overcome_sciatica_lubricity_flounder_uranus_saturn,6878769,6,1372,0,1372,0
6_6255097,craves_sciatica_wonderbread,6255097,6,60,38,98,0
6_2814490,harmony_aesthetics_saturn,2814490,6,185,86,271,0
6_384688,harmony_aesthetics_vulcan,384688,6,68,29,97,0
6_3889381,harmony_aesthetics_uranus,3889381,6,141,66,207,0
6_492278,fears_sciatica_achievement,492278,6,35,22,57,0
6_3121428,craves_sciatica_bacon,3121428,6,29,19,48,0
6_4464227,fears_sciatica_learning,4464227,6,46,28,74,0
6_5951675,fears_sciatica_aesthetics,5951675,6,46,17,63,0
6_6898824,craves_sciatica_lobster,6898824,6,45,23,68,0
6_2052314,fears_sciatica_expectation,2052314,6,43,25,68,0
6_715788,noop_craves_prostatitis_beef,715788,6,123,0,123,0
6_6123062,overcome_prostatitis_love_beef_vulcan_uranus,6123062,6,809,0,809,0
6_24097,overcome_prostatitis_stimulation_beef_vulcan_uranus,24097,6,642,0,642,0
6_4194702,overcome_prostatitis_stimulation_beef_uranus_saturn,4194702,6,642,0,642,0
6_2616341,overcome_prostatitis_entertainment_beef_vulcan_uranus,2616341,6,921,0,921,0
6_5551508,overcome_prostatitis_aesthetics_beef_uranus_saturn,5551508,6,1076,0,1076,0
6_2370943,overcome_prostatitis_lubricity_beef_vulcan_uranus,2370943,6,620,0,620,0
6_6541548,overcome_prostatitis_lubricity_beef_uranus_saturn,6541548,6,604,0,604,0
6_3734046,craves_prostatitis_tofu,3734046,6,23,25,48,0
6_58194,craves_prostatitis_wonderbread,58194,6,33,34,67,0
6_7047677,craves_prostatitis_cantelope,7047677,6,23,20,43,0
6_3048718,craves_prostatitis_marzipan,3048718,6,25,18,43,0
6_2244238,noop_fears_anger_stimulation,2244238,6,447,0,447,0
6_5552835,succumb_anger_stimulation_flounder_uranus_saturn,5552835,6,623,0,623,0
6_1382230,succumb_anger_stimulation_flounder_vulcan_uranus,1382230,6,622,0,622,0
6_4950870,succumb_anger_stimulation_haroset_uranus_saturn,4950870,6,624,0,624,0
6_780265,succumb_anger_stimulation_haroset_vulcan_uranus,780265,6,623,0,623,0
6_3047493,succumb_anger_stimulation_lemon_uranus_saturn,3047493,6,623,0,623,0
6_6877865,succumb_anger_stimulation_lemon_vulcan_uranus,6877865,6,623,0,623,0
6_6590502,craves_anger_haroset,6590502,6,33,8,41,0
6_2910864,noop_locale_okra_bavaria,2910864,6,5,0,5,0
6_1619342,locale_okra_manitoba,1619342,6,13,16,29,0
6_7044628,noop_craves_expectation_wonderbread,7044628,6,60,0,60,0
6_1748051,succumb_grief_expectation_wonderbread_vulcan_uranus,1748051,6,805,0,805,0
6_5918656,succumb_grief_expectation_wonderbread_uranus_saturn,5918656,6,805,0,805,0
6_532580,succumb_depression_expectation_wonderbread_vulcan_uranus,532580,6,181,0,181,0
6_4703185,succumb_depression_expectation_wonderbread_uranus_saturn,4703185,6,181,0,181,0
6_5267480,succumb_sciatica_expectation_wonderbread_vulcan_uranus,5267480,6,462,0,462,0
6_1437108,succumb_sciatica_expectation_wonderbread_uranus_saturn,1437108,6,462,0,462,0
6_5699864,succumb_dread_expectation_wonderbread_vulcan_uranus,5699864,6,153,0,153,0
6_1869492,succumb_dread_expectation_wonderbread_uranus_saturn,1869492,6,153,0,153,0
6_5814941,succumb_hangover_expectation_wonderbread_vulcan_uranus,5814941,6,172,0,172,0
6_1984569,succumb_hangover_expectation_wonderbread_uranus_saturn,1984569,6,172,0,172,0
6_1740408,overcome_sciatica_expectation_wonderbread_uranus_saturn,1740408,6,328,0,328,0
6_5570780,overcome_sciatica_expectation_wonderbread_vulcan_uranus,5570780,6,328,0,328,0
6_1413418,overcome_abrasion_expectation_wonderbread_uranus_saturn,1413418,6,292,0,292,0
6_5243790,overcome_abrasion_expectation_wonderbread_vulcan_uranus,5243790,6,291,0,291,0
6_7345117,overcome_depression_expectation_wonderbread_uranus_saturn,7345117,6,184,0,184,0
6_3174512,overcome_depression_expectation_wonderbread_vulcan_uranus,3174512,6,183,0,183,0
6_2287869,overcome_hangover_expectation_wonderbread_uranus_saturn,2287869,6,175,0,175,0
6_6118241,overcome_hangover_expectation_wonderbread_vulcan_uranus,6118241,6,174,0,174,0
6_996828,overcome_prostatitis_expectation_wonderbread_uranus_saturn,996828,6,237,0,237,0
6_4827200,overcome_prostatitis_expectation_wonderbread_vulcan_uranus,4827200,6,236,0,236,0
6_3164387,overcome_dread_expectation_wonderbread_uranus_saturn,3164387,6,156,0,156,0
6_6994759,overcome_dread_expectation_wonderbread_vulcan_uranus,6994759,6,155,0,155,0
6_2204084,overcome_jealousy_expectation_wonderbread_uranus_saturn,2204084,6,905,0,905,0
6_6034456,overcome_jealousy_expectation_wonderbread_vulcan_uranus,6034456,6,904,0,904,0
6_7213551,overcome_grief_expectation_wonderbread_uranus_saturn,7213551,6,606,0,606,0
6_3042946,overcome_grief_expectation_wonderbread_vulcan_uranus,3042946,6,606,0,606,0
6_4128492,craves_expectation_onion,4128492,6,16,25,41,0
6_6885171,craves_expectation_okra,6885171,6,11,11,22,0
6_2455781,craves_expectation_snickers,2455781,6,13,13,26,0
6_1016330,noop_pleasure_love,1016330,6,0,0,0,0
6_5986378,succumb_laceration_love_wonderbread_vulcan_uranus,5986378,6,845,0,845,0
6_7512148,succumb_laceration_love_lamb_vulcan_uranus,7512148,6,845,0,845,0
6_6368951,succumb_laceration_love_tofu_vulcan_uranus,6368951,6,866,0,866,0
6_7192833,succumb_laceration_love_lemon_vulcan_uranus,7192833,6,845,0,845,0
6_5441782,succumb_laceration_love_beef_vulcan_uranus,5441782,6,845,0,845,0
6_2162529,succumb_laceration_love_marzipan_vulcan_uranus,2162529,6,852,0,852,0
6_2453,succumb_laceration_love_haroset_vulcan_uranus,2453,6,457,0,457,0
6_2286783,succumb_laceration_love_flounder_vulcan_uranus,2286783,6,845,0,845,0
6_3766222,succumb_laceration_love_lobster_vulcan_uranus,3766222,6,846,0,846,0
6_2567359,succumb_depression_love_wonderbread_vulcan_uranus,2567359,6,812,0,812,0
6_1323893,succumb_sciatica_love_wonderbread_vulcan_uranus,1323893,6,796,0,796,0
6_816536,succumb_sciatica_love_bacon_vulcan_uranus,816536,6,890,0,890,0
6_4732330,succumb_sciatica_love_haroset_vulcan_uranus,4732330,6,678,0,678,0
6_495122,succumb_sciatica_love_lobster_vulcan_uranus,495122,6,797,0,797,0
6_4225933,succumb_abrasion_love_wonderbread_vulcan_uranus,4225933,6,843,0,843,0
6_2206194,succumb_abrasion_love_lamb_vulcan_uranus,2206194,6,843,0,843,0
6_1062997,succumb_abrasion_love_tofu_vulcan_uranus,1062997,6,864,0,864,0
6_1033722,succumb_abrasion_love_lemon_vulcan_uranus,1033722,6,843,0,843,0
6_135828,succumb_abrasion_love_beef_vulcan_uranus,135828,6,843,0,843,0
6_4517208,succumb_abrasion_love_marzipan_vulcan_uranus,4517208,6,850,0,850,0
6_5793607,succumb_abrasion_love_haroset_vulcan_uranus,5793607,6,843,0,843,0
6_5976703,succumb_grief_love_wonderbread_vulcan_uranus,5976703,6,798,0,798,0
6_2320336,succumb_grief_love_bacon_vulcan_uranus,2320336,6,879,0,879,0
6_3062520,succumb_grief_love_lamb_vulcan_uranus,3062520,6,802,0,802,0
6_1734444,succumb_grief_love_haroset_vulcan_uranus,1734444,6,582,0,582,0
6_5622744,succumb_grief_love_flounder_vulcan_uranus,5622744,6,802,0,802,0
6_5498213,succumb_grief_love_lobster_vulcan_uranus,5498213,6,799,0,799,0
6_6846198,succumb_jealousy_love_wonderbread_vulcan_uranus,6846198,6,808,0,808,0
6_2415109,succumb_jealousy_love_bacon_vulcan_uranus,2415109,6,919,0,919,0
6_1906499,succumb_jealousy_love_lamb_vulcan_uranus,1906499,6,808,0,808,0
6_763302,succumb_jealousy_love_tofu_vulcan_uranus,763302,6,829,0,829,0
6_4321572,succumb_jealousy_love_lemon_vulcan_uranus,4321572,6,808,0,808,0
6_7837110,succumb_jealousy_love_beef_vulcan_uranus,7837110,6,808,0,808,0
6_6432225,succumb_jealousy_love_marzipan_vulcan_uranus,6432225,6,815,0,815,0
6_4019620,succumb_jealousy_love_haroset_vulcan_uranus,4019620,6,409,0,409,0
6_6556479,succumb_jealousy_love_flounder_vulcan_uranus,6556479,6,808,0,808,0
6_7783389,succumb_jealousy_love_lobster_vulcan_uranus,7783389,6,809,0,809,0
6_4344025,succumb_loneliness_love_tofu_vulcan_uranus,4344025,6,752,0,752,0
6_556434,succumb_anger_love_lemon_vulcan_uranus,556434,6,762,0,762,0
6_7384849,succumb_anger_love_beef_vulcan_uranus,7384849,6,765,0,765,0
6_2066332,succumb_anger_love_haroset_vulcan_uranus,2066332,6,765,0,765,0
6_2575325,succumb_anger_love_flounder_vulcan_uranus,2575325,6,762,0,762,0
6_6116802,succumb_prostatitis_love_wonderbread_vulcan_uranus,6116802,6,812,0,812,0
6_6118731,succumb_prostatitis_love_tofu_vulcan_uranus,6118731,6,821,0,821,0
6_5191562,succumb_prostatitis_love_beef_vulcan_uranus,5191562,6,812,0,812,0
6_3446381,succumb_prostatitis_love_marzipan_vulcan_uranus,3446381,6,812,0,812,0
6_4208485,succumb_dread_love_wonderbread_vulcan_uranus,4208485,6,755,0,755,0
6_64367,succumb_angina_love_lemon_vulcan_uranus,64367,6,765,0,765,0
6_4976383,succumb_angina_love_beef_vulcan_uranus,4976383,6,765,0,765,0
6_5901707,succumb_angina_love_haroset_vulcan_uranus,5901707,6,765,0,765,0
6_311154,succumb_angina_love_flounder_vulcan_uranus,311154,6,765,0,765,0
6_4101321,succumb_hangover_love_wonderbread_vulcan_uranus,4101321,6,801,0,801,0
6_1482738,feast_love_bacon_lobster_bavaria_manitoba,1482738,6,902,0,902,0
6_2482178,feast_love_bacon_wonderbread_bavaria_manitoba,2482178,6,902,0,902,0
6_5016585,feast_love_lamb_beef_oregon_goias,5016585,6,732,0,732,0
6_6976806,feast_love_lamb_beef_pennsylvania_oregon,6976806,6,732,0,732,0
6_3839051,feast_love_lamb_beef_manitoba_pennsylvania,3839051,6,732,0,732,0
6_2475506,feast_love_lamb_beef_bavaria_manitoba,2475506,6,732,0,732,0
6_7478636,feast_love_lamb_beef_goias_bosnia,7478636,6,1123,0,1123,0
6_5661286,feast_love_lamb_haroset_oregon_goias,5661286,6,732,0,732,0
6_3565718,feast_love_lamb_haroset_pennsylvania_oregon,3565718,6,732,0,732,0
6_2073263,feast_love_lamb_haroset_manitoba_pennsylvania,2073263,6,732,0,732,0
6_2040829,feast_love_lamb_haroset_bavaria_manitoba,2040829,6,732,0,732,0
6_122360,feast_love_lamb_haroset_goias_bosnia,122360,6,1123,0,1123,0
6_1067745,feast_love_lemon_cantelope_bavaria_manitoba,1067745,6,1111,0,1111,0
6_6581411,feast_love_lemon_beef_bavaria_manitoba,6581411,6,1111,0,1111,0
6_3991422,feast_love_beef_marzipan_bavaria_manitoba,3991422,6,726,0,726,0
6_6819309,feast_love_beef_marzipan_manitoba_pennsylvania,6819309,6,726,0,726,0
6_7539176,feast_love_beef_marzipan_pennsylvania_oregon,7539176,6,1021,0,1021,0
6_4775790,feast_love_beef_lamb_bavaria_manitoba,4775790,6,726,0,726,0
6_4691811,feast_love_beef_lamb_manitoba_pennsylvania,4691811,6,726,0,726,0
6_7989638,feast_love_beef_lamb_pennsylvania_oregon,7989638,6,1021,0,1021,0
6_183107,feast_love_marzipan_wonderbread_pennsylvania_oregon,183107,6,884,0,884,0
6_2348506,feast_love_marzipan_wonderbread_manitoba_pennsylvania,2348506,6,734,0,734,0
6_4910645,feast_love_marzipan_tofu_pennsylvania_oregon,4910645,6,884,0,884,0
6_4446503,feast_love_marzipan_tofu_manitoba_pennsylvania,4446503,6,734,0,734,0
6_2441894,feast_love_marzipan_beef_pennsylvania_oregon,2441894,6,884,0,884,0
6_136884,feast_love_marzipan_beef_manitoba_pennsylvania,136884,6,734,0,734,0
6_3096043,feast_love_marzipan_cantelope_pennsylvania_oregon,3096043,6,884,0,884,0
6_1210982,feast_love_marzipan_cantelope_manitoba_pennsylvania,1210982,6,734,0,734,0
6_328749,feast_love_haroset_flounder_bavaria_manitoba,328749,6,709,0,709,0
6_6173515,feast_love_flounder_haroset_bavaria_manitoba,6173515,6,1188,0,1188,0
6_6749570,feast_love_flounder_haroset_pennsylvania_oregon,6749570,6,721,0,721,0
6_1518752,feast_love_flounder_haroset_manitoba_pennsylvania,1518752,6,718,0,718,0
6_7040767,feast_love_lobster_haroset_bavaria_manitoba,7040767,6,804,0,804,0
6_4205329,feast_love_lobster_bacon_bavaria_manitoba,4205329,6,804,0,804,0
6_1426622,overcome_sciatica_love_lobster_vulcan_uranus,1426622,6,805,0,805,0
6_975261,overcome_sciatica_love_bacon_vulcan_uranus,975261,6,892,0,892,0
6_5663830,overcome_sciatica_love_haroset_vulcan_uranus,5663830,6,825,0,825,0
6_146217,overcome_sciatica_love_wonderbread_vulcan_uranus,146217,6,779,0,779,0
6_1062052,overcome_anxiety_love_onion_vulcan_uranus,1062052,6,785,0,785,0
6_1192447,overcome_abrasion_love_lemon_vulcan_uranus,1192447,6,828,0,828,0
6_1407409,overcome_abrasion_love_tofu_vulcan_uranus,1407409,6,866,0,866,0
6_2550606,overcome_abrasion_love_lamb_vulcan_uranus,2550606,6,845,0,845,0
6_480240,overcome_abrasion_love_beef_vulcan_uranus,480240,6,845,0,845,0
6_6725107,overcome_abrasion_love_haroset_vulcan_uranus,6725107,6,431,0,431,0
6_2951898,overcome_abrasion_love_marzipan_vulcan_uranus,2951898,6,845,0,845,0
6_3048257,overcome_abrasion_love_wonderbread_vulcan_uranus,3048257,6,822,0,822,0
6_7818142,overcome_depression_love_wonderbread_vulcan_uranus,7818142,6,791,0,791,0
6_5899270,overcome_depression_love_onion_vulcan_uranus,5899270,6,907,0,907,0
6_6060432,overcome_angina_love_haroset_vulcan_uranus,6060432,6,809,0,809,0
6_3191094,overcome_angina_love_lemon_vulcan_uranus,3191094,6,753,0,753,0
6_939869,overcome_angina_love_flounder_vulcan_uranus,939869,6,767,0,767,0
6_2923645,overcome_hangover_love_wonderbread_vulcan_uranus,2923645,6,780,0,780,0
6_7813735,overcome_hangover_love_onion_vulcan_uranus,7813735,6,1001,0,1001,0
6_2734050,overcome_anger_love_flounder_vulcan_uranus,2734050,6,763,0,763,0
6_7850787,overcome_anger_love_lemon_vulcan_uranus,7850787,6,767,0,767,0
6_2268705,overcome_prostatitis_love_marzipan_vulcan_uranus,2268705,6,802,0,802,0
6_6153114,overcome_prostatitis_love_wonderbread_vulcan_uranus,6153114,6,786,0,786,0
6_7050231,overcome_prostatitis_love_tofu_vulcan_uranus,7050231,6,823,0,823,0
6_2643175,overcome_dread_love_wonderbread_vulcan_uranus,2643175,6,734,0,734,0
6_4480297,overcome_jealousy_love_lemon_vulcan_uranus,4480297,6,810,0,810,0
6_4866915,overcome_jealousy_love_marzipan_vulcan_uranus,4866915,6,822,0,822,0
6_5668522,overcome_jealousy_love_wonderbread_vulcan_uranus,5668522,6,810,0,810,0
6_713912,overcome_jealousy_love_lobster_vulcan_uranus,713912,6,811,0,811,0
6_4991169,overcome_jealousy_love_flounder_vulcan_uranus,4991169,6,810,0,810,0
6_2573834,overcome_jealousy_love_bacon_vulcan_uranus,2573834,6,939,0,939,0
6_4951120,overcome_jealousy_love_haroset_vulcan_uranus,4951120,6,411,0,411,0
6_2250911,overcome_jealousy_love_lamb_vulcan_uranus,2250911,6,810,0,810,0
6_180545,overcome_jealousy_love_beef_vulcan_uranus,180545,6,810,0,810,0
6_7332920,overcome_laceration_love_haroset_vulcan_uranus,7332920,6,452,0,452,0
6_139886,overcome_laceration_love_lamb_vulcan_uranus,139886,6,847,0,847,0
6_6070497,overcome_laceration_love_beef_vulcan_uranus,6070497,6,847,0,847,0
6_123356,overcome_laceration_love_lemon_vulcan_uranus,123356,6,830,0,830,0
6_6533463,overcome_laceration_love_marzipan_vulcan_uranus,6533463,6,852,0,852,0
6_6657717,overcome_laceration_love_flounder_vulcan_uranus,6657717,6,1141,0,1141,0
6_6997666,overcome_laceration_love_tofu_vulcan_uranus,6997666,6,1202,0,1202,0
6_2078856,overcome_grief_love_haroset_vulcan_uranus,2078856,6,591,0,591,0
6_1613712,overcome_grief_love_bacon_vulcan_uranus,1613712,6,881,0,881,0
6_5842625,overcome_grief_love_lobster_vulcan_uranus,5842625,6,801,0,801,0
6_4411393,overcome_grief_love_wonderbread_vulcan_uranus,4411393,6,785,0,785,0
6_2516280,noop_eats_wonderbread_marzipan,2516280,6,0,0,0,0
6_4671628,noop_craves_anger_flounder,4671628,6,89,0,89,0
6_3934300,overcome_anger_stimulation_flounder_vulcan_uranus,3934300,6,624,0,624,0
6_103928,overcome_anger_stimulation_flounder_uranus_saturn,103928,6,615,0,615,0
6_817593,overcome_anger_entertainment_flounder_vulcan_uranus,817593,6,873,0,873,0
6_159485,overcome_anger_aesthetics_flounder_vulcan_uranus,159485,6,953,0,953,0
6_4330090,overcome_anger_aesthetics_flounder_uranus_saturn,4330090,6,946,0,946,0
6_4436329,overcome_anger_lubricity_flounder_vulcan_uranus,4436329,6,595,0,595,0
6_605957,overcome_anger_lubricity_flounder_uranus_saturn,605957,6,586,0,586,0
6_1321506,noop_fears_grief_aesthetics,1321506,6,202,0,202,0
6_1821573,succumb_grief_aesthetics_bacon_uranus_saturn,1821573,6,465,0,465,0
6_5651945,succumb_grief_aesthetics_bacon_vulcan_uranus,5651945,6,465,0,465,0
6_3333912,succumb_grief_aesthetics_lobster_uranus_saturn,3333912,6,491,0,491,0
6_7164284,succumb_grief_aesthetics_lobster_vulcan_uranus,7164284,6,491,0,491,0
6_4254767,succumb_grief_aesthetics_flounder_uranus_saturn,4254767,6,946,0,946,0
6_2310529,succumb_grief_aesthetics_wonderbread_uranus_saturn,2310529,6,480,0,480,0
6_6140901,succumb_grief_aesthetics_wonderbread_vulcan_uranus,6140901,6,480,0,480,0
6_964122,succumb_grief_aesthetics_lamb_uranus_saturn,964122,6,947,0,947,0
6_7571120,succumb_grief_aesthetics_haroset_uranus_saturn,7571120,6,679,0,679,0
6_3400515,succumb_grief_aesthetics_haroset_vulcan_uranus,3400515,6,678,0,678,0
6_456128,noop_fears_laceration_love,456128,6,385,0,385,0
6_2928243,harmony_love_uranus,2928243,6,151,72,223,0
6_3769528,noop_craves_abrasion_lemon,3769528,6,178,0,178,0
6_1687825,overcome_abrasion_stimulation_lemon_vulcan_uranus,1687825,6,670,0,670,0
6_5858430,overcome_abrasion_stimulation_lemon_uranus_saturn,5858430,6,670,0,670,0
6_4248829,overcome_abrasion_entertainment_lemon_vulcan_uranus,4248829,6,1002,0,1002,0
6_5422951,overcome_abrasion_lubricity_lemon_vulcan_uranus,5422951,6,646,0,646,0
6_1592579,overcome_abrasion_lubricity_lemon_uranus_saturn,1592579,6,646,0,646,0
6_6725084,noop_craves_sciatica_lamb,6725084,6,961,0,961,0
6_4088543,overcome_sciatica_stimulation_lamb_vulcan_uranus,4088543,6,1363,0,1363,0
6_258171,overcome_sciatica_stimulation_lamb_uranus_saturn,258171,6,1363,0,1363,0
6_3960812,overcome_sciatica_lubricity_lamb_vulcan_uranus,3960812,6,1372,0,1372,0
6_130440,overcome_sciatica_lubricity_lamb_uranus_saturn,130440,6,1367,0,1367,0
6_5557734,noop_craves_abrasion_tofu,5557734,6,215,0,215,0
6_5847386,overcome_abrasion_stimulation_tofu_vulcan_uranus,5847386,6,702,0,702,0
6_2017014,overcome_abrasion_stimulation_tofu_uranus_saturn,2017014,6,702,0,702,0
6_4482222,overcome_abrasion_entertainment_tofu_vulcan_uranus,4482222,6,1022,0,1022,0
6_2174026,overcome_abrasion_lubricity_tofu_vulcan_uranus,2174026,6,691,0,691,0
6_6344631,overcome_abrasion_lubricity_tofu_uranus_saturn,6344631,6,684,0,684,0
6_4303857,noop_craves_grief_haroset,4303857,6,331,0,331,0
6_6350567,overcome_grief_stimulation_haroset_vulcan_uranus,6350567,6,827,0,827,0
6_2520195,overcome_grief_stimulation_haroset_uranus_saturn,2520195,6,813,0,813,0
6_6669823,overcome_grief_entertainment_haroset_vulcan_uranus,6669823,6,603,0,603,0
6_7771449,overcome_grief_aesthetics_haroset_vulcan_uranus,7771449,6,681,0,681,0
6_3941077,overcome_grief_aesthetics_haroset_uranus_saturn,3941077,6,673,0,673,0
6_4100075,overcome_grief_lubricity_haroset_vulcan_uranus,4100075,6,815,0,815,0
6_269703,overcome_grief_lubricity_haroset_uranus_saturn,269703,6,798,0,798,0
6_2631839,noop_craves_love_wonderbread,2631839,6,654,0,654,0
6_2231879,noop_fears_boils_lubricity,2231879,6,185,0,185,0
6_2227981,noop_food_marzipan,2227981,6,0,0,0,0
6_7229304,succumb_prostatitis_entertainment_marzipan_vulcan_uranus,7229304,6,971,0,971,0
6_3149333,succumb_laceration_stimulation_marzipan_uranus_saturn,3149333,6,657,0,657,0
6_6979705,succumb_laceration_stimulation_marzipan_vulcan_uranus,6979705,6,658,0,658,0
6_4764836,succumb_grief_entertainment_marzipan_vulcan_uranus,4764836,6,902,0,902,0
6_7232890,succumb_prostatitis_lubricity_marzipan_uranus_saturn,7232890,6,618,0,618,0
6_3062285,succumb_prostatitis_lubricity_marzipan_vulcan_uranus,3062285,6,626,0,626,0
6_6100689,succumb_laceration_entertainment_marzipan_vulcan_uranus,6100689,6,1005,0,1005,0
6_6670644,succumb_abrasion_stimulation_marzipan_uranus_saturn,6670644,6,681,0,681,0
6_2500039,succumb_abrasion_stimulation_marzipan_vulcan_uranus,2500039,6,682,0,682,0
6_1804303,succumb_loneliness_lubricity_marzipan_uranus_saturn,1804303,6,585,0,585,0
6_6558774,succumb_abrasion_entertainment_marzipan_vulcan_uranus,6558774,6,1011,0,1011,0
6_3403593,succumb_jealousy_stimulation_marzipan_uranus_saturn,3403593,6,705,0,705,0
6_7233965,succumb_jealousy_stimulation_marzipan_vulcan_uranus,7233965,6,705,0,705,0
6_6373882,succumb_abrasion_lubricity_marzipan_uranus_saturn,6373882,6,671,0,671,0
6_2203277,succumb_abrasion_lubricity_marzipan_vulcan_uranus,2203277,6,679,0,679,0
6_4809062,succumb_laceration_lubricity_marzipan_uranus_saturn,4809062,6,701,0,701,0
6_638457,succumb_laceration_lubricity_marzipan_vulcan_uranus,638457,6,708,0,708,0
6_7744760,succumb_prostatitis_stimulation_marzipan_uranus_saturn,7744760,6,639,0,639,0
6_3574155,succumb_prostatitis_stimulation_marzipan_vulcan_uranus,3574155,6,640,0,640,0
6_3309433,succumb_loneliness_stimulation_marzipan_uranus_saturn,3309433,6,599,0,599,0
6_3248958,succumb_jealousy_entertainment_marzipan_vulcan_uranus,3248958,6,960,0,960,0
6_7061695,feast_stimulation_marzipan_wonderbread_pennsylvania_oregon,7061695,6,741,0,741,0
6_6445540,feast_stimulation_marzipan_wonderbread_manitoba_pennsylvania,6445540,6,614,0,614,0
6_3873239,feast_stimulation_marzipan_tofu_pennsylvania_oregon,3873239,6,741,0,741,0
6_1308456,feast_stimulation_marzipan_tofu_manitoba_pennsylvania,1308456,6,614,0,614,0
6_1404488,feast_stimulation_marzipan_beef_pennsylvania_oregon,1404488,6,741,0,741,0
6_4999814,feast_stimulation_marzipan_beef_manitoba_pennsylvania,4999814,6,614,0,614,0
6_3573257,feast_stimulation_marzipan_cantelope_pennsylvania_oregon,3573257,6,741,0,741,0
6_88593,feast_stimulation_marzipan_cantelope_manitoba_pennsylvania,88593,6,614,0,614,0
6_4836223,feast_entertainment_marzipan_wonderbread_pennsylvania_oregon,4836223,6,1049,0,1049,0
6_7722281,feast_entertainment_marzipan_wonderbread_manitoba_pennsylvania,7722281,6,905,0,905,0
6_3578699,feast_entertainment_marzipan_tofu_pennsylvania_oregon,3578699,6,1049,0,1049,0
6_4692517,feast_entertainment_marzipan_tofu_manitoba_pennsylvania,4692517,6,905,0,905,0
6_1109948,feast_entertainment_marzipan_beef_pennsylvania_oregon,1109948,6,1049,0,1049,0
6_382898,feast_entertainment_marzipan_beef_manitoba_pennsylvania,382898,6,905,0,905,0
6_1111985,feast_entertainment_marzipan_cantelope_pennsylvania_oregon,1111985,6,1049,0,1049,0
6_5864098,feast_entertainment_marzipan_cantelope_manitoba_pennsylvania,5864098,6,905,0,905,0
6_6454858,feast_lubricity_marzipan_wonderbread_pennsylvania_oregon,6454858,6,655,0,655,0
6_1631598,feast_lubricity_marzipan_wonderbread_manitoba_pennsylvania,1631598,6,587,0,587,0
6_614424,feast_lubricity_marzipan_tofu_pennsylvania_oregon,614424,6,655,0,655,0
6_1687677,feast_lubricity_marzipan_tofu_manitoba_pennsylvania,1687677,6,587,0,587,0
6_6146650,feast_lubricity_marzipan_beef_pennsylvania_oregon,6146650,6,655,0,655,0
6_5379035,feast_lubricity_marzipan_beef_manitoba_pennsylvania,5379035,6,587,0,587,0
6_3304294,feast_lubricity_marzipan_cantelope_pennsylvania_oregon,3304294,6,655,0,655,0
6_7482733,feast_lubricity_marzipan_cantelope_manitoba_pennsylvania,7482733,6,587,0,587,0
6_946107,feast_aesthetics_marzipan_wonderbread_pennsylvania_oregon,946107,6,1160,0,1160,0
6_210256,feast_aesthetics_marzipan_wonderbread_manitoba_pennsylvania,210256,6,1024,0,1024,0
6_5308791,feast_aesthetics_marzipan_tofu_pennsylvania_oregon,5308791,6,1160,0,1160,0
6_6156762,feast_aesthetics_marzipan_tofu_manitoba_pennsylvania,6156762,6,1024,0,1024,0
6_2840040,feast_aesthetics_marzipan_beef_pennsylvania_oregon,2840040,6,1160,0,1160,0
6_1847143,feast_aesthetics_marzipan_beef_manitoba_pennsylvania,1847143,6,1024,0,1024,0
6_4003392,feast_aesthetics_marzipan_cantelope_pennsylvania_oregon,4003392,6,1160,0,1160,0
6_1973982,feast_aesthetics_marzipan_cantelope_manitoba_pennsylvania,1973982,6,1024,0,1024,0
6_2116192,feast_stimulation_beef_marzipan_bavaria_manitoba,2116192,6,590,0,590,0
6_3681262,feast_stimulation_beef_marzipan_manitoba_pennsylvania,3681262,6,590,0,590,0
6_6501770,feast_stimulation_beef_marzipan_pennsylvania_oregon,6501770,6,872,0,872,0
6_7253147,feast_entertainment_beef_marzipan_bavaria_manitoba,7253147,6,841,0,841,0
6_7065323,feast_entertainment_beef_marzipan_manitoba_pennsylvania,7065323,6,841,0,841,0
6_6207230,feast_entertainment_beef_marzipan_pennsylvania_oregon,6207230,6,1130,0,1130,0
6_1984630,feast_aesthetics_beef_marzipan_bavaria_manitoba,1984630,6,1004,0,1004,0
6_528591,feast_aesthetics_beef_marzipan_manitoba_pennsylvania,528591,6,1004,0,1004,0
6_7937322,feast_aesthetics_beef_marzipan_pennsylvania_oregon,7937322,6,1280,0,1280,0
6_4348222,feast_lubricity_beef_marzipan_bavaria_manitoba,4348222,6,553,0,553,0
6_4060483,feast_lubricity_beef_marzipan_manitoba_pennsylvania,4060483,6,553,0,553,0
6_3242955,feast_lubricity_beef_marzipan_pennsylvania_oregon,3242955,6,788,0,788,0
6_3794934,overcome_abrasion_stimulation_marzipan_vulcan_uranus,3794934,6,683,0,683,0
6_7965539,overcome_abrasion_stimulation_marzipan_uranus_saturn,7965539,6,683,0,683,0
6_2434455,overcome_abrasion_entertainment_marzipan_vulcan_uranus,2434455,6,1013,0,1013,0
6_7454060,overcome_abrasion_lubricity_marzipan_vulcan_uranus,7454060,6,673,0,673,0
6_3623688,overcome_abrasion_lubricity_marzipan_uranus_saturn,3623688,6,666,0,666,0
6_3877455,overcome_prostatitis_stimulation_marzipan_vulcan_uranus,3877455,6,641,0,641,0
6_47083,overcome_prostatitis_stimulation_marzipan_uranus_saturn,47083,6,641,0,641,0
6_1870259,overcome_prostatitis_entertainment_marzipan_vulcan_uranus,1870259,6,973,0,973,0
6_6515348,overcome_prostatitis_lubricity_marzipan_vulcan_uranus,6515348,6,620,0,620,0
6_2684976,overcome_prostatitis_lubricity_marzipan_uranus_saturn,2684976,6,613,0,613,0
6_527883,overcome_jealousy_stimulation_marzipan_vulcan_uranus,527883,6,1190,0,1190,0
6_4698488,overcome_jealousy_stimulation_marzipan_uranus_saturn,4698488,6,1190,0,1190,0
6_4171749,overcome_jealousy_lubricity_marzipan_vulcan_uranus,4171749,6,1213,0,1213,0
6_341377,overcome_jealousy_lubricity_marzipan_uranus_saturn,341377,6,1208,0,1208,0
6_2855386,overcome_laceration_stimulation_marzipan_vulcan_uranus,2855386,6,659,0,659,0
6_7025991,overcome_laceration_stimulation_marzipan_uranus_saturn,7025991,6,659,0,659,0
6_3735719,overcome_laceration_entertainment_marzipan_vulcan_uranus,3735719,6,1007,0,1007,0
6_1933352,overcome_laceration_lubricity_marzipan_vulcan_uranus,1933352,6,753,0,753,0
6_6103957,overcome_laceration_lubricity_marzipan_uranus_saturn,6103957,6,746,0,746,0
6_2601920,noop_harmony_expectation_saturn,2601920,6,90,0,90,0
6_4815849,overcome_anxiety_expectation_onion_uranus_saturn,4815849,6,205,0,205,0
6_1199656,overcome_depression_expectation_okra_uranus_saturn,1199656,6,184,0,184,0
6_5868596,overcome_depression_expectation_snickers_uranus_saturn,5868596,6,187,0,187,0
6_7361263,overcome_depression_expectation_onion_uranus_saturn,7361263,6,244,0,244,0
6_4306136,overcome_hangover_expectation_okra_uranus_saturn,4306136,6,175,0,175,0
6_2522443,overcome_hangover_expectation_onion_uranus_saturn,2522443,6,271,0,271,0
6_6675930,overcome_hangover_expectation_snickers_uranus_saturn,6675930,6,178,0,178,0
6_2966295,harmony_expectation_uranus,2966295,6,61,31,92,0
6_1739057,harmony_expectation_earth,1739057,6,34,12,46,0
6_7462579,harmony_expectation_vulcan,7462579,6,33,10,43,0
6_4802981,noop_eats_marzipan_wonderbread,4802981,6,0,0,0,0
6_3765671,noop_fears_sciatica_lubricity,3765671,6,650,0,650,0
6_7489832,succumb_sciatica_lubricity_wonderbread_uranus_saturn,7489832,6,750,0,750,0
6_1966426,succumb_sciatica_lubricity_haroset_uranus_saturn,1966426,6,727,0,727,0
6_4944137,harmony_lubricity_earth,4944137,6,155,59,214,0
6_7755206,noop_craves_aesthetics_ham,7755206,6,958,0,958,0
6_7012217,locale_flounder_oregon,7012217,6,16,6,22,0
6_6440884,noop_craves_abrasion_lamb,6440884,6,178,0,178,0
6_6990583,overcome_abrasion_stimulation_lamb_vulcan_uranus,6990583,6,662,0,662,0
6_3160211,overcome_abrasion_stimulation_lamb_uranus_saturn,3160211,6,662,0,662,0
6_5625419,overcome_abrasion_entertainment_lamb_vulcan_uranus,5625419,6,951,0,951,0
6_3720425,overcome_abrasion_aesthetics_lamb_vulcan_uranus,3720425,6,1029,0,1029,0
6_7891030,overcome_abrasion_aesthetics_lamb_uranus_saturn,7891030,6,1022,0,1022,0
6_3317223,overcome_abrasion_lubricity_lamb_vulcan_uranus,3317223,6,658,0,658,0
6_7487828,overcome_abrasion_lubricity_lamb_uranus_saturn,7487828,6,649,0,649,0
6_1572380,noop_craves_angina_haroset,1572380,6,573,0,573,0
6_6135955,overcome_angina_stimulation_haroset_vulcan_uranus,6135955,6,1066,0,1066,0
6_2305583,overcome_angina_stimulation_haroset_uranus_saturn,2305583,6,1055,0,1055,0
6_7575357,overcome_angina_entertainment_haroset_vulcan_uranus,7575357,6,1007,0,1007,0
6_394710,overcome_angina_aesthetics_haroset_vulcan_uranus,394710,6,1105,0,1105,0
6_4565315,overcome_angina_aesthetics_haroset_uranus_saturn,4565315,6,1099,0,1099,0
6_7577871,noop_fears_prostatitis_entertainment,7577871,6,952,0,952,0
6_3477531,harmony_entertainment_uranus,3477531,6,128,62,190,0
6_2247302,craves_entertainment_lobster,2247302,6,28,16,44,0
6_5125653,craves_prostatitis_beef,5125653,6,26,5,31,0
6_5175958,noop_craves_depression_okra,5175958,6,104,0,104,0
6_5030028,overcome_depression_expectation_okra_vulcan_uranus,5030028,6,184,0,184,0
6_1390631,overcome_depression_learning_okra_uranus_saturn,1390631,6,199,0,199,0
6_2003721,noop_harmony_stimulation_uranus,2003721,6,462,0,462,0
6_5757246,succumb_hangover_stimulation_wonderbread_uranus_saturn,5757246,6,631,0,631,0
6_4955135,succumb_laceration_stimulation_tofu_uranus_saturn,4955135,6,676,0,676,0
6_6098332,succumb_laceration_stimulation_lamb_uranus_saturn,6098332,6,636,0,636,0
6_7627690,succumb_laceration_stimulation_wonderbread_uranus_saturn,7627690,6,641,0,641,0
6_3273587,succumb_laceration_stimulation_flounder_uranus_saturn,3273587,6,647,0,647,0
6_2543575,succumb_laceration_stimulation_cantelope_uranus_saturn,2543575,6,646,0,646,0
6_4027966,succumb_laceration_stimulation_beef_uranus_saturn,4027966,6,646,0,646,0
6_4019105,succumb_laceration_stimulation_bacon_uranus_saturn,4019105,6,1288,0,1288,0
6_7442272,succumb_laceration_stimulation_haroset_uranus_saturn,7442272,6,645,0,645,0
6_5925568,succumb_laceration_stimulation_lemon_uranus_saturn,5925568,6,644,0,644,0
6_3205064,succumb_laceration_stimulation_lobster_uranus_saturn,3205064,6,1191,0,1191,0
6_3194690,succumb_abrasion_stimulation_tofu_uranus_saturn,3194690,6,700,0,700,0
6_4337887,succumb_abrasion_stimulation_lamb_uranus_saturn,4337887,6,660,0,660,0
6_4882795,succumb_abrasion_stimulation_wonderbread_uranus_saturn,4882795,6,665,0,665,0
6_6794898,succumb_abrasion_stimulation_flounder_uranus_saturn,6794898,6,670,0,670,0
6_7889767,succumb_abrasion_stimulation_cantelope_uranus_saturn,7889767,6,670,0,670,0
6_2267521,succumb_abrasion_stimulation_beef_uranus_saturn,2267521,6,670,0,670,0
6_7987342,succumb_abrasion_stimulation_haroset_uranus_saturn,7987342,6,669,0,669,0
6_3306360,succumb_abrasion_stimulation_lemon_uranus_saturn,3306360,6,668,0,668,0
6_3750134,succumb_abrasion_stimulation_lobster_uranus_saturn,3750134,6,1218,0,1218,0
6_6088657,succumb_grief_stimulation_lamb_uranus_saturn,6088657,6,811,0,811,0
6_1690356,succumb_grief_stimulation_wonderbread_uranus_saturn,1690356,6,816,0,816,0
6_4824171,succumb_grief_stimulation_flounder_uranus_saturn,4824171,6,823,0,823,0
6_1542305,succumb_grief_stimulation_bacon_uranus_saturn,1542305,6,1288,0,1288,0
6_3697871,succumb_grief_stimulation_haroset_uranus_saturn,3697871,6,820,0,820,0
6_7461640,succumb_grief_stimulation_lobster_uranus_saturn,7461640,6,1219,0,1219,0
6_6958152,succumb_jealousy_stimulation_lamb_uranus_saturn,6958152,6,683,0,683,0
6_5673461,succumb_jealousy_stimulation_wonderbread_uranus_saturn,5673461,6,691,0,691,0
6_3527847,succumb_jealousy_stimulation_flounder_uranus_saturn,3527847,6,694,0,694,0
6_4887786,succumb_jealousy_stimulation_beef_uranus_saturn,4887786,6,693,0,693,0
6_105669,succumb_jealousy_stimulation_bacon_uranus_saturn,105669,6,1297,0,1297,0
6_7818311,succumb_jealousy_stimulation_haroset_uranus_saturn,7818311,6,692,0,692,0
6_2012132,succumb_jealousy_stimulation_lemon_uranus_saturn,2012132,6,690,0,690,0
6_3581103,succumb_jealousy_stimulation_lobster_uranus_saturn,3581103,6,1197,0,1197,0
6_474885,succumb_depression_stimulation_wonderbread_uranus_saturn,474885,6,634,0,634,0
6_5209785,succumb_sciatica_stimulation_wonderbread_uranus_saturn,5209785,6,738,0,738,0
6_2568518,succumb_sciatica_stimulation_bacon_uranus_saturn,2568518,6,1302,0,1302,0
6_1380377,succumb_sciatica_stimulation_haroset_uranus_saturn,1380377,6,741,0,741,0
6_5144146,succumb_sciatica_stimulation_lobster_uranus_saturn,5144146,6,1223,0,1223,0
6_5642169,succumb_dread_stimulation_wonderbread_uranus_saturn,5642169,6,591,0,591,0
6_5085559,succumb_prostatitis_stimulation_tofu_uranus_saturn,5085559,6,658,0,658,0
6_6228756,succumb_prostatitis_stimulation_lamb_uranus_saturn,6228756,6,639,0,639,0
6_516981,succumb_prostatitis_stimulation_wonderbread_uranus_saturn,516981,6,636,0,636,0
6_2829268,succumb_prostatitis_stimulation_cantelope_uranus_saturn,2829268,6,641,0,641,0
6_4158390,succumb_prostatitis_stimulation_beef_uranus_saturn,4158390,6,641,0,641,0
6_7310204,succumb_prostatitis_stimulation_lemon_uranus_saturn,7310204,6,640,0,640,0
6_6913214,succumb_loneliness_stimulation_tofu_uranus_saturn,6913214,6,599,0,599,0
6_1009853,overcome_sciatica_stimulation_lobster_vulcan_uranus,1009853,6,1231,0,1231,0
6_949983,overcome_sciatica_stimulation_bacon_vulcan_uranus,949983,6,1304,0,1304,0
6_5247061,overcome_sciatica_stimulation_haroset_vulcan_uranus,5247061,6,1052,0,1052,0
6_1342480,overcome_sciatica_stimulation_wonderbread_vulcan_uranus,1342480,6,740,0,740,0
6_7172225,overcome_abrasion_stimulation_cantelope_vulcan_uranus,7172225,6,672,0,672,0
6_4920217,overcome_abrasion_stimulation_beef_vulcan_uranus,4920217,6,672,0,672,0
6_3853049,overcome_abrasion_stimulation_haroset_vulcan_uranus,3853049,6,670,0,670,0
6_1015490,overcome_abrasion_stimulation_wonderbread_vulcan_uranus,1015490,6,667,0,667,0
6_6947189,overcome_depression_stimulation_wonderbread_vulcan_uranus,6947189,6,646,0,646,0
6_4271803,overcome_angina_stimulation_flounder_vulcan_uranus,4271803,6,641,0,641,0
6_1889941,overcome_hangover_stimulation_wonderbread_vulcan_uranus,1889941,6,636,0,636,0
6_6207355,overcome_anger_stimulation_lemon_vulcan_uranus,6207355,6,1168,0,1168,0
6_4294670,overcome_prostatitis_stimulation_cantelope_vulcan_uranus,4294670,6,643,0,643,0
6_598900,overcome_prostatitis_stimulation_wonderbread_vulcan_uranus,598900,6,638,0,638,0
6_951266,overcome_prostatitis_stimulation_tofu_vulcan_uranus,951266,6,660,0,660,0
6_2766459,overcome_dread_stimulation_wonderbread_vulcan_uranus,2766459,6,592,0,592,0
6_393597,overcome_jealousy_stimulation_lemon_vulcan_uranus,393597,6,1194,0,1194,0
6_1806156,overcome_jealousy_stimulation_wonderbread_vulcan_uranus,1806156,6,1191,0,1191,0
6_7447787,overcome_jealousy_stimulation_lobster_vulcan_uranus,7447787,6,1199,0,1199,0
6_652137,overcome_jealousy_stimulation_flounder_vulcan_uranus,652137,6,696,0,696,0
6_6488111,overcome_jealousy_stimulation_bacon_vulcan_uranus,6488111,6,1323,0,1323,0
6_3684018,overcome_jealousy_stimulation_haroset_vulcan_uranus,3684018,6,694,0,694,0
6_1609871,overcome_jealousy_stimulation_lamb_vulcan_uranus,1609871,6,685,0,685,0
6_7540482,overcome_jealousy_stimulation_beef_vulcan_uranus,7540482,6,695,0,695,0
6_6724730,overcome_laceration_stimulation_haroset_vulcan_uranus,6724730,6,647,0,647,0
6_7178510,overcome_laceration_stimulation_lamb_vulcan_uranus,7178510,6,638,0,638,0
6_5108144,overcome_laceration_stimulation_beef_vulcan_uranus,5108144,6,648,0,648,0
6_1791275,overcome_laceration_stimulation_lemon_vulcan_uranus,1791275,6,645,0,645,0
6_4702167,overcome_grief_stimulation_bacon_vulcan_uranus,4702167,6,1290,0,1290,0
6_352742,overcome_grief_stimulation_lamb_vulcan_uranus,352742,6,1203,0,1203,0
6_2113359,overcome_grief_stimulation_lobster_vulcan_uranus,2113359,6,1221,0,1221,0
6_6283353,overcome_grief_stimulation_beef_vulcan_uranus,6283353,6,1286,0,1286,0
6_6815623,overcome_grief_stimulation_wonderbread_vulcan_uranus,6815623,6,965,0,965,0
6_843471,noop_craves_entertainment_bacon,843471,6,501,0,501,0
6_6017560,succumb_grief_entertainment_bacon_vulcan_uranus,6017560,6,600,0,600,0
6_3700066,succumb_sciatica_entertainment_bacon_vulcan_uranus,3700066,6,590,0,590,0
6_2137023,succumb_jealousy_entertainment_bacon_vulcan_uranus,2137023,6,662,0,662,0
6_4744463,feast_entertainment_bacon_lobster_bavaria_manitoba,4744463,6,604,0,604,0
6_5546013,feast_entertainment_bacon_wonderbread_bavaria_manitoba,5546013,6,604,0,604,0
6_3736378,overcome_sciatica_entertainment_bacon_vulcan_uranus,3736378,6,592,0,592,0
6_4839884,overcome_grief_entertainment_bacon_vulcan_uranus,4839884,6,602,0,602,0
6_8131,noop_craves_learning_wonderbread,8131,6,84,0,84,0
6_3215560,succumb_grief_learning_wonderbread_vulcan_uranus,3215560,6,829,0,829,0
6_6361188,succumb_hangover_learning_wonderbread_vulcan_uranus,6361188,6,193,0,193,0
6_2009394,succumb_sciatica_learning_wonderbread_vulcan_uranus,2009394,6,486,0,486,0
6_2972091,succumb_depression_learning_wonderbread_vulcan_uranus,2972091,6,193,0,193,0
6_6563539,succumb_dread_learning_wonderbread_vulcan_uranus,6563539,6,177,0,177,0
6_7474894,overcome_sciatica_learning_wonderbread_uranus_saturn,7474894,6,352,0,352,0
6_2650810,overcome_abrasion_learning_wonderbread_uranus_saturn,2650810,6,316,0,316,0
6_3018377,overcome_depression_learning_wonderbread_uranus_saturn,3018377,6,196,0,196,0
6_3825711,overcome_hangover_learning_wonderbread_uranus_saturn,3825711,6,196,0,196,0
6_2733331,overcome_prostatitis_learning_wonderbread_uranus_saturn,2733331,6,261,0,261,0
6_5285237,overcome_dread_learning_wonderbread_uranus_saturn,5285237,6,180,0,180,0
6_7384736,overcome_jealousy_learning_wonderbread_uranus_saturn,7384736,6,928,0,928,0
6_1937258,overcome_grief_learning_wonderbread_uranus_saturn,1937258,6,630,0,630,0
6_1344146,locale_snickers_manitoba,1344146,6,18,20,38,0
6_4769340,fears_anxiety_learning,4769340,6,20,21,41,0
6_2875084,craves_learning_snickers,2875084,6,11,12,23,0
6_2404175,craves_learning_okra,2404175,6,15,14,29,0
6_1133227,craves_learning_onion,1133227,6,11,14,25,0
6_2720041,noop_fears_dread_achievement,2720041,6,45,0,45,0
6_3353748,succumb_dread_achievement_wonderbread_uranus_saturn,3353748,6,84,0,84,0
6_7184120,succumb_dread_achievement_wonderbread_vulcan_uranus,7184120,6,84,0,84,0
6_150287,fears_dread_learning,150287,6,23,18,41,0
6_7952859,craves_dread_wonderbread,7952859,6,45,12,57,0
6_688965,fears_dread_expectation,688965,6,20,14,34,0
6_1323959,noop_province_oregon,1323959,6,0,0,0,0
6_778640,noop_eats_onion_snickers,778640,6,0,0,0,0
6_1950022,noop_fears_hangover_stimulation,1950022,6,586,0,586,0
6_478591,fears_hangover_expectation,478591,6,35,19,54,0
6_1750334,craves_hangover_snickers,1750334,6,23,16,39,0
6_2633557,craves_hangover_okra,2633557,6,23,13,36,0
6_4681374,craves_hangover_wonderbread,4681374,6,49,22,71,0
6_2802576,fears_hangover_learning,2802576,6,33,19,52,0
6_6919532,fears_hangover_achievement,6919532,6,17,14,31,0
6_6295867,noop_craves_anger_ham,6295867,6,120,0,120,0
6_3570034,noop_craves_abrasion_cantelope,3570034,6,178,0,178,0
6_3341853,overcome_abrasion_stimulation_cantelope_uranus_saturn,3341853,6,672,0,672,0
6_2931612,overcome_abrasion_entertainment_cantelope_vulcan_uranus,2931612,6,1001,0,1001,0
6_7794172,overcome_abrasion_lubricity_cantelope_vulcan_uranus,7794172,6,662,0,662,0
6_3963800,overcome_abrasion_lubricity_cantelope_uranus_saturn,3963800,6,655,0,655,0
6_116634,noop_harmony_expectation_earth,116634,6,92,0,92,0
6_1891404,harmony_expectation_saturn,1891404,6,61,2,63,0
6_2821384,noop_fears_anxiety_stimulation,2821384,6,621,0,621,0
6_3837243,craves_anxiety_onion,3837243,6,23,14,37,0
6_3046200,locale_tofu_manitoba,3046200,6,14,6,20,0
6_1145084,noop_fears_abrasion_aesthetics,1145084,6,1054,0,1054,0
6_3520096,succumb_abrasion_aesthetics_lamb_uranus_saturn,3520096,6,1104,0,1104,0
6_6305720,harmony_aesthetics_earth,6305720,6,107,29,136,0
6_1706395,noop_craves_grief_bacon,1706395,6,341,0,341,0
6_871795,overcome_grief_stimulation_bacon_uranus_saturn,871795,6,1286,0,1286,0
6_4086635,overcome_grief_aesthetics_bacon_vulcan_uranus,4086635,6,467,0,467,0
6_256263,overcome_grief_aesthetics_bacon_uranus_saturn,256263,6,467,0,467,0
6_6230769,noop_locale_snickers_bavaria,6230769,6,7,0,7,0
6_7173461,noop_harmony_stimulation_earth,7173461,6,403,0,403,0
6_7779537,noop_craves_hangover_okra,7779537,6,88,0,88,0
6_135531,overcome_hangover_expectation_okra_vulcan_uranus,135531,6,175,0,175,0
6_118053,overcome_hangover_learning_okra_uranus_saturn,118053,6,199,0,199,0
6_1477182,noop_craves_love_bacon,1477182,6,812,0,812,0
6_5280719,noop_eats_snickers_onion,5280719,6,0,0,0,0
6_6245149,feast_expectation_snickers_onion_bavaria_manitoba,6245149,6,202,0,202,0
6_2466891,feast_learning_snickers_onion_bavaria_manitoba,2466891,6,138,0,138,0
6_1666233,noop_craves_stimulation_marzipan,1666233,6,524,0,524,0
6_1137858,noop_craves_entertainment_marzipan,1137858,6,861,0,861,0
6_2854983,noop_craves_grief_lamb,2854983,6,788,0,788,0
6_4523347,overcome_grief_stimulation_lamb_uranus_saturn,4523347,6,1203,0,1203,0
6_1197133,overcome_grief_entertainment_lamb_vulcan_uranus,1197133,6,886,0,886,0
6_5725994,overcome_grief_aesthetics_lamb_vulcan_uranus,5725994,6,957,0,957,0
6_1895622,overcome_grief_aesthetics_lamb_uranus_saturn,1895622,6,957,0,957,0
6_7794353,overcome_grief_lubricity_lamb_vulcan_uranus,7794353,6,1216,0,1216,0
6_3963981,overcome_grief_lubricity_lamb_uranus_saturn,3963981,6,1208,0,1208,0
6_5772160,noop_craves_boils_marzipan,5772160,6,524,0,524,0
6_1260143,noop_craves_love_lamb,1260143,6,691,0,691,0
6_3800886,noop_pain_sciatica,3800886,6,0,0,0,0
6_5169740,succumb_sciatica_aesthetics_bacon_uranus_saturn,5169740,6,406,0,406,0
6_999135,succumb_sciatica_aesthetics_bacon_vulcan_uranus,999135,6,406,0,406,0
6_2012199,succumb_sciatica_aesthetics_lobster_uranus_saturn,2012199,6,429,0,429,0
6_5842571,succumb_sciatica_aesthetics_lobster_vulcan_uranus,5842571,6,429,0,429,0
6_1937273,succumb_sciatica_aesthetics_flounder_uranus_saturn,1937273,6,935,0,935,0
6_4668313,succumb_sciatica_aesthetics_wonderbread_uranus_saturn,4668313,6,428,0,428,0
6_497708,succumb_sciatica_aesthetics_wonderbread_vulcan_uranus,497708,6,428,0,428,0
6_258363,succumb_sciatica_aesthetics_lamb_uranus_saturn,258363,6,936,0,936,0
6_6249407,succumb_sciatica_aesthetics_haroset_uranus_saturn,6249407,6,656,0,656,0
6_2078802,succumb_sciatica_aesthetics_haroset_vulcan_uranus,2078802,6,656,0,656,0
6_2921364,succumb_sciatica_achievement_wonderbread_uranus_saturn,2921364,6,392,0,392,0
6_6751736,succumb_sciatica_achievement_wonderbread_vulcan_uranus,6751736,6,392,0,392,0
6_5210749,succumb_sciatica_stimulation_haroset_vulcan_uranus,5210749,6,741,0,741,0
6_973541,succumb_sciatica_stimulation_lobster_vulcan_uranus,973541,6,1222,0,1222,0
6_4678647,succumb_sciatica_entertainment_haroset_vulcan_uranus,4678647,6,590,0,590,0
6_2496319,succumb_sciatica_entertainment_wonderbread_vulcan_uranus,2496319,6,601,0,601,0
6_7055036,overcome_sciatica_achievement_wonderbread_vulcan_uranus,7055036,6,258,0,258,0
6_3224664,overcome_sciatica_achievement_wonderbread_uranus_saturn,3224664,6,258,0,258,0
6_5180458,overcome_sciatica_stimulation_lobster_uranus_saturn,5180458,6,1225,0,1225,0
6_5120588,overcome_sciatica_stimulation_bacon_uranus_saturn,5120588,6,1299,0,1299,0
6_1416689,overcome_sciatica_stimulation_haroset_uranus_saturn,1416689,6,1040,0,1040,0
6_5513085,overcome_sciatica_stimulation_wonderbread_uranus_saturn,5513085,6,740,0,740,0
6_5138251,overcome_sciatica_entertainment_wonderbread_vulcan_uranus,5138251,6,603,0,603,0
6_3092377,overcome_sciatica_aesthetics_lobster_vulcan_uranus,3092377,6,431,0,431,0
6_7262982,overcome_sciatica_aesthetics_lobster_uranus_saturn,7262982,6,431,0,431,0
6_7822436,overcome_sciatica_aesthetics_bacon_vulcan_uranus,7822436,6,408,0,408,0
6_3992064,overcome_sciatica_aesthetics_bacon_uranus_saturn,3992064,6,408,0,408,0
6_3499213,overcome_sciatica_aesthetics_haroset_uranus_saturn,3499213,6,659,0,659,0
6_4374366,overcome_sciatica_aesthetics_wonderbread_vulcan_uranus,4374366,6,430,0,430,0
6_543994,overcome_sciatica_aesthetics_wonderbread_uranus_saturn,543994,6,430,0,430,0
6_281288,overcome_sciatica_lubricity_lobster_uranus_saturn,281288,6,1245,0,1245,0
6_347891,overcome_sciatica_lubricity_haroset_vulcan_uranus,347891,6,1047,0,1047,0
6_4518496,overcome_sciatica_lubricity_haroset_uranus_saturn,4518496,6,1033,0,1033,0
6_6772290,overcome_sciatica_lubricity_wonderbread_vulcan_uranus,6772290,6,751,0,751,0
6_2941918,overcome_sciatica_lubricity_wonderbread_uranus_saturn,2941918,6,745,0,745,0
6_7165176,noop_craves_dread_wonderbread,7165176,6,45,0,45,0
6_478038,overcome_dread_achievement_wonderbread_vulcan_uranus,478038,6,86,0,86,0
6_4648643,overcome_dread_achievement_wonderbread_uranus_saturn,4648643,6,87,0,87,0
6_6937064,overcome_dread_stimulation_wonderbread_uranus_saturn,6937064,6,593,0,593,0
6_3630267,overcome_dread_entertainment_wonderbread_vulcan_uranus,3630267,6,564,0,564,0
6_535709,overcome_dread_aesthetics_wonderbread_vulcan_uranus,535709,6,397,0,397,0
6_4706314,overcome_dread_aesthetics_wonderbread_uranus_saturn,4706314,6,397,0,397,0
6_6288488,overcome_dread_lubricity_wonderbread_vulcan_uranus,6288488,6,602,0,602,0
6_2458116,overcome_dread_lubricity_wonderbread_uranus_saturn,2458116,6,596,0,596,0
6_7129906,fears_dread_achievement,7129906,6,13,5,18,0
6_513547,noop_craves_boils_lemon,513547,6,178,0,178,0
6_7667263,noop_fears_hangover_aesthetics,7667263,6,396,0,396,0
6_1013755,succumb_hangover_aesthetics_wonderbread_uranus_saturn,1013755,6,443,0,443,0
6_4844127,succumb_hangover_aesthetics_wonderbread_vulcan_uranus,4844127,6,443,0,443,0
6_376993,noop_craves_love_tofu,376993,6,711,0,711,0
6_1498085,noop_locale_lamb_goias,1498085,6,55,0,55,0
6_2708932,feast_stimulation_lamb_beef_oregon_goias,2708932,6,587,0,587,0
6_4440354,feast_stimulation_lamb_haroset_oregon_goias,4440354,6,587,0,587,0
6_1685627,feast_entertainment_lamb_beef_oregon_goias,1685627,6,841,0,841,0
6_3832902,feast_entertainment_lamb_haroset_oregon_goias,3832902,6,841,0,841,0
6_3081722,feast_aesthetics_lamb_beef_oregon_goias,3081722,6,911,0,911,0
6_3070140,feast_aesthetics_lamb_haroset_oregon_goias,3070140,6,911,0,911,0
6_3218010,feast_lubricity_lamb_beef_oregon_goias,3218010,6,564,0,564,0
6_1075334,feast_lubricity_lamb_haroset_oregon_goias,1075334,6,564,0,564,0
6_7957589,locale_lamb_manitoba,7957589,6,25,15,40,0
6_7086086,locale_lamb_pennsylvania,7086086,6,25,15,40,0
6_7037277,locale_lamb_oregon,7037277,6,25,9,34,0
6_1573596,noop_fears_laceration_stimulation,1573596,6,204,0,204,0
6_1927727,succumb_laceration_stimulation_lamb_vulcan_uranus,1927727,6,636,0,636,0
6_7103959,succumb_laceration_stimulation_flounder_vulcan_uranus,7103959,6,646,0,646,0
6_7858338,succumb_laceration_stimulation_beef_vulcan_uranus,7858338,6,646,0,646,0
6_3271667,succumb_laceration_stimulation_haroset_vulcan_uranus,3271667,6,645,0,645,0
6_1754963,succumb_laceration_stimulation_lemon_vulcan_uranus,1754963,6,643,0,643,0
6_7035436,succumb_laceration_stimulation_lobster_vulcan_uranus,7035436,6,1190,0,1190,0
6_6772543,noop_pain_anxiety,6772543,6,0,0,0,0
6_5717126,succumb_anxiety_learning_onion_vulcan_uranus,5717126,6,145,0,145,0
6_1822920,succumb_anxiety_expectation_onion_vulcan_uranus,1822920,6,261,0,261,0
6_5993525,succumb_anxiety_expectation_onion_uranus_saturn,5993525,6,255,0,255,0
6_645244,overcome_anxiety_expectation_onion_vulcan_uranus,645244,6,204,0,204,0
6_321444,overcome_anxiety_learning_onion_uranus_saturn,321444,6,146,0,146,0
6_3291100,overcome_anxiety_stimulation_onion_uranus_saturn,3291100,6,625,0,625,0
6_2058750,overcome_anxiety_lubricity_onion_uranus_saturn,2058750,6,611,0,611,0
6_3958185,noop_attacks_pennsylvania_oregon,3958185,6,0,0,0,0
6_4906729,feast_stimulation_lamb_beef_pennsylvania_oregon,4906729,6,586,0,586,0
6_3499158,feast_stimulation_lamb_haroset_pennsylvania_oregon,3499158,6,586,0,586,0
6_3507238,feast_stimulation_flounder_haroset_pennsylvania_oregon,3507238,6,597,0,597,0
6_4576090,feast_lubricity_flounder_haroset_pennsylvania_oregon,4576090,6,578,0,578,0
6_5919561,feast_stimulation_beef_lamb_pennsylvania_oregon,5919561,6,872,0,872,0
6_4522139,feast_aesthetics_flounder_haroset_pennsylvania_oregon,4522139,6,900,0,900,0
6_2582759,feast_entertainment_lamb_beef_pennsylvania_oregon,2582759,6,840,0,840,0
6_1872809,feast_entertainment_lamb_haroset_pennsylvania_oregon,1872809,6,840,0,840,0
6_3218509,feast_aesthetics_lamb_beef_pennsylvania_oregon,3218509,6,910,0,910,0
6_6505132,feast_aesthetics_lamb_haroset_pennsylvania_oregon,6505132,6,910,0,910,0
6_977467,feast_lubricity_lamb_beef_pennsylvania_oregon,977467,6,563,0,563,0
6_7955724,feast_lubricity_lamb_haroset_pennsylvania_oregon,7955724,6,563,0,563,0
6_3595591,feast_entertainment_beef_lamb_pennsylvania_oregon,3595591,6,1130,0,1130,0
6_4231341,feast_aesthetics_beef_lamb_pennsylvania_oregon,4231341,6,1280,0,1280,0
6_1990299,feast_lubricity_beef_lamb_pennsylvania_oregon,1990299,6,788,0,788,0
6_5721338,feast_entertainment_flounder_haroset_pennsylvania_oregon,5721338,6,830,0,830,0
6_4813922,noop_harmony_learning_saturn,4813922,6,87,0,87,0
6_2696465,overcome_depression_learning_snickers_uranus_saturn,2696465,6,175,0,175,0
6_244024,overcome_depression_learning_onion_uranus_saturn,244024,6,198,0,198,0
6_5858622,overcome_hangover_learning_snickers_uranus_saturn,5858622,6,175,0,175,0
6_2297701,harmony_learning_uranus,2297701,6,59,1,60,0
6_2799837,noop_craves_lubricity_marzipan,2799837,6,501,0,501,0
6_4396286,noop_craves_jealousy_lemon,4396286,6,794,0,794,0
6_4564202,overcome_jealousy_stimulation_lemon_uranus_saturn,4564202,6,1194,0,1194,0
6_4651841,overcome_jealousy_lubricity_lemon_vulcan_uranus,4651841,6,1209,0,1209,0
6_821469,overcome_jealousy_lubricity_lemon_uranus_saturn,821469,6,1209,0,1209,0
6_7424527,harmony_love_vulcan,7424527,6,143,32,175,0
6_873646,noop_fears_grief_expectation,873646,6,783,0,783,0
6_3197964,noop_locale_beef_manitoba,3197964,6,48,0,48,0
6_4255301,feast_stimulation_beef_lamb_bavaria_manitoba,4255301,6,591,0,591,0
6_766152,feast_entertainment_beef_lamb_bavaria_manitoba,766152,6,842,0,842,0
6_5523505,feast_aesthetics_beef_lamb_bavaria_manitoba,5523505,6,1005,0,1005,0
6_6915697,feast_lubricity_beef_lamb_bavaria_manitoba,6915697,6,554,0,554,0
6_7015491,locale_beef_pennsylvania,7015491,6,33,15,48,0
6_5689671,locale_beef_bavaria,5689671,6,18,2,20,0
6_1760814,noop_locale_onion_bavaria,1760814,6,0,0,0,0
6_6949341,noop_craves_abrasion_beef,6949341,6,178,0,178,0
6_1089845,overcome_abrasion_stimulation_beef_uranus_saturn,1089845,6,672,0,672,0
6_3555053,overcome_abrasion_entertainment_beef_vulcan_uranus,3555053,6,955,0,955,0
6_5820664,overcome_abrasion_aesthetics_beef_uranus_saturn,5820664,6,1110,0,1110,0
6_1246857,overcome_abrasion_lubricity_beef_vulcan_uranus,1246857,6,661,0,661,0
6_5417462,overcome_abrasion_lubricity_beef_uranus_saturn,5417462,6,645,0,645,0
6_6243624,noop_fears_anxiety_lubricity,6243624,6,606,0,606,0
6_5662014,noop_craves_love_lemon,5662014,6,670,0,670,0
6_942287,noop_locale_ham_oregon,942287,6,46,0,46,0
6_157616,locale_ham_goias,157616,6,24,7,31,0
6_2114526,locale_ham_bosnia,2114526,6,14,9,23,0
6_7946530,locale_ham_pennsylvania,7946530,6,24,9,33,0
6_1477183,noop_food_tofu,1477183,6,0,0,0,0
6_4916647,succumb_prostatitis_lubricity_tofu_uranus_saturn,4916647,6,636,0,636,0
6_5242032,succumb_loneliness_lubricity_tofu_uranus_saturn,5242032,6,585,0,585,0
6_7015141,succumb_abrasion_lubricity_tofu_uranus_saturn,7015141,6,689,0,689,0
6_5121871,overcome_prostatitis_stimulation_tofu_uranus_saturn,5121871,6,660,0,660,0
6_3543510,overcome_prostatitis_entertainment_tofu_vulcan_uranus,3543510,6,982,0,982,0
6_3298112,overcome_prostatitis_lubricity_tofu_vulcan_uranus,3298112,6,638,0,638,0
6_7468717,overcome_prostatitis_lubricity_tofu_uranus_saturn,7468717,6,631,0,631,0
6_6962491,overcome_laceration_entertainment_tofu_vulcan_uranus,6962491,6,1329,0,1329,0
6_6943288,overcome_laceration_lubricity_tofu_vulcan_uranus,6943288,6,1116,0,1116,0
6_3112916,overcome_laceration_lubricity_tofu_uranus_saturn,3112916,6,1112,0,1112,0
6_2360333,noop_food_lamb,2360333,6,0,0,0,0
6_4827176,succumb_grief_entertainment_lamb_vulcan_uranus,4827176,6,879,0,879,0
6_6059844,succumb_prostatitis_lubricity_lamb_uranus_saturn,6059844,6,617,0,617,0
6_1889239,succumb_prostatitis_lubricity_lamb_vulcan_uranus,1889239,6,624,0,624,0
6_2120551,succumb_laceration_aesthetics_lamb_uranus_saturn,2120551,6,1021,0,1021,0
6_6810793,succumb_laceration_entertainment_lamb_vulcan_uranus,6810793,6,942,0,942,0
6_167282,succumb_abrasion_stimulation_lamb_vulcan_uranus,167282,6,659,0,659,0
6_1918052,succumb_grief_stimulation_lamb_vulcan_uranus,1918052,6,811,0,811,0
6_374636,succumb_abrasion_entertainment_lamb_vulcan_uranus,374636,6,959,0,959,0
6_2787547,succumb_jealousy_stimulation_lamb_vulcan_uranus,2787547,6,682,0,682,0
6_157361,succumb_abrasion_lubricity_lamb_uranus_saturn,157361,6,655,0,655,0
6_3987733,succumb_abrasion_lubricity_lamb_vulcan_uranus,3987733,6,662,0,662,0
6_7291748,succumb_anger_lubricity_lamb_uranus_saturn,7291748,6,593,0,593,0
6_3121143,succumb_anger_lubricity_lamb_vulcan_uranus,3121143,6,600,0,600,0
6_5433789,succumb_laceration_lubricity_lamb_uranus_saturn,5433789,6,684,0,684,0
6_1263184,succumb_laceration_lubricity_lamb_vulcan_uranus,1263184,6,691,0,691,0
6_2058151,succumb_prostatitis_stimulation_lamb_vulcan_uranus,2058151,6,639,0,639,0
6_3335266,succumb_grief_lubricity_lamb_uranus_saturn,3335266,6,814,0,814,0
6_7165638,succumb_grief_lubricity_lamb_vulcan_uranus,7165638,6,814,0,814,0
6_5093302,succumb_jealousy_entertainment_lamb_vulcan_uranus,5093302,6,908,0,908,0
6_2342116,succumb_jealousy_lubricity_lamb_uranus_saturn,2342116,6,684,0,684,0
6_6172488,succumb_jealousy_lubricity_lamb_vulcan_uranus,6172488,6,691,0,691,0
6_3838791,feast_stimulation_lamb_beef_manitoba_pennsylvania,3838791,6,586,0,586,0
6_1955017,feast_stimulation_lamb_beef_bavaria_manitoba,1955017,6,586,0,586,0
6_5170983,feast_stimulation_lamb_beef_goias_bosnia,5170983,6,698,0,698,0
6_529568,feast_stimulation_lamb_haroset_manitoba_pennsylvania,529568,6,586,0,586,0
6_7971729,feast_stimulation_lamb_haroset_bavaria_manitoba,7971729,6,586,0,586,0
6_6902405,feast_stimulation_lamb_haroset_goias_bosnia,6902405,6,698,0,698,0
6_4691551,feast_stimulation_beef_lamb_manitoba_pennsylvania,4691551,6,590,0,590,0
6_6739043,feast_entertainment_lamb_beef_manitoba_pennsylvania,6739043,6,840,0,840,0
6_6466845,feast_entertainment_lamb_beef_bavaria_manitoba,6466845,6,840,0,840,0
6_4147678,feast_entertainment_lamb_beef_goias_bosnia,4147678,6,1224,0,1224,0
6_5137098,feast_entertainment_lamb_haroset_manitoba_pennsylvania,5137098,6,840,0,840,0
6_5647759,feast_entertainment_lamb_haroset_bavaria_manitoba,5647759,6,840,0,840,0
6_6294953,feast_entertainment_lamb_haroset_goias_bosnia,6294953,6,1224,0,1224,0
6_2162827,feast_aesthetics_lamb_beef_manitoba_pennsylvania,2162827,6,910,0,910,0
6_3223221,feast_aesthetics_lamb_beef_bavaria_manitoba,3223221,6,910,0,910,0
6_5543773,feast_aesthetics_lamb_beef_goias_bosnia,5543773,6,1294,0,1294,0
6_7986915,feast_aesthetics_lamb_haroset_manitoba_pennsylvania,7986915,6,910,0,910,0
6_6283509,feast_aesthetics_lamb_haroset_bavaria_manitoba,6283509,6,910,0,910,0
6_5532191,feast_aesthetics_lamb_haroset_goias_bosnia,5532191,6,1294,0,1294,0
6_7169104,feast_lubricity_lamb_beef_manitoba_pennsylvania,7169104,6,563,0,563,0
6_4615413,feast_lubricity_lamb_beef_bavaria_manitoba,4615413,6,563,0,563,0
6_5680061,feast_lubricity_lamb_beef_goias_bosnia,5680061,6,1114,0,1114,0
6_6375513,feast_lubricity_lamb_haroset_manitoba_pennsylvania,6375513,6,563,0,563,0
6_4042467,feast_lubricity_lamb_haroset_bavaria_manitoba,4042467,6,563,0,563,0
6_3537385,feast_lubricity_lamb_haroset_goias_bosnia,3537385,6,1114,0,1114,0
6_7591803,feast_entertainment_beef_lamb_manitoba_pennsylvania,7591803,6,841,0,841,0
6_3015587,feast_aesthetics_beef_lamb_manitoba_pennsylvania,3015587,6,1004,0,1004,0
6_20887,feast_lubricity_beef_lamb_manitoba_pennsylvania,20887,6,553,0,553,0
6_5780476,overcome_jealousy_stimulation_lamb_uranus_saturn,5780476,6,684,0,684,0
6_2343108,overcome_jealousy_entertainment_lamb_vulcan_uranus,2343108,6,910,0,910,0
6_2949315,overcome_jealousy_aesthetics_lamb_vulcan_uranus,2949315,6,985,0,985,0
6_7119920,overcome_jealousy_aesthetics_lamb_uranus_saturn,7119920,6,977,0,977,0
6_5501978,overcome_jealousy_lubricity_lamb_vulcan_uranus,5501978,6,686,0,686,0
6_1671606,overcome_jealousy_lubricity_lamb_uranus_saturn,1671606,6,677,0,677,0
6_3348138,overcome_laceration_stimulation_lamb_uranus_saturn,3348138,6,637,0,637,0
6_104711,overcome_laceration_entertainment_lamb_vulcan_uranus,104711,6,944,0,944,0
6_502016,overcome_laceration_aesthetics_lamb_vulcan_uranus,502016,6,1023,0,1023,0
6_4672621,overcome_laceration_aesthetics_lamb_uranus_saturn,4672621,6,1015,0,1015,0
6_85508,overcome_laceration_lubricity_lamb_vulcan_uranus,85508,6,686,0,686,0
6_4256113,overcome_laceration_lubricity_lamb_uranus_saturn,4256113,6,677,0,677,0
6_4565515,noop_orbits_vulcan_uranus,4565515,6,0,0,0,0
6_7924023,succumb_grief_entertainment_lemon_vulcan_uranus,7924023,6,890,0,890,0
6_2756810,succumb_grief_entertainment_beef_vulcan_uranus,2756810,6,890,0,890,0
6_1419040,succumb_grief_entertainment_haroset_vulcan_uranus,1419040,6,600,0,600,0
6_4889090,succumb_grief_entertainment_flounder_vulcan_uranus,4889090,6,879,0,879,0
6_5362331,succumb_grief_entertainment_wonderbread_vulcan_uranus,5362331,6,611,0,611,0
6_7780222,succumb_depression_expectation_okra_vulcan_uranus,7780222,6,181,0,181,0
6_5822310,succumb_depression_expectation_snickers_vulcan_uranus,5822310,6,184,0,184,0
6_3154346,succumb_depression_expectation_onion_vulcan_uranus,3154346,6,247,0,247,0
6_7903989,succumb_prostatitis_lubricity_lemon_vulcan_uranus,7903989,6,626,0,626,0
6_3636552,succumb_prostatitis_lubricity_cantelope_vulcan_uranus,3636552,6,627,0,627,0
6_7819850,succumb_prostatitis_lubricity_beef_vulcan_uranus,7819850,6,625,0,625,0
6_1146924,succumb_laceration_aesthetics_lobster_vulcan_uranus,1146924,6,710,0,710,0
6_5384132,succumb_laceration_aesthetics_haroset_vulcan_uranus,5384132,6,757,0,757,0
6_3232307,succumb_grief_achievement_wonderbread_vulcan_uranus,3232307,6,736,0,736,0
6_7754586,succumb_dread_entertainment_wonderbread_vulcan_uranus,7754586,6,632,0,632,0
6_3667447,succumb_laceration_entertainment_lemon_vulcan_uranus,3667447,6,993,0,993,0
6_4740427,succumb_laceration_entertainment_beef_vulcan_uranus,4740427,6,953,0,953,0
6_4518386,succumb_laceration_entertainment_haroset_vulcan_uranus,4518386,6,663,0,663,0
6_6224943,succumb_laceration_entertainment_flounder_vulcan_uranus,6224943,6,949,0,949,0
6_2624293,succumb_abrasion_stimulation_flounder_vulcan_uranus,2624293,6,670,0,670,0
6_6097893,succumb_abrasion_stimulation_beef_vulcan_uranus,6097893,6,669,0,669,0
6_3816737,succumb_abrasion_stimulation_haroset_vulcan_uranus,3816737,6,668,0,668,0
6_7136732,succumb_abrasion_stimulation_lemon_vulcan_uranus,7136732,6,667,0,667,0
6_7580506,succumb_abrasion_stimulation_lobster_vulcan_uranus,7580506,6,1218,0,1218,0
6_653566,succumb_grief_stimulation_flounder_vulcan_uranus,653566,6,823,0,823,0
6_7528243,succumb_grief_stimulation_haroset_vulcan_uranus,7528243,6,819,0,819,0
6_3291035,succumb_grief_stimulation_lobster_vulcan_uranus,3291035,6,1218,0,1218,0
6_5513735,succumb_hangover_learning_okra_vulcan_uranus,5513735,6,196,0,196,0
6_7004995,succumb_hangover_learning_onion_vulcan_uranus,7004995,6,190,0,190,0
6_7136924,succumb_hangover_learning_snickers_vulcan_uranus,7136924,6,172,0,172,0
6_3979665,succumb_angina_entertainment_lemon_vulcan_uranus,3979665,6,922,0,922,0
6_3418878,succumb_angina_entertainment_flounder_vulcan_uranus,3418878,6,882,0,882,0
6_2016836,succumb_depression_achievement_wonderbread_vulcan_uranus,2016836,6,142,0,142,0
6_4212517,succumb_abrasion_entertainment_lemon_vulcan_uranus,4212517,6,999,0,999,0
6_6305247,succumb_abrasion_entertainment_beef_vulcan_uranus,6305247,6,959,0,959,0
6_850069,succumb_depression_learning_okra_vulcan_uranus,850069,6,196,0,196,0
6_5252072,succumb_depression_learning_onion_vulcan_uranus,5252072,6,195,0,195,0
6_6490525,succumb_depression_learning_snickers_vulcan_uranus,6490525,6,172,0,172,0
6_7358219,succumb_jealousy_stimulation_flounder_vulcan_uranus,7358219,6,693,0,693,0
6_717181,succumb_jealousy_stimulation_beef_vulcan_uranus,717181,6,692,0,692,0
6_3647706,succumb_jealousy_stimulation_haroset_vulcan_uranus,3647706,6,691,0,691,0
6_5842504,succumb_jealousy_stimulation_lemon_vulcan_uranus,5842504,6,690,0,690,0
6_7411475,succumb_jealousy_stimulation_lobster_vulcan_uranus,7411475,6,1196,0,1196,0
6_499397,succumb_dread_aesthetics_wonderbread_vulcan_uranus,499397,6,395,0,395,0
6_2327531,succumb_abrasion_lubricity_flounder_vulcan_uranus,2327531,6,663,0,663,0
6_1052017,succumb_abrasion_lubricity_lemon_vulcan_uranus,1052017,6,651,0,651,0
6_7757860,succumb_abrasion_lubricity_cantelope_vulcan_uranus,7757860,6,667,0,667,0
6_1917367,succumb_abrasion_lubricity_beef_vulcan_uranus,1917367,6,665,0,665,0
6_4519547,succumb_hangover_entertainment_wonderbread_vulcan_uranus,4519547,6,679,0,679,0
6_7299197,succumb_hangover_achievement_wonderbread_vulcan_uranus,7299197,6,130,0,130,0
6_65395,succumb_anger_lubricity_flounder_vulcan_uranus,65395,6,600,0,600,0
6_3232333,succumb_anger_lubricity_lemon_vulcan_uranus,3232333,6,602,0,602,0
6_762711,succumb_laceration_lubricity_flounder_vulcan_uranus,762711,6,692,0,692,0
6_7653449,succumb_laceration_lubricity_lemon_vulcan_uranus,7653449,6,680,0,680,0
6_7193795,succumb_laceration_lubricity_beef_vulcan_uranus,7193795,6,694,0,694,0
6_1313207,succumb_hangover_expectation_okra_vulcan_uranus,1313207,6,172,0,172,0
6_1210430,succumb_hangover_expectation_snickers_vulcan_uranus,1210430,6,175,0,175,0
6_3800745,succumb_hangover_expectation_onion_vulcan_uranus,3800745,6,241,0,241,0
6_5981887,succumb_depression_entertainment_wonderbread_vulcan_uranus,5981887,6,691,0,691,0
6_7988762,succumb_prostatitis_stimulation_beef_vulcan_uranus,7988762,6,640,0,640,0
6_3139599,succumb_prostatitis_stimulation_lemon_vulcan_uranus,3139599,6,640,0,640,0
6_6780071,succumb_grief_lubricity_flounder_vulcan_uranus,6780071,6,815,0,815,0
6_4043486,succumb_jealousy_entertainment_lemon_vulcan_uranus,4043486,6,948,0,948,0
6_3022936,succumb_jealousy_entertainment_beef_vulcan_uranus,3022936,6,908,0,908,0
6_5601130,succumb_jealousy_entertainment_haroset_vulcan_uranus,5601130,6,655,0,655,0
6_3373212,succumb_jealousy_entertainment_flounder_vulcan_uranus,3373212,6,915,0,915,0
6_4686816,succumb_anger_aesthetics_haroset_vulcan_uranus,4686816,6,960,0,960,0
6_1176045,succumb_anger_entertainment_lemon_vulcan_uranus,1176045,6,921,0,921,0
6_3934553,succumb_anger_entertainment_haroset_vulcan_uranus,3934553,6,870,0,870,0
6_781281,succumb_anger_entertainment_flounder_vulcan_uranus,781281,6,870,0,870,0
6_7046197,succumb_jealousy_lubricity_flounder_vulcan_uranus,7046197,6,692,0,692,0
6_4102122,succumb_jealousy_lubricity_beef_vulcan_uranus,4102122,6,694,0,694,0
6_6728046,overcome_abrasion_achievement_wonderbread_vulcan_uranus,6728046,6,221,0,221,0
6_5316664,overcome_abrasion_entertainment_haroset_vulcan_uranus,5316664,6,653,0,653,0
6_2138017,overcome_abrasion_entertainment_wonderbread_vulcan_uranus,2138017,6,669,0,669,0
6_4198758,overcome_abrasion_aesthetics_haroset_vulcan_uranus,4198758,6,757,0,757,0
6_3810520,overcome_abrasion_aesthetics_wonderbread_vulcan_uranus,3810520,6,518,0,518,0
6_7180247,overcome_abrasion_lubricity_haroset_vulcan_uranus,7180247,6,656,0,656,0
6_3957244,overcome_abrasion_lubricity_wonderbread_vulcan_uranus,3957244,6,687,0,687,0
6_1697991,overcome_depression_expectation_snickers_vulcan_uranus,1697991,6,186,0,186,0
6_3190658,overcome_depression_expectation_onion_vulcan_uranus,3190658,6,243,0,243,0
6_4658768,overcome_depression_achievement_wonderbread_vulcan_uranus,4658768,6,144,0,144,0
6_6495159,overcome_depression_entertainment_wonderbread_vulcan_uranus,6495159,6,622,0,622,0
6_1739685,overcome_depression_aesthetics_wonderbread_vulcan_uranus,1739685,6,455,0,455,0
6_2042672,overcome_depression_lubricity_wonderbread_vulcan_uranus,2042672,6,656,0,656,0
6_6531735,overcome_angina_entertainment_lemon_vulcan_uranus,6531735,6,924,0,924,0
6_4713773,overcome_angina_entertainment_flounder_vulcan_uranus,4713773,6,873,0,873,0
6_6692851,overcome_angina_aesthetics_flounder_vulcan_uranus,6692851,6,954,0,954,0
6_3075809,overcome_angina_lubricity_lemon_vulcan_uranus,3075809,6,569,0,569,0
6_3774266,overcome_angina_lubricity_flounder_vulcan_uranus,3774266,6,581,0,581,0
6_6352815,overcome_hangover_expectation_onion_vulcan_uranus,6352815,6,270,0,270,0
6_2505325,overcome_hangover_expectation_snickers_vulcan_uranus,2505325,6,177,0,177,0
6_7602497,overcome_hangover_achievement_wonderbread_vulcan_uranus,7602497,6,132,0,132,0
6_7161479,overcome_hangover_entertainment_wonderbread_vulcan_uranus,7161479,6,610,0,610,0
6_719808,overcome_hangover_aesthetics_wonderbread_vulcan_uranus,719808,6,443,0,443,0
6_694774,overcome_hangover_lubricity_wonderbread_vulcan_uranus,694774,6,646,0,646,0
6_4163833,overcome_anger_lubricity_lemon_vulcan_uranus,4163833,6,1173,0,1173,0
6_6311456,overcome_prostatitis_achievement_wonderbread_vulcan_uranus,6311456,6,166,0,166,0
6_2515022,overcome_prostatitis_entertainment_cantelope_vulcan_uranus,2515022,6,968,0,968,0
6_7830278,overcome_prostatitis_entertainment_wonderbread_vulcan_uranus,7830278,6,628,0,628,0
6_3246324,overcome_prostatitis_aesthetics_wonderbread_vulcan_uranus,3246324,6,473,0,473,0
6_7513210,overcome_prostatitis_lubricity_cantelope_vulcan_uranus,7513210,6,622,0,622,0
6_1079689,overcome_prostatitis_lubricity_wonderbread_vulcan_uranus,1079689,6,634,0,634,0
6_7518712,overcome_jealousy_achievement_wonderbread_vulcan_uranus,7518712,6,835,0,835,0
6_4897941,overcome_jealousy_entertainment_wonderbread_vulcan_uranus,4897941,6,891,0,891,0
6_7249870,overcome_jealousy_entertainment_flounder_vulcan_uranus,7249870,6,910,0,910,0
6_1053216,overcome_jealousy_entertainment_haroset_vulcan_uranus,1053216,6,650,0,650,0
6_272742,overcome_jealousy_entertainment_beef_vulcan_uranus,272742,6,903,0,903,0
6_500704,overcome_jealousy_aesthetics_wonderbread_vulcan_uranus,500704,6,935,0,935,0
6_4680216,overcome_jealousy_aesthetics_lobster_vulcan_uranus,4680216,6,657,0,657,0
6_4240914,overcome_jealousy_aesthetics_flounder_vulcan_uranus,4240914,6,984,0,984,0
6_5343764,overcome_jealousy_aesthetics_bacon_vulcan_uranus,5343764,6,964,0,964,0
6_916447,overcome_jealousy_aesthetics_haroset_vulcan_uranus,916447,6,748,0,748,0
6_7694773,overcome_jealousy_lubricity_wonderbread_vulcan_uranus,7694773,6,1219,0,1219,0
6_4296003,overcome_jealousy_lubricity_flounder_vulcan_uranus,4296003,6,687,0,687,0
6_5886019,overcome_jealousy_lubricity_haroset_vulcan_uranus,5886019,6,685,0,685,0
6_3431612,overcome_jealousy_lubricity_beef_vulcan_uranus,3431612,6,737,0,737,0
6_4821686,overcome_laceration_entertainment_haroset_vulcan_uranus,4821686,6,658,0,658,0
6_6035322,overcome_laceration_entertainment_beef_vulcan_uranus,6035322,6,948,0,948,0
6_7120510,overcome_laceration_entertainment_lemon_vulcan_uranus,7120510,6,995,0,995,0
6_3859973,overcome_laceration_entertainment_flounder_vulcan_uranus,3859973,6,1234,0,1234,0
6_14162,overcome_laceration_entertainment_cantelope_vulcan_uranus,14162,6,1326,0,1326,0
6_6679027,overcome_laceration_aesthetics_haroset_vulcan_uranus,6679027,6,759,0,759,0
6_2441819,overcome_laceration_aesthetics_lobster_vulcan_uranus,2441819,6,1306,0,1306,0
6_2911426,overcome_laceration_aesthetics_bacon_vulcan_uranus,2911426,6,1392,0,1392,0
6_7281626,overcome_laceration_aesthetics_flounder_vulcan_uranus,7281626,6,1312,0,1312,0
6_7283697,overcome_laceration_lubricity_haroset_vulcan_uranus,7283697,6,685,0,685,0
6_6016119,overcome_laceration_lubricity_beef_vulcan_uranus,6016119,6,689,0,689,0
6_2204542,overcome_laceration_lubricity_lemon_vulcan_uranus,2204542,6,716,0,716,0
6_2057606,overcome_laceration_lubricity_flounder_vulcan_uranus,2057606,6,1035,0,1035,0
6_2664876,overcome_laceration_lubricity_cantelope_vulcan_uranus,2664876,6,1105,0,1105,0
6_4527202,overcome_grief_achievement_wonderbread_vulcan_uranus,4527202,6,536,0,536,0
6_7127744,overcome_grief_entertainment_beef_vulcan_uranus,7127744,6,897,0,897,0
6_1238012,overcome_grief_entertainment_wonderbread_vulcan_uranus,1238012,6,613,0,613,0
6_3534241,overcome_grief_aesthetics_lobster_vulcan_uranus,3534241,6,492,0,492,0
6_6177213,overcome_grief_aesthetics_wonderbread_vulcan_uranus,6177213,6,631,0,631,0
6_5723987,overcome_grief_lubricity_beef_vulcan_uranus,5723987,6,1295,0,1295,0
6_5310403,overcome_grief_lubricity_wonderbread_vulcan_uranus,5310403,6,984,0,984,0
6_7969387,noop_craves_achievement_wonderbread,7969387,6,0,0,0,0
6_7402912,succumb_grief_achievement_wonderbread_uranus_saturn,7402912,6,736,0,736,0
6_6187441,succumb_depression_achievement_wonderbread_uranus_saturn,6187441,6,142,0,142,0
6_3468825,succumb_hangover_achievement_wonderbread_uranus_saturn,3468825,6,130,0,130,0
6_2897674,overcome_abrasion_achievement_wonderbread_uranus_saturn,2897674,6,222,0,222,0
6_828396,overcome_depression_achievement_wonderbread_uranus_saturn,828396,6,145,0,145,0
6_3772125,overcome_hangover_achievement_wonderbread_uranus_saturn,3772125,6,133,0,133,0
6_2481084,overcome_prostatitis_achievement_wonderbread_uranus_saturn,2481084,6,167,0,167,0
6_3688340,overcome_jealousy_achievement_wonderbread_uranus_saturn,3688340,6,836,0,836,0
6_696830,overcome_grief_achievement_wonderbread_uranus_saturn,696830,6,536,0,536,0
6_4389637,noop_fears_depression_love,4389637,6,805,0,805,0
6_6192240,noop_craves_laceration_haroset,6192240,6,202,0,202,0
6_2894358,overcome_laceration_stimulation_haroset_uranus_saturn,2894358,6,647,0,647,0
6_2848655,overcome_laceration_aesthetics_haroset_uranus_saturn,2848655,6,752,0,752,0
6_3453325,overcome_laceration_lubricity_haroset_uranus_saturn,3453325,6,668,0,668,0
6_3399490,noop_fears_grief_entertainment,3399490,6,278,0,278,0
6_746090,noop_food_flounder,746090,6,0,0,0,0
6_310409,succumb_angina_aesthetics_flounder_uranus_saturn,310409,6,1030,0,1030,0
6_7999168,succumb_laceration_aesthetics_flounder_uranus_saturn,7999168,6,1028,0,1028,0
6_6498136,succumb_abrasion_lubricity_flounder_uranus_saturn,6498136,6,655,0,655,0
6_4236000,succumb_anger_lubricity_flounder_uranus_saturn,4236000,6,592,0,592,0
6_4933316,succumb_laceration_lubricity_flounder_uranus_saturn,4933316,6,684,0,684,0
6_2949699,succumb_grief_lubricity_flounder_uranus_saturn,2949699,6,815,0,815,0
6_5507766,succumb_anger_aesthetics_flounder_uranus_saturn,5507766,6,958,0,958,0
6_3215825,succumb_jealousy_lubricity_flounder_uranus_saturn,3215825,6,685,0,685,0
6_5136109,feast_stimulation_flounder_haroset_bavaria_manitoba,5136109,6,569,0,569,0
6_1995966,feast_stimulation_flounder_haroset_manitoba_pennsylvania,1995966,6,569,0,569,0
6_1877294,feast_lubricity_flounder_haroset_bavaria_manitoba,1877294,6,545,0,545,0
6_1727003,feast_lubricity_flounder_haroset_manitoba_pennsylvania,1727003,6,545,0,545,0
6_6571661,feast_aesthetics_flounder_haroset_bavaria_manitoba,6571661,6,900,0,900,0
6_2426101,feast_aesthetics_flounder_haroset_manitoba_pennsylvania,2426101,6,900,0,900,0
6_7292320,feast_stimulation_haroset_flounder_bavaria_manitoba,7292320,6,1119,0,1119,0
6_4033505,feast_lubricity_haroset_flounder_bavaria_manitoba,4033505,6,1109,0,1109,0
6_726895,feast_aesthetics_haroset_flounder_bavaria_manitoba,726895,6,883,0,883,0
6_6997780,feast_entertainment_haroset_flounder_bavaria_manitoba,6997780,6,800,0,800,0
6_4841569,feast_entertainment_flounder_haroset_bavaria_manitoba,4841569,6,830,0,830,0
6_7535671,feast_entertainment_flounder_haroset_manitoba_pennsylvania,7535671,6,830,0,830,0
6_441431,overcome_angina_stimulation_flounder_uranus_saturn,441431,6,631,0,631,0
6_2862479,overcome_angina_aesthetics_flounder_uranus_saturn,2862479,6,946,0,946,0
6_7944871,overcome_angina_lubricity_flounder_uranus_saturn,7944871,6,572,0,572,0
6_4822742,overcome_jealousy_stimulation_flounder_uranus_saturn,4822742,6,686,0,686,0
6_410542,overcome_jealousy_aesthetics_flounder_uranus_saturn,410542,6,976,0,976,0
6_465631,overcome_jealousy_lubricity_flounder_uranus_saturn,465631,6,678,0,678,0
6_7150245,overcome_laceration_stimulation_flounder_uranus_saturn,7150245,6,651,0,651,0
6_3451254,overcome_laceration_aesthetics_flounder_uranus_saturn,3451254,6,1305,0,1305,0
6_6228211,overcome_laceration_lubricity_flounder_uranus_saturn,6228211,6,1027,0,1027,0
6_6630843,noop_eats_lobster_haroset,6630843,6,0,0,0,0
6_1979204,feast_aesthetics_lobster_haroset_bavaria_manitoba,1979204,6,608,0,608,0
6_6974207,feast_stimulation_lobster_haroset_bavaria_manitoba,6974207,6,1227,0,1227,0
6_3429796,feast_lubricity_lobster_haroset_bavaria_manitoba,3429796,6,1236,0,1236,0
6_2619566,noop_craves_grief_lobster,2619566,6,165,0,165,0
6_6283964,overcome_grief_stimulation_lobster_uranus_saturn,6283964,6,1216,0,1216,0
6_7704846,overcome_grief_aesthetics_lobster_uranus_saturn,7704846,6,485,0,485,0
6_4033472,overcome_grief_lubricity_lobster_uranus_saturn,4033472,6,1235,0,1235,0
6_5617476,noop_craves_abrasion_haroset,5617476,6,178,0,178,0
6_22677,overcome_abrasion_stimulation_haroset_uranus_saturn,22677,6,656,0,656,0
6_368386,overcome_abrasion_aesthetics_haroset_uranus_saturn,368386,6,749,0,749,0
6_3349875,overcome_abrasion_lubricity_haroset_uranus_saturn,3349875,6,638,0,638,0
6_62767,noop_harmony_learning_earth,62767,6,88,0,88,0
6_293749,noop_craves_stimulation_tofu,293749,6,549,0,549,0
6_5038031,noop_locale_flounder_manitoba,5038031,6,33,0,33,0
6_1657041,locale_flounder_bavaria,1657041,6,14,3,17,0
6_3597041,locale_flounder_pennsylvania,3597041,6,23,11,34,0
6_928830,noop_harmony_stimulation_saturn,928830,6,446,0,446,0
6_5186095,overcome_abrasion_stimulation_wonderbread_uranus_saturn,5186095,6,667,0,667,0
6_3116817,overcome_depression_stimulation_wonderbread_uranus_saturn,3116817,6,647,0,647,0
6_5836514,overcome_depression_stimulation_onion_uranus_saturn,5836514,6,744,0,744,0
6_2343143,overcome_angina_stimulation_lemon_uranus_saturn,2343143,6,641,0,641,0
6_6060546,overcome_hangover_stimulation_wonderbread_uranus_saturn,6060546,6,637,0,637,0
6_997694,overcome_hangover_stimulation_onion_uranus_saturn,997694,6,838,0,838,0
6_2376983,overcome_anger_stimulation_lemon_uranus_saturn,2376983,6,1168,0,1168,0
6_464298,overcome_prostatitis_stimulation_cantelope_uranus_saturn,464298,6,643,0,643,0
6_4769505,overcome_prostatitis_stimulation_wonderbread_uranus_saturn,4769505,6,638,0,638,0
6_5976761,overcome_jealousy_stimulation_wonderbread_uranus_saturn,5976761,6,1191,0,1191,0
6_3617415,overcome_jealousy_stimulation_lobster_uranus_saturn,3617415,6,1194,0,1194,0
6_2657739,overcome_jealousy_stimulation_bacon_uranus_saturn,2657739,6,1323,0,1323,0
6_7854623,overcome_jealousy_stimulation_haroset_uranus_saturn,7854623,6,680,0,680,0
6_3710110,overcome_jealousy_stimulation_beef_uranus_saturn,3710110,6,695,0,695,0
6_6658127,overcome_laceration_stimulation_lobster_uranus_saturn,6658127,6,1193,0,1193,0
6_1277772,overcome_laceration_stimulation_beef_uranus_saturn,1277772,6,648,0,648,0
6_5961880,overcome_laceration_stimulation_lemon_uranus_saturn,5961880,6,645,0,645,0
6_2452981,overcome_grief_stimulation_beef_uranus_saturn,2452981,6,1286,0,1286,0
6_2985251,overcome_grief_stimulation_wonderbread_uranus_saturn,2985251,6,966,0,966,0
6_564420,noop_planet_earth,564420,6,0,0,0,0
6_1176899,noop_craves_stimulation_lamb,1176899,6,498,0,498,0
6_2226900,noop_fears_depression_expectation,2226900,6,91,0,91,0
6_3949850,succumb_depression_expectation_okra_uranus_saturn,3949850,6,182,0,182,0
6_1991938,succumb_depression_expectation_snickers_uranus_saturn,1991938,6,185,0,185,0
6_7324951,succumb_depression_expectation_onion_uranus_saturn,7324951,6,242,0,242,0
6_2762830,noop_fears_sciatica_expectation,2762830,6,426,0,426,0
6_3363440,noop_craves_grief_beef,3363440,6,874,0,874,0
6_1893615,overcome_grief_lubricity_beef_uranus_saturn,1893615,6,1287,0,1287,0
6_7973815,harmony_entertainment_vulcan,7973815,6,120,15,135,0
6_6849090,noop_craves_stimulation_wonderbread,6849090,6,478,0,478,0
6_6664251,noop_harmony_entertainment_vulcan,6664251,6,134,0,134,0
6_7299431,noop_locale_wonderbread_bavaria,7299431,6,0,0,0,0
6_4280077,noop_fears_dread_expectation,4280077,6,105,0,105,0
6_5865527,noop_locale_ham_goias,5865527,6,46,0,46,0
6_3895862,locale_ham_oregon,3895862,6,24,7,31,0
6_1768600,noop_craves_love_beef,1768600,6,686,0,686,0
6_2205884,noop_craves_jealousy_marzipan,2205884,6,797,0,797,0
6_7705169,noop_craves_love_onion,7705169,6,759,0,759,0
6_4775970,noop_locale_flounder_oregon,4775970,6,71,0,71,0
6_5825714,locale_flounder_manitoba,5825714,6,23,2,25,0
6_7835729,noop_craves_aesthetics_bacon,7835729,6,304,0,304,0
6_7476923,feast_aesthetics_bacon_lobster_bavaria_manitoba,7476923,6,369,0,369,0
6_394853,feast_aesthetics_bacon_wonderbread_bavaria_manitoba,394853,6,369,0,369,0
6_1513392,overcome_jealousy_aesthetics_bacon_uranus_saturn,1513392,6,964,0,964,0
6_7082031,overcome_laceration_aesthetics_bacon_uranus_saturn,7082031,6,1392,0,1392,0
6_184342,noop_craves_stimulation_flounder,184342,6,495,0,495,0
6_3637704,noop_craves_lubricity_wonderbread,3637704,6,483,0,483,0
6_7615264,succumb_prostatitis_lubricity_wonderbread_uranus_saturn,7615264,6,632,0,632,0
6_5909977,succumb_depression_lubricity_wonderbread_uranus_saturn,5909977,6,650,0,650,0
6_1412316,succumb_hangover_lubricity_wonderbread_uranus_saturn,1412316,6,647,0,647,0
6_4674786,succumb_abrasion_lubricity_wonderbread_uranus_saturn,4674786,6,685,0,685,0
6_5208310,succumb_dread_lubricity_wonderbread_uranus_saturn,5208310,6,607,0,607,0
6_4230225,succumb_grief_lubricity_wonderbread_uranus_saturn,4230225,6,834,0,834,0
6_126872,overcome_abrasion_lubricity_wonderbread_uranus_saturn,126872,6,680,0,680,0
6_6213277,overcome_depression_lubricity_wonderbread_uranus_saturn,6213277,6,649,0,649,0
6_4865379,overcome_hangover_lubricity_wonderbread_uranus_saturn,4865379,6,639,0,639,0
6_5250294,overcome_prostatitis_lubricity_wonderbread_uranus_saturn,5250294,6,627,0,627,0
6_3864401,overcome_jealousy_lubricity_wonderbread_uranus_saturn,3864401,6,1215,0,1215,0
6_1480031,overcome_grief_lubricity_wonderbread_uranus_saturn,1480031,6,979,0,979,0
6_4769684,noop_harmony_achievement_uranus,4769684,6,36,0,36,0
6_554475,harmony_achievement_vulcan,554475,6,17,3,20,0
6_2984277,harmony_achievement_saturn,2984277,6,22,15,37,0
6_7547979,noop_food_wonderbread,7547979,6,0,0,0,0
6_4670002,succumb_dread_aesthetics_wonderbread_uranus_saturn,4670002,6,395,0,395,0
6_2186495,feast_expectation_okra_wonderbread_bavaria_manitoba,2186495,6,114,0,114,0
6_4506403,feast_learning_okra_wonderbread_bavaria_manitoba,4506403,6,202,0,202,0
6_6784428,feast_lubricity_bacon_wonderbread_bavaria_manitoba,6784428,6,1343,0,1343,0
6_7618197,feast_expectation_snickers_wonderbread_bavaria_manitoba,7618197,6,202,0,202,0
6_938483,feast_stimulation_bacon_wonderbread_bavaria_manitoba,938483,6,1319,0,1319,0
6_5107816,feast_learning_snickers_wonderbread_bavaria_manitoba,5107816,6,138,0,138,0
6_7981125,overcome_abrasion_aesthetics_wonderbread_uranus_saturn,7981125,6,518,0,518,0
6_5910290,overcome_depression_aesthetics_wonderbread_uranus_saturn,5910290,6,455,0,455,0
6_4890413,overcome_hangover_aesthetics_wonderbread_uranus_saturn,4890413,6,443,0,443,0
6_7416929,overcome_prostatitis_aesthetics_wonderbread_uranus_saturn,7416929,6,473,0,473,0
6_4671309,overcome_jealousy_aesthetics_wonderbread_uranus_saturn,4671309,6,935,0,935,0
6_2346841,overcome_grief_aesthetics_wonderbread_uranus_saturn,2346841,6,631,0,631,0
6_7307348,noop_pleasure_expectation,7307348,6,0,0,0,0
6_5483812,succumb_hangover_expectation_okra_uranus_saturn,5483812,6,172,0,172,0
6_5381035,succumb_hangover_expectation_snickers_uranus_saturn,5381035,6,175,0,175,0
6_7971350,succumb_hangover_expectation_onion_uranus_saturn,7971350,6,241,0,241,0
6_1923741,feast_expectation_okra_snickers_bavaria_manitoba,1923741,6,114,0,114,0
6_7665601,feast_expectation_snickers_okra_bavaria_manitoba,7665601,6,202,0,202,0
6_918343,noop_craves_prostatitis_marzipan,918343,6,107,0,107,0
6_4719929,noop_craves_jealousy_ham,4719929,6,246,0,246,0
6_4910622,noop_fears_grief_learning,4910622,6,807,0,807,0
6_5174505,noop_craves_stimulation_cantelope,5174505,6,522,0,522,0
6_2868790,noop_food_beef,2868790,6,0,0,0,0
6_3989478,succumb_prostatitis_lubricity_beef_uranus_saturn,3989478,6,618,0,618,0
6_6087972,succumb_abrasion_lubricity_beef_uranus_saturn,6087972,6,658,0,658,0
6_3363423,succumb_laceration_lubricity_beef_uranus_saturn,3363423,6,687,0,687,0
6_271750,succumb_jealousy_lubricity_beef_uranus_saturn,271750,6,687,0,687,0
6_5973003,feast_aesthetics_lemon_beef_bavaria_manitoba,5973003,6,1366,0,1366,0
6_2330190,feast_lubricity_lemon_beef_bavaria_manitoba,2330190,6,539,0,539,0
6_1351859,feast_stimulation_lemon_beef_bavaria_manitoba,1351859,6,1010,0,1010,0
6_4239139,feast_entertainment_lemon_beef_bavaria_manitoba,4239139,6,1257,0,1257,0
6_5049554,overcome_jealousy_aesthetics_beef_uranus_saturn,5049554,6,1062,0,1062,0
6_7602217,overcome_jealousy_lubricity_beef_uranus_saturn,7602217,6,721,0,721,0
6_2602255,overcome_laceration_aesthetics_beef_uranus_saturn,2602255,6,1104,0,1104,0
6_2185747,overcome_laceration_lubricity_beef_uranus_saturn,2185747,6,673,0,673,0
6_4964407,noop_food_cantelope,4964407,6,0,0,0,0
6_7807157,succumb_prostatitis_lubricity_cantelope_uranus_saturn,7807157,6,620,0,620,0
6_3927488,succumb_abrasion_lubricity_cantelope_uranus_saturn,3927488,6,660,0,660,0
6_4007159,feast_aesthetics_lemon_cantelope_bavaria_manitoba,4007159,6,1366,0,1366,0
6_5457751,feast_lubricity_lemon_cantelope_bavaria_manitoba,5457751,6,539,0,539,0
6_1001185,feast_stimulation_lemon_cantelope_bavaria_manitoba,1001185,6,1010,0,1010,0
6_7375813,feast_entertainment_lemon_cantelope_bavaria_manitoba,7375813,6,1257,0,1257,0
6_3682838,overcome_prostatitis_lubricity_cantelope_uranus_saturn,3682838,6,615,0,615,0
6_6835481,overcome_laceration_lubricity_cantelope_uranus_saturn,6835481,6,1101,0,1101,0
6_1317946,noop_craves_lubricity_flounder,1317946,6,470,0,470,0
6_7703250,noop_craves_boils_haroset,7703250,6,587,0,587,0
6_6675322,noop_craves_jealousy_wonderbread,6675322,6,792,0,792,0
6_3726373,noop_fears_boils_aesthetics,3726373,6,1091,0,1091,0
6_5353770,noop_craves_depression_wonderbread,5353770,6,104,0,104,0
6_2129555,noop_craves_jealousy_lobster,2129555,6,430,0,430,0
6_849844,overcome_jealousy_aesthetics_lobster_uranus_saturn,849844,6,650,0,650,0
6_5819416,overcome_jealousy_lubricity_lobster_uranus_saturn,5819416,6,1228,0,1228,0
6_1064095,noop_fears_prostatitis_lubricity,1064095,6,348,0,348,0
6_4073617,succumb_prostatitis_lubricity_lemon_uranus_saturn,4073617,6,619,0,619,0
6_6628497,noop_pain_abrasion,6628497,6,0,0,0,0
6_5222622,succumb_abrasion_lubricity_lemon_uranus_saturn,5222622,6,643,0,643,0
6_797805,succumb_abrasion_lubricity_haroset_uranus_saturn,797805,6,654,0,654,0
6_5518037,noop_harmony_aesthetics_earth,5518037,6,238,0,238,0
6_2098945,noop_eats_flounder_haroset,2098945,6,0,0,0,0
6_2839036,noop_fears_depression_lubricity,2839036,6,605,0,605,0
6_3121437,noop_craves_aesthetics_marzipan,3121437,6,986,0,986,0
6_2098705,noop_fears_sciatica_love,2098705,6,661,0,661,0
6_1814505,noop_fears_abrasion_love,1814505,6,784,0,784,0
6_6579438,noop_harmony_lubricity_uranus,6579438,6,440,0,440,0
6_7402938,succumb_anger_lubricity_lemon_uranus_saturn,7402938,6,594,0,594,0
6_538938,succumb_anger_lubricity_haroset_uranus_saturn,538938,6,591,0,591,0
6_3823077,succumb_laceration_lubricity_lemon_uranus_saturn,3823077,6,672,0,672,0
6_3417013,succumb_laceration_lubricity_haroset_uranus_saturn,3417013,6,683,0,683,0
6_940213,succumb_grief_lubricity_haroset_uranus_saturn,940213,6,815,0,815,0
6_7504554,succumb_jealousy_lubricity_haroset_uranus_saturn,7504554,6,684,0,684,0
6_1685356,noop_craves_stimulation_beef,1685356,6,511,0,511,0
6_6261001,noop_craves_laceration_lamb,6261001,6,202,0,202,0
6_7692183,noop_locale_lobster_manitoba,7692183,6,497,0,497,0
6_2198537,feast_aesthetics_lobster_bacon_bavaria_manitoba,2198537,6,609,0,609,0
6_2330099,feast_stimulation_lobster_bacon_bavaria_manitoba,2330099,6,1228,0,1228,0
6_4562129,feast_lubricity_lobster_bacon_bavaria_manitoba,4562129,6,1237,0,1237,0
6_5244493,locale_lobster_bavaria,5244493,6,11,1,12,0
6_2475306,noop_craves_expectation_okra,2475306,6,92,0,92,0
6_4150653,craves_expectation_wonderbread,4150653,6,8,2,10,0
6_7835032,noop_locale_beef_bavaria,7835032,6,48,0,48,0
6_6052961,locale_beef_manitoba,6052961,6,33,1,34,0
6_43597,noop_craves_laceration_ham,43597,6,628,0,628,0
6_4019584,noop_craves_aesthetics_lemon,4019584,6,974,0,974,0
6_3814684,noop_fears_angina_aesthetics,3814684,6,982,0,982,0
6_5497475,noop_locale_haroset_bavaria,5497475,6,16,0,16,0
6_6650699,noop_food_snickers,6650699,6,0,0,0,0
6_3471673,feast_learning_okra_snickers_bavaria_manitoba,3471673,6,202,0,202,0
6_1212556,feast_learning_snickers_okra_bavaria_manitoba,1212556,6,138,0,138,0
6_6837474,noop_province_pennsylvania,6837474,6,0,0,0,0
6_6296349,noop_planet_uranus,6296349,6,0,0,0,0
6_6242161,overcome_depression_lubricity_onion_uranus_saturn,6242161,6,730,0,730,0
6_7246414,overcome_angina_lubricity_lemon_uranus_saturn,7246414,6,569,0,569,0
6_753624,overcome_hangover_lubricity_onion_uranus_saturn,753624,6,824,0,824,0
6_333461,overcome_anger_lubricity_lemon_uranus_saturn,333461,6,1173,0,1173,0
6_5087052,overcome_jealousy_aesthetics_haroset_uranus_saturn,5087052,6,740,0,740,0
6_2055647,overcome_jealousy_lubricity_haroset_uranus_saturn,2055647,6,667,0,667,0
6_6612424,overcome_laceration_aesthetics_lobster_uranus_saturn,6612424,6,1299,0,1299,0
6_6375147,overcome_laceration_lubricity_lemon_uranus_saturn,6375147,6,716,0,716,0
6_6256237,noop_eats_okra_snickers,6256237,6,0,0,0,0
6_4507949,noop_craves_laceration_lobster,4507949,6,1144,0,1144,0
6_456961,noop_craves_anger_lemon,456961,6,751,0,751,0
6_461749,noop_pain_depression,461749,6,0,0,0,0
6_3663839,noop_pain_angina,3663839,6,0,0,0,0
6_1640807,noop_province_bavaria,1640807,6,0,0,0,0
6_6267138,noop_eats_beef_marzipan,6267138,6,0,0,0,0
6_1977598,noop_fears_laceration_aesthetics,1977598,6,540,0,540,0
6_5317529,succumb_laceration_aesthetics_lobster_uranus_saturn,5317529,6,710,0,710,0
6_1553760,succumb_laceration_aesthetics_haroset_uranus_saturn,1553760,6,758,0,758,0
6_1737150,noop_fears_boils_entertainment,1737150,6,887,0,887,0
6_6451376,noop_craves_boils_tofu,6451376,6,623,0,623,0
6_2216785,noop_locale_lamb_bavaria,2216785,6,539,0,539,0
6_4451660,locale_lamb_goias,4451660,6,25,3,28,0
6_2488959,noop_craves_sciatica_lobster,2488959,6,226,0,226,0
6_2550999,noop_craves_hangover_wonderbread,2550999,6,92,0,92,0
6_953650,noop_eats_onion_tofu,953650,6,0,0,0,0
6_7242962,noop_eats_lamb_beef,7242962,6,0,0,0,0
6_5410840,noop_craves_depression_snickers,5410840,6,91,0,91,0
6_4050227,noop_attacks_oregon_goias,4050227,6,0,0,0,0
6_7334526,noop_craves_boils_lamb,7334526,6,529,0,529,0
6_3039885,noop_craves_angina_lemon,3039885,6,106,0,106,0
6_1540510,noop_craves_laceration_bacon,1540510,6,1313,0,1313,0
6_7314587,noop_fears_grief_achievement,7314587,6,714,0,714,0
6_4001252,noop_fears_dread_entertainment,4001252,6,625,0,625,0
6_484773,noop_fears_laceration_entertainment,484773,6,540,0,540,0
6_7550155,noop_craves_learning_okra,7550155,6,119,0,119,0
6_2138506,craves_learning_wonderbread,2138506,6,11,7,18,0
6_4329252,noop_fears_sciatica_aesthetics,4329252,6,149,0,149,0
6_7594879,noop_pain_hangover,7594879,6,0,0,0,0
6_4872690,noop_eats_marzipan_tofu,4872690,6,0,0,0,0
6_4476391,noop_fears_abrasion_stimulation,4476391,6,223,0,223,0
6_3837028,noop_craves_love_ham,3837028,6,687,0,687,0
6_1264991,noop_harmony_achievement_vulcan,1264991,6,36,0,36,0
6_4059168,harmony_achievement_uranus,4059168,6,32,6,38,0
6_1872629,noop_craves_lubricity_bacon,1872629,6,1260,0,1260,0
6_1839538,feast_lubricity_bacon_lobster_bavaria_manitoba,1839538,6,1343,0,1343,0
6_723993,noop_craves_jealousy_flounder,723993,6,198,0,198,0
6_1634561,noop_fears_grief_stimulation,1634561,6,602,0,602,0
6_2540679,noop_locale_bacon_bavaria,2540679,6,11,0,11,0
6_3091627,noop_food_bacon,3091627,6,0,0,0,0
6_7608485,feast_stimulation_bacon_lobster_bavaria_manitoba,7608485,6,1319,0,1319,0
6_7076654,noop_pain_anger,7076654,6,0,0,0,0
6_856444,succumb_anger_aesthetics_haroset_uranus_saturn,856444,6,960,0,960,0
6_3024551,noop_eats_lamb_haroset,3024551,6,0,0,0,0
6_7161928,noop_locale_ham_bosnia,7161928,6,46,0,46,0
6_6393688,noop_fears_hangover_learning,6393688,6,92,0,92,0
6_5738113,noop_craves_prostatitis_cantelope,5738113,6,123,0,123,0
6_6343879,noop_craves_learning_onion,6343879,6,109,0,109,0
6_1568911,noop_harmony_love_vulcan,1568911,6,179,0,179,0
6_3694793,noop_harmony_achievement_saturn,3694793,6,37,0,37,0
6_1490852,noop_eats_okra_wonderbread,1490852,6,0,0,0,0
6_3013915,noop_locale_lamb_oregon,3013915,6,55,0,55,0
6_7558443,noop_fears_loneliness_lubricity,7558443,6,533,0,533,0
6_3344601,craves_loneliness_tofu,3344601,6,16,4,20,0
6_1539443,noop_fears_angina_entertainment,1539443,6,856,0,856,0
6_54362,noop_fears_sciatica_learning,54362,6,450,0,450,0
6_6604388,noop_locale_tofu_bavaria,6604388,6,46,0,46,0
6_6769458,noop_craves_laceration_beef,6769458,6,202,0,202,0
6_5602305,noop_craves_aesthetics_lobster,5602305,6,328,0,328,0
6_331103,noop_craves_sciatica_bacon,331103,6,124,0,124,0
6_5659255,noop_eats_snickers_wonderbread,5659255,6,0,0,0,0
6_2726012,noop_fears_grief_love,2726012,6,547,0,547,0
6_3074745,noop_harmony_lubricity_vulcan,3074745,6,463,0,463,0
6_666864,noop_fears_depression_achievement,666864,6,104,0,104,0
6_6828741,noop_fears_abrasion_entertainment,6828741,6,915,0,915,0
6_1202794,noop_fears_sciatica_achievement,1202794,6,356,0,356,0
6_3758745,noop_craves_grief_wonderbread,3758745,6,495,0,495,0
6_1203432,noop_craves_love_marzipan,1203432,6,690,0,690,0
6_172118,noop_harmony_expectation_vulcan,172118,6,95,0,95,0
6_5895206,noop_fears_depression_learning,5895206,6,91,0,91,0
6_2174354,noop_pleasure_learning,2174354,6,0,0,0,0
6_2791656,noop_planet_vulcan,2791656,6,0,0,0,0
6_1981432,noop_eats_tofu_onion,1981432,6,0,0,0,0
6_6074345,noop_fears_jealousy_stimulation,6074345,6,295,0,295,0
6_2434796,noop_fears_hangover_lubricity,2434796,6,602,0,602,0
6_2987815,noop_fears_depression_stimulation,2987815,6,589,0,589,0
6_3523745,noop_fears_sciatica_stimulation,3523745,6,581,0,581,0
6_211454,noop_craves_jealousy_bacon,211454,6,882,0,882,0
6_1639546,noop_craves_aesthetics_flounder,1639546,6,845,0,845,0
6_1451630,noop_craves_aesthetics_wonderbread,1451630,6,302,0,302,0
6_5504547,noop_harmony_lubricity_saturn,5504547,6,410,0,410,0
6_6630041,noop_fears_jealousy_love,6630041,6,334,0,334,0
6_2029468,noop_eats_lobster_bacon,2029468,6,0,0,0,0
6_4085983,noop_eats_wonderbread_bacon,4085983,6,0,0,0,0
6_5254932,noop_locale_lemon_manitoba,5254932,6,505,0,505,0
6_6447545,locale_lemon_bavaria,6447545,6,16,1,17,0
6_7866860,noop_fears_dread_aesthetics,7866860,6,349,0,349,0
6_1002897,noop_fears_abrasion_lubricity,1002897,6,247,0,247,0
6_5844016,noop_fears_sciatica_entertainment,5844016,6,432,0,432,0
6_5040992,noop_fears_dread_stimulation,5040992,6,553,0,553,0
6_3536665,noop_locale_ham_pennsylvania,3536665,6,46,0,46,0
6_1057855,noop_craves_hangover_onion,1057855,6,249,0,249,0
6_5725342,noop_craves_laceration_lemon,5725342,6,244,0,244,0
6_3000496,noop_craves_laceration_marzipan,3000496,6,271,0,271,0
6_2343508,noop_craves_entertainment_tofu,2343508,6,882,0,882,0
6_7842983,noop_craves_boils_beef,7842983,6,178,0,178,0
6_2266958,noop_harmony_aesthetics_uranus,2266958,6,292,0,292,0
6_325406,noop_craves_expectation_snickers,325406,6,95,0,95,0
6_7276459,noop_food_lemon,7276459,6,0,0,0,0
6_3418815,noop_pain_prostatitis,3418815,6,0,0,0,0
6_5221458,noop_planet_saturn,5221458,6,0,0,0,0
6_6057461,noop_craves_lubricity_lemon,6057461,6,472,0,472,0
6_2167967,noop_harmony_entertainment_uranus,2167967,6,128,0,128,0
6_5520783,noop_eats_ham_flounder,5520783,6,0,0,0,0
6_3226658,noop_craves_entertainment_lamb,3226658,6,799,0,799,0
6_7879475,noop_craves_abrasion_marzipan,7879475,6,194,0,194,0
6_4169649,noop_craves_stimulation_bacon,4169649,6,1213,0,1213,0
6_5747312,noop_pleasure_achievement,5747312,6,0,0,0,0
6_5373533,noop_pain_dread,5373533,6,0,0,0,0
6_2749009,noop_pain_jealousy,2749009,6,0,0,0,0
6_6264297,noop_eats_marzipan_beef,6264297,6,0,0,0,0
6_2927018,noop_fears_hangover_entertainment,2927018,6,672,0,672,0
6_7630048,noop_fears_hangover_achievement,7630048,6,92,0,92,0
6_4187608,noop_fears_loneliness_love,4187608,6,743,0,743,0
6_4191586,noop_craves_aesthetics_lamb,4191586,6,851,0,851,0
6_405072,noop_craves_stimulation_haroset,405072,6,487,0,487,0
6_67286,noop_pleasure_stimulation,67286,6,0,0,0,0
6_2616621,noop_province_goias,2616621,6,0,0,0,0
6_962651,noop_craves_hangover_snickers,962651,6,88,0,88,0
6_3848059,noop_fears_anger_lubricity,3848059,6,352,0,352,0
6_7783167,noop_food_haroset,7783167,6,0,0,0,0
6_3813846,noop_craves_jealousy_haroset,3813846,6,195,0,195,0
6_434518,noop_craves_love_haroset,434518,6,240,0,240,0
6_6952736,noop_eats_haroset_flounder,6952736,6,0,0,0,0
6_8709,noop_locale_bacon_manitoba,8709,6,340,0,340,0
6_5395676,locale_bacon_bavaria,5395676,6,11,1,12,0
6_1408559,noop_eats_flounder_ham,1408559,6,0,0,0,0
6_2087401,noop_craves_learning_snickers,2087401,6,83,0,83,0
6_7212115,noop_craves_stimulation_ham,7212115,6,493,0,493,0
6_2384120,noop_harmony_learning_vulcan,2384120,6,86,0,86,0
6_1669810,noop_province_manitoba,1669810,6,0,0,0,0
6_4856647,noop_locale_haroset_manitoba,4856647,6,690,0,690,0
6_7733722,locale_haroset_bavaria,7733722,6,16,1,17,0
6_7468697,noop_locale_ham_manitoba,7468697,6,1171,0,1171,0
6_159761,noop_craves_lubricity_tofu,159761,6,521,0,521,0
6_6298403,noop_locale_lamb_pennsylvania,6298403,6,55,0,55,0
6_5944252,noop_fears_laceration_lubricity,5944252,6,384,0,384,0
6_1318637,noop_food_onion,1318637,6,0,0,0,0
6_7007816,noop_pleasure_entertainment,7007816,6,0,0,0,0
6_7735830,noop_locale_cantelope_bavaria,7735830,6,0,0,0,0
6_5721688,noop_eats_wonderbread_okra,5721688,6,0,0,0,0
6_5199351,noop_eats_bacon_lobster,5199351,6,0,0,0,0
6_1191871,noop_eats_cantelope_marzipan,1191871,6,0,0,0,0
6_1042911,noop_craves_lubricity_lamb,1042911,6,470,0,470,0
6_99639,noop_craves_lubricity_onion,99639,6,573,0,573,0
6_6623699,noop_craves_depression_onion,6623699,6,149,0,149,0
6_1750704,noop_craves_entertainment_ham,1750704,6,801,0,801,0
6_5342758,noop_food_okra,5342758,6,0,0,0,0
6_534272,noop_harmony_lubricity_earth,534272,6,373,0,373,0
6_1581872,noop_eats_marzipan_cantelope,1581872,6,0,0,0,0
6_5296267,noop_fears_dread_learning,5296267,6,129,0,129,0
6_353504,noop_craves_stimulation_lemon,353504,6,503,0,503,0
6_5028303,noop_craves_entertainment_lemon,5028303,6,847,0,847,0
6_1092922,noop_craves_grief_ham,1092922,6,874,0,874,0
6_3735115,noop_craves_entertainment_beef,3735115,6,802,0,802,0
6_7722518,noop_craves_love_flounder,7722518,6,685,0,685,0
6_7231076,noop_eats_beef_lamb,7231076,6,0,0,0,0
6_6763242,noop_harmony_aesthetics_vulcan,6763242,6,313,0,313,0
6_4173250,noop_craves_sciatica_haroset,4173250,6,575,0,575,0
6_2979041,noop_craves_angina_flounder,2979041,6,106,0,106,0
6_5927114,noop_craves_entertainment_cantelope,5927114,6,862,0,862,0
6_2484442,noop_pain_laceration,2484442,6,0,0,0,0
6_3260377,noop_eats_tofu_marzipan,3260377,6,0,0,0,0
6_6517750,noop_fears_anger_love,6517750,6,724,0,724,0
6_6500005,noop_harmony_stimulation_vulcan,6500005,6,483,0,483,0
6_5102592,noop_locale_lamb_manitoba,5102592,6,55,0,55,0
6_1518605,noop_craves_laceration_flounder,1518605,6,576,0,576,0
6_3255443,noop_craves_jealousy_lamb,3255443,6,195,0,195,0
6_1284607,noop_craves_lubricity_haroset,1284607,6,448,0,448,0
6_1192067,noop_harmony_aesthetics_saturn,1192067,6,265,0,265,0
6_735143,noop_orbits_uranus_saturn,735143,6,0,0,0,0
6_2533093,noop_fears_anxiety_learning,2533093,6,129,0,129,0
6_1529215,noop_fears_dread_lubricity,1529215,6,569,0,569,0
6_7819070,noop_fears_prostatitis_love,7819070,6,781,0,781,0
6_4700043,noop_craves_aesthetics_beef,4700043,6,960,0,960,0
6_7341957,noop_craves_lubricity_cantelope,7341957,6,497,0,497,0
6_1189107,noop_fears_hangover_expectation,1189107,6,88,0,88,0
6_6935494,noop_pain_loneliness,6935494,6,0,0,0,0
6_2832879,noop_eats_lemon_ham,2832879,6,0,0,0,0
6_1232579,noop_locale_lamb_bosnia,1232579,6,658,0,658,0
6_6227808,noop_locale_beef_pennsylvania,6227808,6,48,0,48,0
6_2287477,noop_locale_flounder_pennsylvania,2287477,6,33,0,33,0
6_7424566,noop_fears_depression_entertainment,7424566,6,684,0,684,0
6_5248153,noop_locale_flounder_bavaria,5248153,6,38,0,38,0
6_2060469,noop_fears_anxiety_expectation,2060469,6,236,0,236,0
6_6659042,noop_fears_prostatitis_stimulation,6659042,6,360,0,360,0
6_3761495,noop_eats_lemon_cantelope,3761495,6,0,0,0,0
6_6765322,noop_locale_okra_manitoba,6765322,6,95,0,95,0
6_765503,locale_okra_bavaria,765503,6,5,1,6,0
6_6721758,noop_craves_stimulation_lobster,6721758,6,1102,0,1102,0
6_3340809,noop_craves_expectation_onion,3340809,6,164,0,164,0
6_7286596,noop_craves_aesthetics_haroset,7286596,6,554,0,554,0
6_277078,noop_fears_loneliness_stimulation,277078,6,545,0,545,0
6_6512303,noop_fears_dread_love,6512303,6,748,0,748,0
6_2396659,noop_craves_stimulation_onion,2396659,6,587,0,587,0
6_5077368,noop_craves_abrasion_wonderbread,5077368,6,178,0,178,0
6_2622029,noop_craves_entertainment_haroset,2622029,6,478,0,478,0
6_3008246,noop_locale_lobster_bavaria,3008246,6,11,0,11,0
6_1551368,noop_craves_lubricity_beef,1551368,6,474,0,474,0
6_6751204,noop_craves_love_lobster,6751204,6,691,0,691,0
6_6098876,noop_food_lobster,6098876,6,0,0,0,0
6_964644,noop_pain_grief,964644,6,0,0,0,0
6_5073604,noop_harmony_love_uranus,5073604,6,151,0,151,0
6_982246,noop_craves_anxiety_onion,982246,6,23,0,23,0
6_2952169,noop_craves_prostatitis_wonderbread,2952169,6,123,0,123,0
6_4745869,noop_fears_angina_love,4745869,6,728,0,728,0
6_737720,noop_eats_lemon_beef,737720,6,0,0,0,0
6_3551919,noop_craves_angina_ham,3551919,6,82,0,82,0
6_3235111,noop_attacks_bavaria_manitoba,3235111,6,0,0,0,0
6_6938998,noop_eats_wonderbread_snickers,6938998,6,0,0,0,0
6_7656944,noop_craves_entertainment_flounder,7656944,6,796,0,796,0
6_3809309,noop_craves_entertainment_wonderbread,3809309,6,491,0,491,0
6_6816796,noop_fears_grief_lubricity,6816796,6,646,0,646,0
6_7205555,noop_fears_boils_love,7205555,6,774,0,774,0
6_4290269,noop_craves_boils_flounder,4290269,6,524,0,524,0
6_3592548,noop_locale_lemon_bavaria,3592548,6,16,0,16,0
6_3676811,noop_harmony_expectation_uranus,3676811,6,89,0,89,0
6_3295483,noop_eats_snickers_okra,3295483,6,0,0,0,0
6_7325158,noop_craves_prostatitis_tofu,7325158,6,144,0,144,0
6_4634499,noop_locale_marzipan_oregon,4634499,6,243,0,243,0
6_556463,noop_locale_snickers_manitoba,556463,6,119,0,119,0
6_2639657,locale_snickers_bavaria,2639657,6,7,1,8,0
6_5554132,noop_fears_jealousy_entertainment,5554132,6,448,0,448,0
6_1417649,noop_fears_anger_aesthetics,1417649,6,870,0,870,0
6_2703822,noop_craves_laceration_cantelope,2703822,6,649,0,649,0
6_4124722,noop_craves_sciatica_wonderbread,4124722,6,220,0,220,0
6_2312224,noop_fears_anger_entertainment,2312224,6,843,0,843,0
6_7543600,noop_province_bosnia,7543600,6,0,0,0,0
6_7650497,noop_attacks_manitoba_pennsylvania,7650497,6,0,0,0,0
6_6317512,noop_locale_beef_oregon,6317512,6,456,0,456,0
6_3763900,noop_craves_jealousy_beef,3763900,6,243,0,243,0
6_5377851,noop_craves_laceration_tofu,5377851,6,664,0,664,0
6_4892132,noop_craves_boils_ham,4892132,6,181,0,181,0
6_2224484,noop_locale_marzipan_pennsylvania,2224484,6,79,0,79,0
6_3159359,noop_pleasure_aesthetics,3159359,6,0,0,0,0
6_2443351,noop_eats_bacon_wonderbread,2443351,6,0,0,0,0
6_6512278,noop_attacks_goias_bosnia,6512278,6,0,0,0,0
6_4741415,noop_fears_jealousy_lubricity,4741415,6,428,0,428,0
6_1205284,noop_fears_boils_stimulation,1205284,6,397,0,397,0
6_335752,noop_craves_lubricity_ham,335752,6,481,0,481,0
6_2417187,noop_pleasure_lubricity,2417187,6,0,0,0,0
6_170733,noop_fears_hangover_love,170733,6,794,0,794,0
6_7601293,noop_craves_lubricity_lobster,7601293,6,1135,0,1135,0
6_6239897,province_bosnia,6239897,6,1,0,1,0
6_7650924,eats_onion_tofu,7650924,6,1,0,1,0
5_7703250,noop_craves_boils_haroset,7703250,5,0,588,588,0
4_2557270,craves_boils_haroset,2557270,4,0,9,9,0
5_4704550,succumb_jealousy_aesthetics_beef_saturn_earth,4704550,5,7,1058,1065,0
5_5808250,succumb_angina_stimulation_flounder_saturn_earth,5808250,5,7,607,614,0
5_5697700,succumb_grief_aesthetics_beef_saturn_earth,5697700,5,7,986,993,0
5_7819850,succumb_prostatitis_lubricity_beef_vulcan_uranus,7819850,5,7,623,630,0
5_6994950,succumb_grief_lubricity_flounder_saturn_earth,6994950,5,7,804,811,0
5_271750,succumb_jealousy_lubricity_beef_uranus_saturn,271750,5,7,685,692,0
5_6538550,feast_stimulation_ham_lemon_manitoba_pennsylvania,6538550,5,7,562,569,0
5_6544850,overcome_boils_love_wonderbread_vulcan_uranus,6544850,5,8,1170,1178,0
4_4117151,craves_boils_wonderbread,4117151,4,0,17,17,0
5_468150,overcome_boils_expectation_wonderbread_saturn_earth,468150,5,8,729,737,0
4_1739057,harmony_expectation_earth,1739057,4,0,17,17,0
6_4854234,fears_boils_expectation,4854234,6,3,55,58,0
5_6879950,overcome_boils_stimulation_tofu_saturn_earth,6879950,5,8,1091,1099,0
4_1403974,craves_boils_tofu,1403974,4,0,6,6,0
5_4912900,overcome_sciatica_stimulation_flounder_uranus_saturn,4912900,5,8,1361,1369,0
4_5508353,craves_sciatica_flounder,5508353,4,0,7,7,0
5_3291100,overcome_anxiety_stimulation_onion_uranus_saturn,3291100,5,9,621,630,0
5_2058750,overcome_anxiety_lubricity_onion_uranus_saturn,2058750,5,9,607,616,0
5_3963800,overcome_abrasion_lubricity_cantelope_uranus_saturn,3963800,5,8,651,659,0
4_5192457,craves_abrasion_cantelope,5192457,4,0,8,8,0
5_3698800,overcome_anger_lubricity_haroset_vulcan_uranus,3698800,5,9,597,606,0
5_4827200,overcome_prostatitis_expectation_wonderbread_vulcan_uranus,4827200,5,8,232,240,0
4_58194,craves_prostatitis_wonderbread,58194,4,0,19,19,0
6_5105477,fears_prostatitis_expectation,5105477,6,3,26,29,0
5_598900,overcome_prostatitis_stimulation_wonderbread_vulcan_uranus,598900,5,9,634,643,0
6_4679598,eats_bacon_wonderbread,4679598,6,1,0,1,0
5_5377851,noop_craves_laceration_tofu,5377851,5,0,665,665,0
4_7614098,craves_laceration_tofu,7614098,4,0,6,6,0
6_1221736,eats_bacon_lobster,1221736,6,1,0,1,0
6_5978126,eats_lamb_haroset,5978126,6,1,0,1,0
5_3939551,noop_craves_laceration_wonderbread,3939551,5,0,631,631,0
4_3146901,craves_laceration_wonderbread,3146901,4,0,17,17,0
5_6140901,succumb_grief_aesthetics_wonderbread_vulcan_uranus,6140901,5,7,478,485,0
5_6368951,succumb_laceration_love_tofu_vulcan_uranus,6368951,5,7,864,871,0
5_1748051,succumb_grief_expectation_wonderbread_vulcan_uranus,1748051,5,6,803,809,0
4_5283511,fears_grief_expectation,5283511,4,0,2,2,0
5_1666801,succumb_prostatitis_lubricity_onion_saturn_earth,1666801,5,7,664,671,0
6_3005221,craves_prostatitis_onion,3005221,6,2,27,29,0
5_1747201,succumb_depression_lubricity_onion_saturn_earth,1747201,5,7,673,680,0
5_3796751,succumb_angina_aesthetics_flounder_saturn_earth,3796751,5,6,1028,1034,0
4_223572,fears_angina_aesthetics,223572,4,0,3,3,0
5_2120551,succumb_laceration_aesthetics_lamb_uranus_saturn,2120551,5,7,1019,1026,0
5_2058151,succumb_prostatitis_stimulation_lamb_vulcan_uranus,2058151,5,7,637,644,0
6_4617196,craves_prostatitis_lamb,4617196,6,6,16,22,0
5_3861001,succumb_boils_stimulation_marzipan_saturn_earth,3861001,5,7,694,701,0
5_4897301,overcome_abrasion_stimulation_tofu_saturn_earth,4897301,5,8,693,701,0
4_411754,craves_abrasion_tofu,411754,4,0,8,8,0
5_331051,overcome_depression_expectation_okra_saturn_earth,331051,5,9,179,188,0
5_6692851,overcome_angina_aesthetics_flounder_vulcan_uranus,6692851,5,9,950,959,0
5_7790851,overcome_hangover_expectation_snickers_saturn_earth,7790851,5,9,173,182,0
5_1421551,overcome_anger_lubricity_lemon_saturn_earth,1421551,5,8,1169,1177,0
4_4480323,craves_anger_lemon,4480323,4,0,7,7,0
5_3864401,overcome_jealousy_lubricity_wonderbread_uranus_saturn,3864401,5,8,1211,1219,0
4_804720,craves_jealousy_wonderbread,804720,4,0,19,19,0
5_7981201,overcome_laceration_achievement_wonderbread_uranus_saturn,7981201,5,9,670,679,0
6_562209,fears_laceration_achievement,562209,6,2,43,45,0
5_963601,overcome_laceration_lubricity_tofu_saturn_earth,963601,5,9,1105,1114,0
5_7615901,overcome_grief_lubricity_beef_saturn_earth,7615901,5,8,1283,1291,0
4_6317015,craves_grief_beef,6317015,4,0,7,7,0
6_4281177,eats_okra_wonderbread,4281177,6,1,0,1,0
5_5640752,succumb_boils_lubricity_cantelope_vulcan_uranus,5640752,5,7,604,611,0
5_941202,succumb_boils_aesthetics_lamb_uranus_saturn,941202,5,6,1182,1188,0
4_5962620,fears_boils_aesthetics,5962620,4,0,6,6,0
5_3636552,succumb_prostatitis_lubricity_cantelope_vulcan_uranus,3636552,5,7,625,632,0
5_2078802,succumb_sciatica_aesthetics_haroset_vulcan_uranus,2078802,5,7,654,661,0
5_6041102,succumb_abrasion_stimulation_flounder_saturn_earth,6041102,5,7,668,675,0
6_7185267,craves_abrasion_flounder,7185267,6,6,20,26,0
5_1918052,succumb_grief_stimulation_lamb_vulcan_uranus,1918052,5,7,809,816,0
5_763302,succumb_jealousy_love_tofu_vulcan_uranus,763302,5,7,827,834,0
6_5227290,craves_jealousy_tofu,5227290,6,1,89,90,0
5_4480352,succumb_anger_lubricity_lamb_saturn_earth,4480352,5,7,591,598,0
6_1599319,craves_anger_lamb,1599319,6,3,44,47,0
5_5500052,succumb_anger_lubricity_lobster_saturn_earth,5500052,5,7,1171,1178,0
6_4906211,craves_anger_lobster,4906211,6,1,107,108,0
5_6116802,succumb_prostatitis_love_wonderbread_vulcan_uranus,6116802,5,7,810,817,0
5_1343002,overcome_boils_stimulation_tofu_vulcan_uranus,1343002,5,9,1094,1103,0
5_1062052,overcome_anxiety_love_onion_vulcan_uranus,1062052,5,8,781,789,0
4_2657767,craves_love_onion,2657767,4,0,3,3,0
6_5436552,fears_anxiety_love,5436552,6,1,85,86,0
5_4483052,overcome_abrasion_love_ham_vulcan_uranus,4483052,5,8,1204,1212,0
4_55452,craves_abrasion_ham,55452,4,0,8,8,0
5_4194702,overcome_prostatitis_stimulation_beef_uranus_saturn,4194702,5,8,638,646,0
4_5125653,craves_prostatitis_beef,5125653,4,0,10,10,0
5_4564202,overcome_jealousy_stimulation_lemon_uranus_saturn,4564202,5,8,1190,1198,0
4_7186611,craves_jealousy_lemon,7186611,4,0,7,7,0
5_2318702,overcome_jealousy_stimulation_wonderbread_saturn_earth,2318702,5,9,1173,1182,0
5_3456752,overcome_laceration_aesthetics_wonderbread_saturn_earth,3456752,5,9,934,943,0
5_6009202,overcome_grief_entertainment_ham_vulcan_uranus,6009202,5,8,893,901,0
4_3385988,craves_grief_ham,3385988,4,0,7,7,0
5_6105303,succumb_angina_lubricity_lobster_saturn_earth,6105303,5,7,1168,1175,0
6_2678414,craves_angina_lobster,2678414,6,1,107,108,0
5_5992053,succumb_boils_entertainment_lamb_vulcan_uranus,5992053,5,7,952,959,0
5_1804303,succumb_loneliness_lubricity_marzipan_uranus_saturn,1804303,5,7,583,590,0
6_327295,craves_loneliness_marzipan,327295,6,4,8,12,0
5_3342953,succumb_boils_love_marzipan_vulcan_uranus,3342953,5,7,843,850,0
5_5973003,feast_aesthetics_lemon_beef_bavaria_manitoba,5973003,5,6,1364,1370,0
4_428472,craves_aesthetics_lemon,428472,4,0,7,7,0
5_6721903,feast_entertainment_tofu_onion_bavaria_manitoba,6721903,5,6,927,933,0
4_3965931,craves_entertainment_tofu,3965931,4,0,7,7,0
6_6360942,craves_entertainment_onion,6360942,6,1,111,112,0
5_521953,overcome_boils_stimulation_haroset_vulcan_uranus,521953,5,9,1062,1071,0
5_5266653,overcome_boils_entertainment_haroset_vulcan_uranus,5266653,5,9,1018,1027,0
5_3341853,overcome_abrasion_stimulation_cantelope_uranus_saturn,3341853,5,9,668,677,0
5_7045953,overcome_angina_aesthetics_lemon_saturn_earth,7045953,5,9,1032,1041,0
5_4701253,overcome_angina_lubricity_haroset_saturn_earth,4701253,5,8,587,595,0
4_4362705,craves_angina_haroset,4362705,4,0,9,9,0
5_6563703,overcome_prostatitis_learning_wonderbread_vulcan_uranus,6563703,5,9,256,265,0
6_3583812,fears_prostatitis_learning,3583812,6,3,28,31,0
5_6571253,overcome_laceration_expectation_wonderbread_saturn_earth,6571253,5,9,739,748,0
6_2122245,fears_laceration_expectation,2122245,6,3,49,52,0
5_6283353,overcome_grief_stimulation_beef_vulcan_uranus,6283353,5,9,1282,1291,0
5_5310403,overcome_grief_lubricity_wonderbread_vulcan_uranus,5310403,5,9,980,989,0
6_5127929,pleasure_learning,5127929,6,1,0,1,0
6_1567476,pain_anger,1567476,6,1,0,1,0
6_7563751,eats_cantelope_lemon,7563751,6,1,0,1,0
5_7229304,succumb_prostatitis_entertainment_marzipan_vulcan_uranus,7229304,5,6,969,975,0
4_2810155,fears_prostatitis_entertainment,2810155,4,0,1,1,0
5_5842504,succumb_jealousy_stimulation_lemon_vulcan_uranus,5842504,5,7,688,695,0
5_6935854,succumb_laceration_lubricity_lemon_saturn_earth,6935854,5,7,670,677,0
5_5953404,succumb_prostatitis_love_cantelope_vulcan_uranus,5953404,5,7,810,817,0
5_7310204,succumb_prostatitis_stimulation_lemon_uranus_saturn,7310204,5,7,638,645,0
6_962066,craves_prostatitis_lemon,962066,6,6,16,22,0
5_7504554,succumb_jealousy_lubricity_haroset_uranus_saturn,7504554,5,7,682,689,0
5_6454254,overcome_boils_love_tofu_vulcan_uranus,6454254,5,9,1196,1205,0
5_5444154,overcome_boils_learning_wonderbread_saturn_earth,5444154,5,8,751,759,0
4_2299014,harmony_learning_earth,2299014,4,0,16,16,0
6_5903734,fears_boils_learning,5903734,6,3,57,60,0
5_5105954,overcome_boils_aesthetics_haroset_uranus_saturn,5105954,5,9,1110,1119,0
5_632704,overcome_boils_lubricity_cantelope_uranus_saturn,632704,5,9,604,613,0
5_3199154,overcome_depression_expectation_wonderbread_saturn_earth,3199154,5,9,181,190,0
5_5623204,overcome_hangover_learning_wonderbread_saturn_earth,5623204,5,9,193,202,0
5_500704,overcome_jealousy_aesthetics_wonderbread_vulcan_uranus,500704,5,9,931,940,0
5_5049554,overcome_jealousy_aesthetics_beef_uranus_saturn,5049554,5,9,1058,1067,0
5_3645954,overcome_laceration_learning_wonderbread_saturn_earth,3645954,5,9,761,770,0
6_1529026,fears_laceration_learning,1529026,6,3,51,54,0
5_3451254,overcome_laceration_aesthetics_flounder_uranus_saturn,3451254,5,9,1301,1310,0
6_7281678,eats_snickers_wonderbread,7281678,6,1,0,1,0
6_4730552,eats_beef_lemon,4730552,6,1,0,1,0
5_2827055,succumb_boils_lubricity_wonderbread_uranus_saturn,2827055,5,7,629,636,0
5_6979705,succumb_laceration_stimulation_marzipan_vulcan_uranus,6979705,5,7,656,663,0
5_4019105,succumb_laceration_stimulation_bacon_uranus_saturn,4019105,5,7,1286,1293,0
5_2212255,succumb_anxiety_lubricity_onion_saturn_earth,2212255,5,6,613,619,0
4_2652512,fears_anxiety_lubricity,2652512,4,0,1,1,0
5_1542305,succumb_grief_stimulation_bacon_uranus_saturn,1542305,5,7,1286,1293,0
5_797805,succumb_abrasion_lubricity_haroset_uranus_saturn,797805,5,7,652,659,0
5_3574155,succumb_prostatitis_stimulation_marzipan_vulcan_uranus,3574155,5,7,638,645,0
5_6976505,succumb_prostatitis_stimulation_lamb_saturn_earth,6976505,5,7,637,644,0
5_756455,succumb_boils_stimulation_marzipan_uranus_saturn,756455,5,7,694,701,0
5_5563455,feast_aesthetics_lemon_ham_bavaria_manitoba,5563455,5,7,1364,1371,0
5_6157905,overcome_boils_stimulation_haroset_saturn_earth,6157905,5,9,1051,1060,0
5_3701455,overcome_boils_stimulation_ham_vulcan_uranus,3701455,5,9,683,692,0
5_1533955,overcome_boils_aesthetics_haroset_saturn_earth,1533955,5,9,1111,1120,0
5_6135955,overcome_angina_stimulation_haroset_vulcan_uranus,6135955,5,9,1062,1071,0
5_6207355,overcome_anger_stimulation_lemon_vulcan_uranus,6207355,5,9,1164,1173,0
5_4769505,overcome_prostatitis_stimulation_wonderbread_uranus_saturn,4769505,5,9,634,643,0
5_4170905,overcome_laceration_aesthetics_ham_saturn_earth,4170905,5,8,1408,1416,0
4_2833922,craves_laceration_ham,2833922,4,0,8,8,0
5_2602255,overcome_laceration_aesthetics_beef_uranus_saturn,2602255,5,9,1100,1109,0
6_3976229,planet_vulcan,3976229,6,1,0,1,0
5_54106,succumb_grief_aesthetics_wonderbread_saturn_earth,54106,5,7,478,485,0
5_4505506,succumb_sciatica_lubricity_lobster_saturn_earth,4505506,5,7,1236,1243,0
5_5918656,succumb_grief_expectation_wonderbread_uranus_saturn,5918656,5,7,803,810,0
5_2500956,succumb_sciatica_aesthetics_ham_saturn_earth,2500956,5,7,983,990,0
6_2806898,craves_sciatica_ham,2806898,6,1,117,118,0
5_7580506,succumb_abrasion_stimulation_lobster_vulcan_uranus,7580506,5,7,1216,1223,0
6_342073,craves_abrasion_lobster,342073,6,4,80,84,0
5_1690356,succumb_grief_stimulation_wonderbread_uranus_saturn,1690356,5,7,814,821,0
5_6228756,succumb_prostatitis_stimulation_lamb_uranus_saturn,6228756,5,7,637,644,0
5_210256,feast_aesthetics_marzipan_wonderbread_manitoba_pennsylvania,210256,5,6,1022,1028,0
4_2410921,craves_aesthetics_marzipan,2410921,4,0,16,16,0
5_2572256,overcome_sciatica_lubricity_flounder_saturn_earth,2572256,5,9,1368,1377,0
5_6311456,overcome_prostatitis_achievement_wonderbread_vulcan_uranus,6311456,5,9,162,171,0
6_3545441,fears_prostatitis_achievement,3545441,6,2,22,24,0
5_6034456,overcome_jealousy_expectation_wonderbread_vulcan_uranus,6034456,5,9,900,909,0
6_4602914,fears_jealousy_expectation,4602914,6,3,86,89,0
5_1806156,overcome_jealousy_stimulation_wonderbread_vulcan_uranus,1806156,5,9,1187,1196,0
6_3933873,province_bavaria,3933873,6,1,0,1,0
6_4177969,food_cantelope,4177969,6,1,0,1,0
5_6789757,succumb_boils_aesthetics_flounder_saturn_earth,6789757,5,7,1181,1188,0
5_5793607,succumb_abrasion_love_haroset_vulcan_uranus,5793607,5,7,841,848,0
5_3232307,succumb_grief_achievement_wonderbread_vulcan_uranus,3232307,5,6,734,740,0
4_3723475,fears_grief_achievement,3723475,4,0,2,2,0
5_6088657,succumb_grief_stimulation_lamb_uranus_saturn,6088657,5,7,809,816,0
5_638457,succumb_laceration_lubricity_marzipan_vulcan_uranus,638457,5,7,706,713,0
5_5901707,succumb_angina_love_haroset_vulcan_uranus,5901707,5,7,763,770,0
5_3467207,succumb_boils_love_flounder_vulcan_uranus,3467207,5,7,833,840,0
5_946107,feast_aesthetics_marzipan_wonderbread_pennsylvania_oregon,946107,5,7,1158,1165,0
5_4170357,feast_stimulation_ham_flounder_manitoba_pennsylvania,4170357,5,7,562,569,0
5_5513607,overcome_boils_stimulation_tofu_uranus_saturn,5513607,5,9,1094,1103,0
5_6725107,overcome_abrasion_love_haroset_vulcan_uranus,6725107,5,8,427,435,0
4_2026364,craves_abrasion_haroset,2026364,4,0,11,11,0
5_3048257,overcome_abrasion_love_wonderbread_vulcan_uranus,3048257,5,8,818,826,0
4_7207743,craves_abrasion_wonderbread,7207743,4,0,19,19,0
5_7575357,overcome_angina_entertainment_haroset_vulcan_uranus,7575357,5,9,1003,1012,0
5_2504357,overcome_jealousy_aesthetics_ham_saturn_earth,2504357,5,9,1061,1070,0
5_5862507,overcome_grief_lubricity_ham_saturn_earth,5862507,5,9,1288,1297,0
5_7325158,noop_craves_prostatitis_tofu,7325158,5,0,145,145,0
4_3734046,craves_prostatitis_tofu,3734046,4,0,8,8,0
6_6133837,food_okra,6133837,6,1,0,1,0
5_4187608,noop_fears_loneliness_love,4187608,5,0,744,744,0
4_6977933,fears_loneliness_love,6977933,4,0,1,1,0
6_6406031,planet_saturn,6406031,6,1,0,1,0
5_2343508,noop_craves_entertainment_tofu,2343508,5,1,883,884,0
5_3932458,succumb_anger_stimulation_lemon_saturn_earth,3932458,5,7,621,628,0
5_7301358,succumb_sciatica_stimulation_haroset_saturn_earth,7301358,5,7,734,741,0
5_7185308,succumb_anger_love_cantelope_vulcan_uranus,7185308,5,7,763,770,0
6_4015280,craves_anger_cantelope,4015280,6,1,81,82,0
5_3248958,succumb_jealousy_entertainment_marzipan_vulcan_uranus,3248958,5,7,958,965,0
5_6662158,feast_aesthetics_marzipan_beef_bavaria_manitoba,6662158,5,7,1022,1029,0
5_4692558,overcome_boils_stimulation_haroset_uranus_saturn,4692558,5,9,1051,1060,0
5_7009658,overcome_boils_aesthetics_wonderbread_vulcan_uranus,7009658,5,9,926,935,0
5_4198758,overcome_abrasion_aesthetics_haroset_vulcan_uranus,4198758,5,9,753,762,0
5_5551508,overcome_prostatitis_aesthetics_beef_uranus_saturn,5551508,5,9,1072,1081,0
6_2119382,fears_prostatitis_aesthetics,2119382,6,6,33,39,0
6_1013998,pleasure_aesthetics,1013998,6,1,0,1,0
6_4362134,eats_flounder_ham,4362134,6,1,0,1,0
6_3933582,pain_jealousy,3933582,6,1,0,1,0
6_1767281,food_lemon,1767281,6,1,0,1,0
6_20256,province_oregon,20256,6,1,0,1,0
5_4537709,succumb_angina_stimulation_lemon_saturn_earth,4537709,5,7,616,623,0
5_7821209,succumb_hangover_stimulation_onion_saturn_earth,7821209,5,7,684,691,0
5_7103959,succumb_laceration_stimulation_flounder_vulcan_uranus,7103959,5,7,644,651,0
5_7561909,succumb_prostatitis_lubricity_lemon_saturn_earth,7561909,5,7,617,624,0
5_310409,succumb_angina_aesthetics_flounder_uranus_saturn,310409,5,7,1028,1035,0
5_2095409,succumb_boils_entertainment_lemon_vulcan_uranus,2095409,5,7,992,999,0
5_5085559,succumb_prostatitis_stimulation_tofu_uranus_saturn,5085559,5,7,656,663,0
5_4051509,succumb_boils_stimulation_lamb_vulcan_uranus,4051509,5,7,672,679,0
5_880709,succumb_boils_stimulation_flounder_uranus_saturn,880709,5,7,683,690,0
5_4007159,feast_aesthetics_lemon_cantelope_bavaria_manitoba,4007159,5,7,1364,1371,0
6_3791185,craves_aesthetics_cantelope,3791185,6,4,121,125,0
5_4728159,feast_entertainment_tofu_marzipan_bavaria_manitoba,4728159,5,7,927,934,0
5_5647759,feast_entertainment_lamb_haroset_bavaria_manitoba,5647759,5,7,838,845,0
5_6283509,feast_aesthetics_lamb_haroset_bavaria_manitoba,6283509,5,7,908,915,0
5_1407409,overcome_abrasion_love_tofu_vulcan_uranus,1407409,5,9,862,871,0
5_7637259,overcome_depression_expectation_onion_saturn_earth,7637259,5,9,240,249,0
5_3075809,overcome_angina_lubricity_lemon_vulcan_uranus,3075809,5,9,565,574,0
5_3746459,overcome_anger_aesthetics_ham_uranus_saturn,3746459,5,9,1032,1041,0
5_2766459,overcome_dread_stimulation_wonderbread_vulcan_uranus,2766459,5,9,588,597,0
5_7689259,overcome_jealousy_aesthetics_wonderbread_saturn_earth,7689259,5,9,931,940,0
5_4671309,overcome_jealousy_aesthetics_wonderbread_uranus_saturn,4671309,5,9,931,940,0
5_1560359,overcome_jealousy_lubricity_wonderbread_saturn_earth,1560359,5,9,1199,1208,0
5_82109,overcome_laceration_aesthetics_ham_uranus_saturn,82109,5,9,1405,1414,0
6_4623385,province_manitoba,4623385,6,1,0,1,0
5_1540510,noop_craves_laceration_bacon,1540510,5,0,1314,1314,0
4_5950375,craves_laceration_bacon,5950375,4,0,4,4,0
5_2442010,succumb_boils_lubricity_tofu_uranus_saturn,2442010,5,7,633,640,0
5_3215560,succumb_grief_learning_wonderbread_vulcan_uranus,3215560,5,6,827,833,0
4_7765619,fears_grief_learning,7765619,4,0,2,2,0
5_7757860,succumb_abrasion_lubricity_cantelope_vulcan_uranus,7757860,5,7,665,672,0
5_5208310,succumb_dread_lubricity_wonderbread_uranus_saturn,5208310,5,7,605,612,0
5_6940560,succumb_boils_stimulation_ham_uranus_saturn,6940560,5,7,683,690,0
5_776910,feast_entertainment_ham_flounder_manitoba_pennsylvania,776910,5,7,837,844,0
5_2650810,overcome_abrasion_learning_wonderbread_uranus_saturn,2650810,5,9,312,321,0
6_6141141,fears_abrasion_learning,6141141,6,3,31,34,0
5_4827410,overcome_abrasion_lubricity_wonderbread_saturn_earth,4827410,5,9,664,673,0
5_394710,overcome_angina_aesthetics_haroset_vulcan_uranus,394710,5,9,1101,1110,0
5_3543510,overcome_prostatitis_entertainment_tofu_vulcan_uranus,3543510,5,9,978,987,0
5_7513210,overcome_prostatitis_lubricity_cantelope_vulcan_uranus,7513210,5,8,618,626,0
4_7047677,craves_prostatitis_cantelope,7047677,4,0,8,8,0
5_6397010,overcome_grief_aesthetics_lamb_saturn_earth,6397010,5,9,953,962,0
6_4022794,attacks_bavaria_manitoba,4022794,6,1,0,1,0
5_456961,noop_craves_anger_lemon,456961,5,1,752,753,0
5_5673461,succumb_jealousy_stimulation_wonderbread_uranus_saturn,5673461,5,7,689,696,0
5_762711,succumb_laceration_lubricity_flounder_vulcan_uranus,762711,5,7,690,697,0
5_7705611,succumb_anger_aesthetics_haroset_saturn_earth,7705611,5,7,950,957,0
5_6242161,overcome_depression_lubricity_onion_uranus_saturn,6242161,5,9,726,735,0
5_7001261,overcome_angina_aesthetics_haroset_saturn_earth,7001261,5,9,1096,1105,0
5_333461,overcome_anger_lubricity_lemon_uranus_saturn,333461,5,9,1169,1178,0
5_493311,overcome_prostatitis_learning_wonderbread_saturn_earth,493311,5,9,258,267,0
5_5976761,overcome_jealousy_stimulation_wonderbread_uranus_saturn,5976761,5,9,1187,1196,0
5_6488111,overcome_jealousy_stimulation_bacon_vulcan_uranus,6488111,5,9,1319,1328,0
5_1955711,overcome_laceration_lubricity_ham_uranus_saturn,1955711,5,9,1073,1082,0
6_601332,pleasure_achievement,601332,6,1,0,1,0
6_6456524,eats_lamb_beef,6456524,6,1,0,1,0
6_3715801,orbits_saturn_earth,3715801,6,1,0,1,0
5_5475662,succumb_prostatitis_lubricity_lamb_saturn_earth,5475662,5,7,615,622,0
5_7402912,succumb_grief_achievement_wonderbread_uranus_saturn,7402912,5,7,734,741,0
5_4809062,succumb_laceration_lubricity_marzipan_uranus_saturn,4809062,5,7,699,706,0
5_5191562,succumb_prostatitis_love_beef_vulcan_uranus,5191562,5,7,810,817,0
5_7988762,succumb_prostatitis_stimulation_beef_vulcan_uranus,7988762,5,7,638,645,0
5_6156762,feast_aesthetics_marzipan_tofu_manitoba_pennsylvania,6156762,5,7,1022,1029,0
6_5544683,craves_aesthetics_tofu,5544683,6,3,124,127,0
5_3960812,overcome_sciatica_lubricity_lamb_vulcan_uranus,3960812,5,8,1368,1376,0
4_1579104,craves_sciatica_lamb,1579104,4,0,7,7,0
5_2931612,overcome_abrasion_entertainment_cantelope_vulcan_uranus,2931612,5,8,997,1005,0
4_3033139,craves_entertainment_cantelope,3033139,4,0,4,4,0
5_491812,overcome_angina_aesthetics_ham_uranus_saturn,491812,5,9,1032,1041,0
5_2742762,overcome_hangover_expectation_onion_saturn_earth,2742762,5,9,267,276,0
5_6123062,overcome_prostatitis_love_beef_vulcan_uranus,6123062,5,9,805,814,0
5_3298112,overcome_prostatitis_lubricity_tofu_vulcan_uranus,3298112,5,9,634,643,0
5_7518712,overcome_jealousy_achievement_wonderbread_vulcan_uranus,7518712,5,9,831,840,0
6_3042878,fears_jealousy_achievement,3042878,6,2,82,84,0
5_3140812,overcome_jealousy_aesthetics_flounder_saturn_earth,3140812,5,9,968,977,0
5_1711262,overcome_laceration_learning_wonderbread_uranus_saturn,1711262,5,9,760,769,0
5_14162,overcome_laceration_entertainment_cantelope_vulcan_uranus,14162,5,8,1322,1330,0
4_4834197,craves_laceration_cantelope,4834197,4,0,6,6,0
5_1281412,overcome_laceration_aesthetics_wonderbread_uranus_saturn,1281412,5,9,934,943,0
5_3887862,overcome_laceration_lubricity_wonderbread_saturn_earth,3887862,5,9,1090,1099,0
5_5738113,noop_craves_prostatitis_cantelope,5738113,5,1,124,125,0
5_2200813,noop_craves_abrasion_ham,2200813,5,1,654,655,0
5_1754963,succumb_laceration_stimulation_lemon_vulcan_uranus,1754963,5,7,641,648,0
5_258363,succumb_sciatica_aesthetics_lamb_uranus_saturn,258363,5,7,934,941,0
5_3417013,succumb_laceration_lubricity_haroset_uranus_saturn,3417013,5,7,681,688,0
5_1835713,succumb_prostatitis_stimulation_onion_saturn_earth,1835713,5,7,679,686,0
5_940213,succumb_grief_lubricity_haroset_uranus_saturn,940213,5,7,813,820,0
5_88513,succumb_anger_aesthetics_ham_saturn_earth,88513,5,7,1031,1038,0
5_1218813,overcome_boils_entertainment_tofu_vulcan_uranus,1218813,5,9,1329,1338,0
5_7803313,overcome_boils_aesthetics_beef_uranus_saturn,7803313,5,9,1101,1110,0
5_3499213,overcome_sciatica_aesthetics_haroset_uranus_saturn,3499213,5,9,655,664,0
5_5383013,overcome_abrasion_lubricity_tofu_saturn_earth,5383013,5,9,675,684,0
5_3473513,overcome_laceration_love_ham_vulcan_uranus,3473513,5,9,1181,1190,0
5_6907463,overcome_grief_aesthetics_flounder_vulcan_uranus,6907463,5,9,956,965,0
5_6177213,overcome_grief_aesthetics_wonderbread_vulcan_uranus,6177213,5,9,627,636,0
5_1079463,overcome_grief_lubricity_ham_uranus_saturn,1079463,5,9,1288,1297,0
5_5927114,noop_craves_entertainment_cantelope,5927114,5,1,863,864,0
6_4615811,locale_onion_bavaria,4615811,6,1,0,1,0
5_7615264,succumb_prostatitis_lubricity_wonderbread_uranus_saturn,7615264,5,7,630,637,0
5_1167014,succumb_laceration_lubricity_lobster_saturn_earth,1167014,5,7,1243,1250,0
5_6913214,succumb_loneliness_stimulation_tofu_uranus_saturn,6913214,5,7,597,604,0
5_7122214,overcome_boils_stimulation_cantelope_vulcan_uranus,7122214,5,9,682,691,0
5_3895164,overcome_boils_stimulation_wonderbread_vulcan_uranus,3895164,5,9,1086,1095,0
5_2708164,overcome_sciatica_lubricity_flounder_vulcan_uranus,2708164,5,9,1373,1382,0
5_2017014,overcome_abrasion_stimulation_tofu_uranus_saturn,2017014,5,9,698,707,0
5_5316664,overcome_abrasion_entertainment_haroset_vulcan_uranus,5316664,5,9,649,658,0
5_5820664,overcome_abrasion_aesthetics_beef_uranus_saturn,5820664,5,9,1106,1115,0
5_5836514,overcome_depression_stimulation_onion_uranus_saturn,5836514,5,9,740,749,0
5_6153114,overcome_prostatitis_love_wonderbread_vulcan_uranus,6153114,5,9,782,791,0
5_4240914,overcome_jealousy_aesthetics_flounder_vulcan_uranus,4240914,5,9,980,989,0
5_46414,overcome_jealousy_lubricity_marzipan_saturn_earth,46414,5,8,1205,1213,0
4_2993567,craves_jealousy_marzipan,2993567,4,0,7,7,0
6_5711881,pain_prostatitis,5711881,6,1,0,1,0
6_7420512,orbits_vulcan_uranus,7420512,6,1,0,1,0
5_780265,succumb_anger_stimulation_haroset_vulcan_uranus,780265,5,7,621,628,0
5_6877865,succumb_anger_stimulation_lemon_vulcan_uranus,6877865,5,7,621,628,0
5_3400515,succumb_grief_aesthetics_haroset_vulcan_uranus,3400515,5,7,676,683,0
5_7386165,succumb_grief_learning_wonderbread_uranus_saturn,7386165,5,7,827,834,0
5_3979665,succumb_angina_entertainment_lemon_vulcan_uranus,3979665,5,7,920,927,0
5_7233965,succumb_jealousy_stimulation_marzipan_vulcan_uranus,7233965,5,7,703,710,0
5_4565315,overcome_angina_aesthetics_haroset_uranus_saturn,4565315,5,9,1095,1104,0
5_6352815,overcome_hangover_expectation_onion_vulcan_uranus,6352815,5,9,266,275,0
5_4866915,overcome_jealousy_love_marzipan_vulcan_uranus,4866915,5,9,818,827,0
5_2949315,overcome_jealousy_aesthetics_lamb_vulcan_uranus,2949315,5,9,981,990,0
5_902415,overcome_laceration_aesthetics_flounder_saturn_earth,902415,5,9,1298,1307,0
5_1893615,overcome_grief_lubricity_beef_uranus_saturn,1893615,5,9,1283,1292,0
6_1243086,pleasure_entertainment,1243086,6,1,0,1,0
5_3734316,succumb_angina_lubricity_lamb_uranus_saturn,3734316,5,7,577,584,0
6_4304394,craves_angina_lamb,4304394,6,3,44,47,0
5_3771966,succumb_sciatica_lubricity_haroset_saturn_earth,3771966,5,7,725,732,0
5_653566,succumb_grief_stimulation_flounder_vulcan_uranus,653566,5,7,821,828,0
5_1412316,succumb_hangover_lubricity_wonderbread_uranus_saturn,1412316,5,7,645,652,0
5_7309516,succumb_hangover_achievement_wonderbread_saturn_earth,7309516,5,7,129,136,0
6_3962347,harmony_achievement_earth,3962347,6,4,9,13,0
5_4933316,succumb_laceration_lubricity_flounder_uranus_saturn,4933316,5,7,682,689,0
5_3335266,succumb_grief_lubricity_lamb_uranus_saturn,3335266,5,7,812,819,0
5_5507766,succumb_anger_aesthetics_flounder_uranus_saturn,5507766,5,7,956,963,0
5_4686816,succumb_anger_aesthetics_haroset_vulcan_uranus,4686816,5,7,958,965,0
5_5546616,succumb_boils_stimulation_lamb_saturn_earth,5546616,5,7,672,679,0
5_716016,feast_lubricity_ham_flounder_bavaria_manitoba,716016,5,6,1245,1251,0
4_5323336,locale_ham_manitoba,5323336,4,0,2,2,0
6_3967861,locale_ham_bavaria,3967861,6,2,119,121,0
5_5617266,overcome_angina_stimulation_haroset_saturn_earth,5617266,5,9,1051,1060,0
5_3774266,overcome_angina_lubricity_flounder_vulcan_uranus,3774266,5,9,577,586,0
5_4155716,overcome_prostatitis_stimulation_beef_saturn_earth,4155716,5,9,638,647,0
5_951266,overcome_prostatitis_stimulation_tofu_vulcan_uranus,951266,5,9,656,665,0
5_2441016,overcome_dread_learning_wonderbread_saturn_earth,2441016,5,9,177,186,0
5_5819416,overcome_jealousy_lubricity_lobster_uranus_saturn,5819416,5,9,1224,1233,0
5_6997666,overcome_laceration_love_tofu_vulcan_uranus,6997666,5,9,1198,1207,0
5_502016,overcome_laceration_aesthetics_lamb_vulcan_uranus,502016,5,9,1019,1028,0
5_3462266,overcome_laceration_lubricity_wonderbread_vulcan_uranus,3462266,5,9,1104,1113,0
5_3112916,overcome_laceration_lubricity_tofu_uranus_saturn,3112916,5,9,1108,1117,0
6_2380884,food_haroset,2380884,6,1,0,1,0
5_62767,noop_harmony_learning_earth,62767,5,1,89,90,0
5_4069667,succumb_jealousy_aesthetics_ham_saturn_earth,4069667,5,7,1058,1065,0
5_4254767,succumb_grief_aesthetics_flounder_uranus_saturn,4254767,5,7,944,951,0
5_4073617,succumb_prostatitis_lubricity_lemon_uranus_saturn,4073617,5,7,617,624,0
5_7889767,succumb_abrasion_stimulation_cantelope_uranus_saturn,7889767,5,7,668,675,0
5_4212517,succumb_abrasion_entertainment_lemon_vulcan_uranus,4212517,5,7,997,1004,0
5_747367,succumb_jealousy_stimulation_ham_uranus_saturn,747367,5,7,692,699,0
5_3478767,succumb_boils_love_cantelope_vulcan_uranus,3478767,5,7,836,843,0
5_5599967,succumb_boils_love_lamb_vulcan_uranus,5599967,5,7,836,843,0
5_3374767,overcome_boils_aesthetics_lemon_saturn_earth,3374767,5,9,1101,1110,0
5_2138017,overcome_abrasion_entertainment_wonderbread_vulcan_uranus,2138017,5,9,665,674,0
5_7468717,overcome_prostatitis_lubricity_tofu_uranus_saturn,7468717,5,9,627,636,0
5_6657717,overcome_laceration_love_flounder_vulcan_uranus,6657717,5,9,1137,1146,0
5_7322667,overcome_laceration_lubricity_cantelope_saturn_earth,7322667,5,9,1097,1106,0
5_4702167,overcome_grief_stimulation_bacon_vulcan_uranus,4702167,5,9,1286,1295,0
5_5077368,noop_craves_abrasion_wonderbread,5077368,5,1,179,180,0
6_6052830,eats_lobster_bacon,6052830,6,1,0,1,0
5_3329468,noop_craves_boils_wonderbread,3329468,5,1,621,622,0
5_2691068,succumb_jealousy_aesthetics_bacon_uranus_saturn,2691068,5,7,629,636,0
5_7999168,succumb_laceration_aesthetics_flounder_uranus_saturn,7999168,5,7,1026,1033,0
5_2568518,succumb_sciatica_stimulation_bacon_uranus_saturn,2568518,5,7,1300,1307,0
5_2829268,succumb_prostatitis_stimulation_cantelope_uranus_saturn,2829268,5,7,639,646,0
5_3663368,succumb_loneliness_stimulation_onion_saturn_earth,3663368,5,7,622,629,0
6_7320002,craves_loneliness_onion,7320002,6,2,16,18,0
5_1824168,overcome_boils_learning_wonderbread_vulcan_uranus,1824168,5,9,749,758,0
5_39918,overcome_boils_aesthetics_ham_uranus_saturn,39918,5,9,1101,1110,0
5_1413418,overcome_abrasion_expectation_wonderbread_uranus_saturn,1413418,5,9,288,297,0
6_3004960,fears_abrasion_expectation,3004960,6,3,29,32,0
5_5628518,overcome_abrasion_stimulation_wonderbread_saturn_earth,5628518,5,9,649,658,0
5_1392118,overcome_abrasion_aesthetics_lemon_saturn_earth,1392118,5,9,1106,1115,0
5_2204518,overcome_abrasion_lubricity_ham_vulcan_uranus,2204518,5,9,1087,1096,0
5_5421418,overcome_prostatitis_aesthetics_marzipan_saturn_earth,5421418,5,9,1078,1087,0
5_2952169,noop_craves_prostatitis_wonderbread,2952169,5,1,124,125,0
5_7705169,noop_craves_love_onion,7705169,5,1,760,761,0
6_3135358,eats_snickers_onion,3135358,6,1,0,1,0
5_3038769,succumb_boils_lubricity_haroset_uranus_saturn,3038769,5,7,598,605,0
5_5825319,succumb_angina_aesthetics_ham_saturn_earth,5825319,5,7,1033,1040,0
5_7358219,succumb_jealousy_stimulation_flounder_vulcan_uranus,7358219,5,7,691,698,0
5_105669,succumb_jealousy_stimulation_bacon_uranus_saturn,105669,5,7,1295,1302,0
5_5642169,succumb_dread_stimulation_wonderbread_uranus_saturn,5642169,5,7,589,596,0
5_1376719,succumb_boils_stimulation_lemon_vulcan_uranus,1376719,5,7,679,686,0
5_6916969,feast_aesthetics_marzipan_cantelope_bavaria_manitoba,6916969,5,7,1022,1029,0
5_3901719,overcome_boils_aesthetics_wonderbread_saturn_earth,3901719,5,9,926,935,0
5_2563469,overcome_sciatica_aesthetics_lamb_saturn_earth,2563469,5,9,980,989,0
5_6878769,overcome_sciatica_lubricity_flounder_uranus_saturn,6878769,5,9,1368,1377,0
5_821469,overcome_jealousy_lubricity_lemon_uranus_saturn,821469,5,9,1205,1214,0
5_5886019,overcome_jealousy_lubricity_haroset_vulcan_uranus,5886019,5,9,681,690,0
6_7434994,eats_lemon_beef,7434994,6,1,0,1,0
6_3163114,planet_earth,3163114,6,1,0,1,0
5_4720670,noop_craves_sciatica_flounder,4720670,5,1,966,967,0
5_3062520,succumb_grief_love_lamb_vulcan_uranus,3062520,5,7,800,807,0
5_3810520,overcome_abrasion_aesthetics_wonderbread_vulcan_uranus,3810520,5,9,514,523,0
5_5899270,overcome_depression_love_onion_vulcan_uranus,5899270,5,9,903,912,0
5_4294670,overcome_prostatitis_stimulation_cantelope_vulcan_uranus,4294670,5,9,639,648,0
5_4699820,overcome_prostatitis_lubricity_tofu_saturn_earth,4699820,5,9,622,631,0
6_5601736,eats_cantelope_marzipan,5601736,6,1,0,1,0
6_1830183,province_goias,1830183,6,1,0,1,0
5_7577871,noop_fears_prostatitis_entertainment,7577871,5,1,953,954,0
5_343821,succumb_anxiety_stimulation_onion_saturn_earth,343821,5,6,628,634,0
4_4443807,fears_anxiety_stimulation,4443807,4,0,1,1,0
5_50921,succumb_abrasion_love_cantelope_vulcan_uranus,50921,5,7,841,848,0
5_4904071,succumb_abrasion_stimulation_lobster_saturn_earth,4904071,5,7,1216,1223,0
5_7945821,succumb_abrasion_stimulation_onion_saturn_earth,7945821,5,7,721,728,0
6_602031,craves_abrasion_onion,602031,6,2,31,33,0
5_4824171,succumb_grief_stimulation_flounder_uranus_saturn,4824171,5,7,821,828,0
5_6443021,succumb_jealousy_stimulation_wonderbread_saturn_earth,6443021,5,7,689,696,0
5_7730821,succumb_prostatitis_stimulation_lemon_saturn_earth,7730821,5,7,638,645,0
5_6780071,succumb_grief_lubricity_flounder_vulcan_uranus,6780071,5,7,813,820,0
5_7527771,succumb_grief_lubricity_lamb_saturn_earth,7527771,5,7,803,810,0
5_7803271,succumb_jealousy_lubricity_ham_saturn_earth,7803271,5,7,677,684,0
5_3223221,feast_aesthetics_lamb_beef_bavaria_manitoba,3223221,5,7,908,915,0
5_3096721,overcome_boils_aesthetics_marzipan_saturn_earth,3096721,5,9,1353,1362,0
5_258171,overcome_sciatica_stimulation_lamb_uranus_saturn,258171,5,9,1359,1368,0
5_2515571,overcome_abrasion_aesthetics_haroset_saturn_earth,2515571,5,9,746,755,0
5_7944871,overcome_angina_lubricity_flounder_uranus_saturn,7944871,5,9,568,577,0
5_6662521,overcome_hangover_learning_snickers_saturn_earth,6662521,5,9,170,179,0
5_5121871,overcome_prostatitis_stimulation_tofu_uranus_saturn,5121871,5,9,656,665,0
5_2973371,overcome_prostatitis_aesthetics_beef_saturn_earth,2973371,5,9,1074,1083,0
5_3173671,overcome_jealousy_lubricity_lemon_saturn_earth,3173671,5,9,1205,1214,0
5_7632871,overcome_laceration_lubricity_wonderbread_uranus_saturn,7632871,5,9,1100,1109,0
5_2703822,noop_craves_laceration_cantelope,2703822,5,1,650,651,0
5_1092922,noop_craves_grief_ham,1092922,5,1,875,876,0
6_5991737,eats_marzipan_cantelope,5991737,6,1,0,1,0
5_6675322,noop_craves_jealousy_wonderbread,6675322,5,1,793,794,0
5_4910622,noop_fears_grief_learning,4910622,5,1,808,809,0
5_964122,succumb_grief_aesthetics_lamb_uranus_saturn,964122,5,7,945,952,0
5_3766222,succumb_laceration_love_lobster_vulcan_uranus,3766222,5,7,844,851,0
5_4102122,succumb_jealousy_lubricity_beef_vulcan_uranus,4102122,5,7,692,699,0
5_4213922,overcome_boils_lubricity_lamb_uranus_saturn,4213922,5,9,602,611,0
5_1183272,overcome_abrasion_stimulation_cantelope_saturn_earth,1183272,5,9,662,671,0
5_4482222,overcome_abrasion_entertainment_tofu_vulcan_uranus,4482222,5,9,1018,1027,0
5_7794172,overcome_abrasion_lubricity_cantelope_vulcan_uranus,7794172,5,9,658,667,0
5_126872,overcome_abrasion_lubricity_wonderbread_uranus_saturn,126872,5,9,676,685,0
5_2042672,overcome_depression_lubricity_wonderbread_vulcan_uranus,2042672,5,9,652,661,0
5_5064322,overcome_prostatitis_stimulation_wonderbread_saturn_earth,5064322,5,9,620,629,0
5_2515022,overcome_prostatitis_entertainment_cantelope_vulcan_uranus,2515022,5,9,964,973,0
5_5668522,overcome_jealousy_love_wonderbread_vulcan_uranus,5668522,5,9,806,815,0
5_839422,overcome_laceration_aesthetics_marzipan_saturn_earth,839422,5,9,1112,1121,0
5_1895622,overcome_grief_aesthetics_lamb_uranus_saturn,1895622,5,9,953,962,0
5_4033472,overcome_grief_lubricity_lobster_uranus_saturn,4033472,5,9,1231,1240,0
5_3726373,noop_fears_boils_aesthetics,3726373,5,1,1092,1093,0
5_7924023,succumb_grief_entertainment_lemon_vulcan_uranus,7924023,5,7,888,895,0
6_1913612,craves_grief_lemon,1913612,6,1,100,101,0
5_7796223,succumb_laceration_aesthetics_beef_saturn_earth,7796223,5,7,1100,1107,0
5_1937273,succumb_sciatica_aesthetics_flounder_uranus_saturn,1937273,5,7,933,940,0
5_3174623,succumb_hangover_learning_onion_uranus_saturn,3174623,5,7,188,195,0
5_2131973,succumb_sciatica_learning_wonderbread_saturn_earth,2131973,5,7,484,491,0
5_1470773,succumb_laceration_lubricity_flounder_saturn_earth,1470773,5,7,673,680,0
5_2137023,succumb_jealousy_entertainment_bacon_vulcan_uranus,2137023,5,7,660,667,0
5_1854473,succumb_jealousy_lubricity_ham_uranus_saturn,1854473,5,7,686,693,0
5_5994773,overcome_boils_learning_wonderbread_uranus_saturn,5994773,5,9,750,759,0
5_1552973,overcome_sciatica_aesthetics_flounder_saturn_earth,1552973,5,9,981,990,0
5_774273,overcome_abrasion_learning_wonderbread_saturn_earth,774273,5,9,313,322,0
5_6375123,overcome_abrasion_lubricity_ham_uranus_saturn,6375123,5,9,1081,1090,0
5_1960173,overcome_jealousy_expectation_wonderbread_saturn_earth,1960173,5,9,902,911,0
5_7694773,overcome_jealousy_lubricity_wonderbread_vulcan_uranus,7694773,5,9,1215,1224,0
5_4149673,overcome_laceration_love_cantelope_vulcan_uranus,4149673,5,9,1195,1204,0
5_3859973,overcome_laceration_entertainment_flounder_vulcan_uranus,3859973,5,9,1230,1239,0
5_6815623,overcome_grief_stimulation_wonderbread_vulcan_uranus,6815623,5,9,961,970,0
6_1626822,province_pennsylvania,1626822,6,1,0,1,0
5_6243624,noop_fears_anxiety_lubricity,6243624,5,1,607,608,0
5_1146924,succumb_laceration_aesthetics_lobster_vulcan_uranus,1146924,5,7,708,715,0
5_6558774,succumb_abrasion_entertainment_marzipan_vulcan_uranus,6558774,5,7,1009,1016,0
5_3500124,succumb_hangover_lubricity_onion_saturn_earth,3500124,5,7,670,677,0
5_5703074,overcome_boils_aesthetics_lamb_vulcan_uranus,5703074,5,9,1307,1316,0
5_2897674,overcome_abrasion_achievement_wonderbread_uranus_saturn,2897674,5,9,218,227,0
6_1444924,fears_abrasion_achievement,1444924,6,2,25,27,0
5_3313824,overcome_abrasion_aesthetics_ham_uranus_saturn,3313824,5,9,1432,1441,0
5_694774,overcome_hangover_lubricity_wonderbread_vulcan_uranus,694774,5,9,642,651,0
5_753624,overcome_hangover_lubricity_onion_uranus_saturn,753624,5,9,820,829,0
5_3246324,overcome_prostatitis_aesthetics_wonderbread_vulcan_uranus,3246324,5,9,469,478,0
5_1774474,overcome_laceration_stimulation_ham_saturn_earth,1774474,5,9,646,655,0
5_243724,overcome_laceration_stimulation_cantelope_saturn_earth,243724,5,9,657,666,0
5_5635924,overcome_laceration_aesthetics_bacon_saturn_earth,5635924,5,9,1388,1397,0
5_3191625,succumb_angina_stimulation_flounder_uranus_saturn,3191625,5,7,616,623,0
5_2543575,succumb_laceration_stimulation_cantelope_uranus_saturn,2543575,5,7,644,651,0
5_1356325,succumb_abrasion_love_ham_vulcan_uranus,1356325,5,7,841,848,0
5_7411475,succumb_jealousy_stimulation_lobster_vulcan_uranus,7411475,5,7,1194,1201,0
5_4344025,succumb_loneliness_love_tofu_vulcan_uranus,4344025,5,7,750,757,0
5_4230225,succumb_grief_lubricity_wonderbread_uranus_saturn,4230225,5,7,832,839,0
5_1437825,feast_entertainment_ham_lemon_manitoba_pennsylvania,1437825,5,7,837,844,0
5_2015325,feast_lubricity_ham_flounder_manitoba_pennsylvania,2015325,5,7,555,562,0
5_7172225,overcome_abrasion_stimulation_cantelope_vulcan_uranus,7172225,5,9,668,677,0
5_3720425,overcome_abrasion_aesthetics_lamb_vulcan_uranus,3720425,5,9,1025,1034,0
5_7981125,overcome_abrasion_aesthetics_wonderbread_uranus_saturn,7981125,5,9,514,523,0
5_3349875,overcome_abrasion_lubricity_haroset_uranus_saturn,3349875,5,9,634,643,0
5_1074175,overcome_prostatitis_aesthetics_wonderbread_saturn_earth,1074175,5,9,469,478,0
5_1791275,overcome_laceration_stimulation_lemon_vulcan_uranus,1791275,5,9,641,650,0
5_3724375,overcome_grief_stimulation_ham_vulcan_uranus,3724375,5,9,1286,1295,0
5_4100075,overcome_grief_lubricity_haroset_vulcan_uranus,4100075,5,9,811,820,0
6_696593,food_lobster,696593,6,1,0,1,0
6_6444638,eats_beef_lamb,6444638,6,1,0,1,0
5_6451376,noop_craves_boils_tofu,6451376,5,1,624,625,0
5_5617476,noop_craves_abrasion_haroset,5617476,5,1,179,180,0
5_1966426,succumb_sciatica_lubricity_haroset_uranus_saturn,1966426,5,7,725,732,0
5_2235676,succumb_jealousy_love_cantelope_vulcan_uranus,2235676,5,7,806,813,0
6_929998,craves_jealousy_cantelope,929998,6,1,86,87,0
5_3627876,succumb_angina_love_cantelope_vulcan_uranus,3627876,5,7,763,770,0
6_4939384,craves_angina_cantelope,4939384,6,1,81,82,0
5_4463076,overcome_boils_lubricity_cantelope_vulcan_uranus,4463076,5,9,604,613,0
5_7471426,overcome_sciatica_stimulation_flounder_saturn_earth,7471426,5,9,1362,1371,0
5_2174026,overcome_abrasion_lubricity_tofu_vulcan_uranus,2174026,5,9,687,696,0
5_5974976,overcome_depression_expectation_snickers_saturn_earth,5974976,5,9,182,191,0
5_2911426,overcome_laceration_aesthetics_bacon_vulcan_uranus,2911426,5,9,1388,1397,0
5_7281626,overcome_laceration_aesthetics_flounder_vulcan_uranus,7281626,5,9,1308,1317,0
5_2664876,overcome_laceration_lubricity_cantelope_vulcan_uranus,2664876,5,9,1101,1110,0
6_7283739,eats_tofu_marzipan,7283739,6,1,0,1,0
6_5583426,food_bacon,5583426,6,1,0,1,0
6_6905224,attacks_oregon_goias,6905224,6,1,0,1,0
6_4569802,eats_haroset_lamb,4569802,6,1,0,1,0
5_1957177,succumb_sciatica_expectation_wonderbread_saturn_earth,1957177,5,7,460,467,0
5_5909977,succumb_depression_lubricity_wonderbread_uranus_saturn,5909977,5,7,648,655,0
5_1518477,succumb_abrasion_stimulation_ham_uranus_saturn,1518477,5,7,669,676,0
5_1380377,succumb_sciatica_stimulation_haroset_uranus_saturn,1380377,5,7,739,746,0
5_2203277,succumb_abrasion_lubricity_marzipan_vulcan_uranus,2203277,5,7,677,684,0
5_3823077,succumb_laceration_lubricity_lemon_uranus_saturn,3823077,5,7,670,677,0
5_4444027,succumb_anxiety_expectation_onion_saturn_earth,4444027,5,7,253,260,0
5_4308527,succumb_loneliness_stimulation_marzipan_saturn_earth,4308527,5,7,597,604,0
5_4586827,succumb_boils_stimulation_marzipan_vulcan_uranus,4586827,5,7,694,701,0
5_3626727,feast_aesthetics_ham_flounder_manitoba_pennsylvania,3626727,5,7,1000,1007,0
5_22677,overcome_abrasion_stimulation_haroset_uranus_saturn,22677,5,9,652,661,0
5_2179277,overcome_hangover_expectation_wonderbread_saturn_earth,2179277,5,9,172,181,0
5_5607927,overcome_anger_entertainment_ham_vulcan_uranus,5607927,5,9,872,881,0
5_341377,overcome_jealousy_lubricity_marzipan_uranus_saturn,341377,5,9,1204,1213,0
5_6658127,overcome_laceration_stimulation_lobster_uranus_saturn,6658127,5,9,1189,1198,0
6_1366298,attacks_goias_bosnia,1366298,6,1,0,1,0
6_918250,pain_boils,918250,6,1,0,1,0
5_5986378,succumb_laceration_love_wonderbread_vulcan_uranus,5986378,5,7,843,850,0
5_281178,succumb_laceration_entertainment_lobster_vulcan_uranus,281178,5,7,596,603,0
5_3418878,succumb_angina_entertainment_flounder_vulcan_uranus,3418878,5,7,880,887,0
5_5809078,succumb_jealousy_stimulation_marzipan_saturn_earth,5809078,5,7,703,710,0
5_6784428,feast_lubricity_bacon_wonderbread_bavaria_manitoba,6784428,5,6,1341,1347,0
4_4108876,craves_lubricity_bacon,4108876,4,0,4,4,0
5_5973928,overcome_boils_lubricity_beef_vulcan_uranus,5973928,5,9,602,611,0
5_996828,overcome_prostatitis_expectation_wonderbread_uranus_saturn,996828,5,9,233,242,0
5_7830278,overcome_prostatitis_entertainment_wonderbread_vulcan_uranus,7830278,5,9,624,633,0
5_1995178,overcome_dread_expectation_wonderbread_saturn_earth,1995178,5,9,153,162,0
5_7894728,overcome_loneliness_lubricity_tofu_vulcan_uranus,7894728,5,9,576,585,0
6_2046441,eats_lemon_ham,2046441,6,1,0,1,0
5_1872629,noop_craves_lubricity_bacon,1872629,5,1,1261,1262,0
6_778475,pain_hangover,778475,6,1,0,1,0
6_1840068,food_wonderbread,1840068,6,1,0,1,0
5_5107579,succumb_angina_stimulation_ham_uranus_saturn,5107579,5,7,616,623,0
5_2310529,succumb_grief_aesthetics_wonderbread_uranus_saturn,2310529,5,7,478,485,0
5_7415579,succumb_boils_lubricity_lamb_vulcan_uranus,7415579,5,7,599,606,0
5_5317529,succumb_laceration_aesthetics_lobster_uranus_saturn,5317529,5,7,708,715,0
5_826679,overcome_boils_stimulation_wonderbread_saturn_earth,826679,5,9,1074,1083,0
5_360279,overcome_boils_lubricity_marzipan_uranus_saturn,360279,5,9,616,625,0
5_3807329,overcome_depression_learning_wonderbread_saturn_earth,3807329,5,9,193,202,0
5_7416929,overcome_prostatitis_aesthetics_wonderbread_uranus_saturn,7416929,5,9,469,478,0
5_6743779,overcome_jealousy_stimulation_bacon_saturn_earth,6743779,5,9,1319,1328,0
5_5498579,overcome_jealousy_aesthetics_ham_uranus_saturn,5498579,5,9,1058,1067,0
6_522536,locale_cantelope_bavaria,522536,6,1,0,1,0
5_1572380,noop_craves_angina_haroset,1572380,5,1,574,575,0
6_4138703,eats_wonderbread_marzipan,4138703,6,1,0,1,0
6_2200903,pleasure_love,2200903,6,1,0,1,0
5_374230,succumb_jealousy_aesthetics_flounder_uranus_saturn,374230,5,7,980,987,0
5_1382230,succumb_anger_stimulation_flounder_vulcan_uranus,1382230,5,7,620,627,0
5_6427130,succumb_boils_aesthetics_flounder_uranus_saturn,6427130,5,7,1181,1188,0
5_4732330,succumb_sciatica_love_haroset_vulcan_uranus,4732330,5,7,676,683,0
5_6615430,succumb_loneliness_lubricity_marzipan_saturn_earth,6615430,5,7,583,590,0
5_1407780,succumb_laceration_lubricity_marzipan_saturn_earth,1407780,5,7,692,699,0
5_1342480,overcome_sciatica_stimulation_wonderbread_vulcan_uranus,1342480,5,9,736,745,0
5_2452880,overcome_anxiety_learning_onion_saturn_earth,2452880,5,9,142,151,0
5_6360130,overcome_abrasion_aesthetics_marzipan_saturn_earth,6360130,5,9,1118,1127,0
5_3951730,overcome_abrasion_aesthetics_wonderbread_saturn_earth,3951730,5,9,514,523,0
5_5496330,overcome_abrasion_lubricity_haroset_saturn_earth,5496330,5,9,618,627,0
5_5961880,overcome_laceration_stimulation_lemon_uranus_saturn,5961880,5,9,641,650,0
5_7894980,overcome_grief_stimulation_ham_uranus_saturn,7894980,5,9,1282,1291,0
6_6588915,locale_wonderbread_bavaria,6588915,6,1,0,1,0
6_6425404,eats_marzipan_wonderbread,6425404,6,1,0,1,0
6_3412554,food_marzipan,3412554,6,1,0,1,0
6_2289801,eats_haroset_lobster,2289801,6,1,0,1,0
5_2216181,succumb_angina_lubricity_lamb_saturn_earth,2216181,5,7,577,584,0
5_3464631,succumb_angina_lubricity_haroset_uranus_saturn,3464631,5,7,576,583,0
5_1802581,succumb_angina_stimulation_lemon_vulcan_uranus,1802581,5,7,616,623,0
5_5597281,succumb_boils_entertainment_marzipan_vulcan_uranus,5597281,5,7,1004,1011,0
5_1751631,succumb_grief_stimulation_flounder_saturn_earth,1751631,5,7,821,828,0
5_2327531,succumb_abrasion_lubricity_flounder_vulcan_uranus,2327531,5,7,661,668,0
5_6118731,succumb_prostatitis_love_tofu_vulcan_uranus,6118731,5,7,819,826,0
5_516981,succumb_prostatitis_stimulation_wonderbread_uranus_saturn,516981,5,7,634,641,0
5_4711081,succumb_boils_stimulation_flounder_vulcan_uranus,4711081,5,7,683,690,0
5_2507781,overcome_abrasion_lubricity_ham_saturn_earth,2507781,5,9,1081,1090,0
5_6344631,overcome_abrasion_lubricity_tofu_uranus_saturn,6344631,5,9,680,689,0
5_7050231,overcome_prostatitis_love_tofu_vulcan_uranus,7050231,5,9,819,828,0
5_2733331,overcome_prostatitis_learning_wonderbread_uranus_saturn,2733331,5,9,257,266,0
5_4909931,overcome_prostatitis_lubricity_wonderbread_saturn_earth,4909931,5,9,611,620,0
5_3214131,overcome_jealousy_learning_wonderbread_vulcan_uranus,3214131,5,9,923,932,0
6_467550,fears_jealousy_learning,467550,6,3,0,3,0
5_7082031,overcome_laceration_aesthetics_bacon_uranus_saturn,7082031,5,9,1388,1397,0
5_6835481,overcome_laceration_lubricity_cantelope_uranus_saturn,6835481,5,9,1097,1106,0
5_2452981,overcome_grief_stimulation_beef_uranus_saturn,2452981,5,9,1282,1291,0
6_677729,eats_tofu_onion,677729,6,1,0,1,0
5_3135932,succumb_grief_aesthetics_ham_saturn_earth,3135932,5,7,986,993,0
5_7489832,succumb_sciatica_lubricity_wonderbread_uranus_saturn,7489832,5,7,748,755,0
5_118932,succumb_laceration_stimulation_ham_uranus_saturn,118932,5,7,645,652,0
5_5384132,succumb_laceration_aesthetics_haroset_vulcan_uranus,5384132,5,7,755,762,0
5_7136732,succumb_abrasion_stimulation_lemon_vulcan_uranus,7136732,5,7,665,672,0
5_5242032,succumb_loneliness_lubricity_tofu_uranus_saturn,5242032,5,7,583,590,0
5_2012132,succumb_jealousy_stimulation_lemon_uranus_saturn,2012132,5,7,688,695,0
5_1973982,feast_aesthetics_marzipan_cantelope_manitoba_pennsylvania,1973982,5,7,1022,1029,0
5_5408782,overcome_boils_entertainment_wonderbread_vulcan_uranus,5408782,5,9,1046,1055,0
5_6481182,overcome_abrasion_learning_wonderbread_vulcan_uranus,6481182,5,9,311,320,0
5_6060432,overcome_angina_love_haroset_vulcan_uranus,6060432,5,9,805,814,0
5_6929782,overcome_laceration_stimulation_wonderbread_saturn_earth,6929782,5,9,644,653,0
5_3957732,overcome_loneliness_entertainment_tofu_vulcan_uranus,3957732,5,9,910,919,0
6_7363867,fears_loneliness_entertainment,7363867,6,1,105,106,0
5_7636682,overcome_grief_expectation_wonderbread_saturn_earth,7636682,5,9,603,612,0
6_7318845,eats_snickers_okra,7318845,6,1,0,1,0
6_7865332,pain_dread,7865332,6,1,0,1,0
6_473381,eats_ham_flounder,473381,6,1,0,1,0
6_6322230,eats_wonderbread_bacon,6322230,6,1,0,1,0
6_3151412,food_lamb,3151412,6,1,0,1,0
6_2268262,food_tofu,2268262,6,1,0,1,0
5_2286783,succumb_laceration_love_flounder_vulcan_uranus,2286783,5,7,843,850,0
5_4225933,succumb_abrasion_love_wonderbread_vulcan_uranus,4225933,5,7,841,848,0
5_3987733,succumb_abrasion_lubricity_lamb_vulcan_uranus,3987733,5,7,660,667,0
5_3232333,succumb_anger_lubricity_lemon_vulcan_uranus,3232333,5,7,600,607,0
5_3309433,succumb_loneliness_stimulation_marzipan_uranus_saturn,3309433,5,7,597,604,0
5_4976383,succumb_angina_love_beef_vulcan_uranus,4976383,5,7,763,770,0
6_4812851,craves_angina_beef,4812851,6,1,70,71,0
5_5782733,feast_aesthetics_marzipan_tofu_bavaria_manitoba,5782733,5,7,1022,1029,0
5_484533,overcome_boils_lubricity_flounder_uranus_saturn,484533,5,9,600,609,0
5_949983,overcome_sciatica_stimulation_bacon_vulcan_uranus,949983,5,9,1300,1309,0
5_2305583,overcome_angina_stimulation_haroset_uranus_saturn,2305583,5,9,1051,1060,0
5_2376983,overcome_anger_stimulation_lemon_uranus_saturn,2376983,5,9,1164,1173,0
5_4163833,overcome_anger_lubricity_lemon_vulcan_uranus,4163833,5,9,1169,1178,0
5_527883,overcome_jealousy_stimulation_marzipan_vulcan_uranus,527883,5,9,1186,1195,0
5_5786083,overcome_laceration_lubricity_ham_vulcan_uranus,5786083,5,9,1079,1088,0
5_3814684,noop_fears_angina_aesthetics,3814684,5,1,983,984,0
5_4019584,noop_craves_aesthetics_lemon,4019584,5,1,975,976,0
5_2205884,noop_craves_jealousy_marzipan,2205884,5,1,798,799,0
5_1145084,noop_fears_abrasion_aesthetics,1145084,5,0,1055,1055,0
4_2767507,fears_abrasion_aesthetics,2767507,4,0,3,3,0
5_2821384,noop_fears_anxiety_stimulation,2821384,5,1,622,623,0
5_116634,noop_harmony_expectation_earth,116634,5,1,93,94,0
5_3570034,noop_craves_abrasion_cantelope,3570034,5,1,179,180,0
5_5557734,noop_craves_abrasion_tofu,5557734,5,1,216,217,0
5_6725084,noop_craves_sciatica_lamb,6725084,5,1,962,963,0
5_3163384,succumb_sciatica_aesthetics_beef_saturn_earth,3163384,5,7,983,990,0
6_2087561,craves_sciatica_beef,2087561,6,1,116,117,0
5_3750134,succumb_abrasion_stimulation_lobster_uranus_saturn,3750134,5,7,1216,1223,0
5_1263184,succumb_laceration_lubricity_lamb_vulcan_uranus,1263184,5,7,689,696,0
5_389934,succumb_jealousy_lubricity_beef_saturn_earth,389934,5,7,676,683,0
5_2026834,succumb_jealousy_lubricity_lobster_saturn_earth,2026834,5,7,1224,1231,0
5_4101934,overcome_boils_love_haroset_vulcan_uranus,4101934,5,9,818,827,0
5_1233734,overcome_sciatica_stimulation_lamb_saturn_earth,1233734,5,9,1359,1368,0
5_813984,overcome_anxiety_expectation_onion_saturn_earth,813984,5,9,200,209,0
5_1863234,overcome_depression_learning_okra_saturn_earth,1863234,5,9,194,203,0
5_7828234,overcome_depression_learning_onion_saturn_earth,7828234,5,9,193,202,0
5_2481084,overcome_prostatitis_achievement_wonderbread_uranus_saturn,2481084,5,9,163,172,0
5_2204084,overcome_jealousy_expectation_wonderbread_uranus_saturn,2204084,5,9,901,910,0
5_3236184,overcome_laceration_love_wonderbread_vulcan_uranus,3236184,5,9,1165,1174,0
5_5541634,overcome_laceration_learning_wonderbread_vulcan_uranus,5541634,5,9,759,768,0
5_5111784,overcome_laceration_aesthetics_wonderbread_vulcan_uranus,5111784,5,9,934,943,0
5_4927284,overcome_grief_lubricity_bacon_saturn_earth,4927284,5,9,1306,1315,0
5_2216785,noop_locale_lamb_bavaria,2216785,5,0,540,540,0
4_71424,locale_lamb_bavaria,71424,4,0,0,0,0
6_6088560,attacks_pennsylvania_oregon,6088560,6,1,0,1,0
5_1035485,noop_locale_marzipan_bavaria,1035485,5,0,80,80,0
4_5445350,locale_marzipan_bavaria,5445350,4,0,0,0,0
5_4955135,succumb_laceration_stimulation_tofu_uranus_saturn,4955135,5,7,674,681,0
5_3062285,succumb_prostatitis_lubricity_marzipan_vulcan_uranus,3062285,5,7,624,631,0
5_5721535,succumb_boils_entertainment_flounder_vulcan_uranus,5721535,5,7,952,959,0
5_3291035,succumb_grief_stimulation_lobster_vulcan_uranus,3291035,5,7,1216,1223,0
5_474885,succumb_depression_stimulation_wonderbread_uranus_saturn,474885,5,7,632,639,0
5_5209785,succumb_sciatica_stimulation_wonderbread_uranus_saturn,5209785,5,7,736,743,0
5_5833835,overcome_sciatica_expectation_wonderbread_saturn_earth,5833835,5,9,324,333,0
5_2168285,overcome_sciatica_learning_wonderbread_saturn_earth,2168285,5,9,348,357,0
5_5327485,overcome_sciatica_lubricity_lamb_saturn_earth,5327485,5,9,1363,1372,0
5_7813735,overcome_hangover_love_onion_vulcan_uranus,7813735,5,9,997,1006,0
5_159485,overcome_anger_aesthetics_flounder_vulcan_uranus,159485,5,9,949,958,0
5_4909835,overcome_grief_lubricity_ham_vulcan_uranus,4909835,5,9,1292,1301,0
6_1742084,eats_haroset_flounder,1742084,6,1,0,1,0
6_2922283,pleasure_stimulation,2922283,6,1,0,1,0
5_4396286,noop_craves_jealousy_lemon,4396286,5,1,795,796,0
6_4985459,pain_sciatica,4985459,6,1,0,1,0
5_2748986,succumb_jealousy_aesthetics_lamb_uranus_saturn,2748986,5,7,981,988,0
5_5973186,succumb_angina_stimulation_lemon_uranus_saturn,5973186,5,7,616,623,0
5_2964786,succumb_dread_achievement_wonderbread_saturn_earth,2964786,5,7,82,89,0
5_7035436,succumb_laceration_stimulation_lobster_vulcan_uranus,7035436,5,7,1188,1195,0
5_4764836,succumb_grief_entertainment_marzipan_vulcan_uranus,4764836,5,7,900,907,0
6_2423393,craves_grief_marzipan,2423393,6,1,103,104,0
5_6018236,succumb_boils_aesthetics_lamb_saturn_earth,6018236,5,7,1182,1189,0
5_5569536,succumb_grief_stimulation_lamb_saturn_earth,5569536,5,7,809,816,0
5_1992186,succumb_loneliness_lubricity_onion_saturn_earth,1992186,5,7,608,615,0
5_374636,succumb_abrasion_entertainment_lamb_vulcan_uranus,374636,5,7,957,964,0
5_4674786,succumb_abrasion_lubricity_wonderbread_uranus_saturn,4674786,5,7,683,690,0
5_6498136,succumb_abrasion_lubricity_flounder_uranus_saturn,6498136,5,7,653,660,0
5_792836,succumb_anger_lubricity_lemon_saturn_earth,792836,5,7,592,599,0
5_4043486,succumb_jealousy_entertainment_lemon_vulcan_uranus,4043486,5,7,946,953,0
5_6042036,succumb_boils_stimulation_cantelope_uranus_saturn,6042036,5,7,682,689,0
5_4862586,feast_aesthetics_ham_lemon_manitoba_pennsylvania,4862586,5,7,1000,1007,0
5_1867886,feast_lubricity_ham_lemon_manitoba_pennsylvania,1867886,5,7,555,562,0
5_5811286,overcome_boils_entertainment_cantelope_vulcan_uranus,5811286,5,9,992,1001,0
5_3179286,overcome_boils_aesthetics_wonderbread_uranus_saturn,3179286,5,9,926,935,0
5_5847386,overcome_abrasion_stimulation_tofu_vulcan_uranus,5847386,5,9,698,707,0
5_368386,overcome_abrasion_aesthetics_haroset_uranus_saturn,368386,5,9,745,754,0
5_3903686,overcome_prostatitis_lubricity_cantelope_saturn_earth,3903686,5,9,611,620,0
5_7384736,overcome_jealousy_learning_wonderbread_uranus_saturn,7384736,5,9,924,933,0
5_2855386,overcome_laceration_stimulation_marzipan_vulcan_uranus,2855386,5,9,655,664,0
5_3482186,overcome_laceration_entertainment_wonderbread_vulcan_uranus,3482186,5,9,1046,1055,0
5_6174686,overcome_laceration_aesthetics_lemon_saturn_earth,6174686,5,9,1100,1109,0
6_6440549,pleasure_lubricity,6440549,6,1,0,1,0
6_3810436,food_onion,3810436,6,1,0,1,0
5_7314587,noop_fears_grief_achievement,7314587,5,1,715,716,0
6_2278622,eats_okra_snickers,2278622,6,1,0,1,0
5_3121437,noop_craves_aesthetics_marzipan,3121437,5,1,987,988,0
6_5075412,craves_achievement_wonderbread,5075412,6,1,0,1,0
5_221137,succumb_boils_stimulation_lamb_uranus_saturn,221137,5,7,672,679,0
5_122487,overcome_boils_expectation_wonderbread_vulcan_uranus,122487,5,9,727,736,0
5_1420337,overcome_abrasion_stimulation_haroset_saturn_earth,1420337,5,9,652,661,0
5_4921137,overcome_hangover_learning_okra_saturn_earth,4921137,5,9,194,203,0
5_7850787,overcome_anger_love_lemon_vulcan_uranus,7850787,5,9,763,772,0
5_1994837,overcome_grief_aesthetics_flounder_saturn_earth,1994837,5,9,956,965,0
5_5723987,overcome_grief_lubricity_beef_vulcan_uranus,5723987,5,9,1291,1300,0
6_511036,eats_wonderbread_okra,511036,6,1,0,1,0
6_2289523,eats_beef_marzipan,2289523,6,1,0,1,0
5_715788,noop_craves_prostatitis_beef,715788,5,1,124,125,0
5_7564688,succumb_angina_lubricity_lamb_vulcan_uranus,7564688,5,7,584,591,0
5_3314788,succumb_laceration_love_ham_vulcan_uranus,3314788,5,7,843,850,0
5_7402938,succumb_anger_lubricity_lemon_uranus_saturn,7402938,5,7,592,599,0
5_538938,succumb_anger_lubricity_haroset_uranus_saturn,538938,5,7,589,596,0
5_1561788,succumb_grief_lubricity_wonderbread_saturn_earth,1561788,5,7,832,839,0
5_7165638,succumb_grief_lubricity_lamb_vulcan_uranus,7165638,5,7,812,819,0
5_6172488,succumb_jealousy_lubricity_lamb_vulcan_uranus,6172488,5,7,689,696,0
5_1839538,feast_lubricity_bacon_lobster_bavaria_manitoba,1839538,5,7,1341,1348,0
5_281288,overcome_sciatica_lubricity_lobster_uranus_saturn,281288,5,9,1241,1250,0
5_7381388,overcome_abrasion_love_cantelope_vulcan_uranus,7381388,5,9,841,850,0
5_459688,overcome_anger_stimulation_ham_vulcan_uranus,459688,5,9,648,657,0
5_247238,overcome_anger_aesthetics_ham_saturn_earth,247238,5,9,1033,1042,0
5_3682838,overcome_prostatitis_lubricity_cantelope_uranus_saturn,3682838,5,9,611,620,0
5_6288488,overcome_dread_lubricity_wonderbread_vulcan_uranus,6288488,5,9,598,607,0
5_4698488,overcome_jealousy_stimulation_marzipan_uranus_saturn,4698488,5,9,1186,1195,0
5_6943288,overcome_laceration_lubricity_tofu_vulcan_uranus,6943288,5,9,1112,1121,0
6_1486223,pain_angina,1486223,6,1,0,1,0
6_6188452,food_ham,6188452,6,1,0,1,0
6_137551,eats_ham_lemon,137551,6,1,0,1,0
5_3712289,succumb_jealousy_aesthetics_bacon_saturn_earth,3712289,5,7,629,636,0
5_1705289,succumb_laceration_stimulation_onion_saturn_earth,1705289,5,7,698,705,0
6_4177385,craves_laceration_onion,4177385,6,1,56,57,0
5_7903989,succumb_prostatitis_lubricity_lemon_vulcan_uranus,7903989,5,7,624,631,0
5_1889239,succumb_prostatitis_lubricity_lamb_vulcan_uranus,1889239,5,7,622,629,0
5_6100689,succumb_laceration_entertainment_marzipan_vulcan_uranus,6100689,5,7,1003,1010,0
5_2500039,succumb_abrasion_stimulation_marzipan_vulcan_uranus,2500039,5,7,680,687,0
5_119989,succumb_hangover_learning_onion_saturn_earth,119989,5,7,188,195,0
5_1157339,succumb_grief_lubricity_lobster_saturn_earth,1157339,5,7,1232,1239,0
5_5269989,overcome_abrasion_expectation_wonderbread_saturn_earth,5269989,5,9,289,298,0
5_5006189,overcome_abrasion_stimulation_ham_saturn_earth,5006189,5,9,671,680,0
5_6947189,overcome_depression_stimulation_wonderbread_vulcan_uranus,6947189,5,9,642,651,0
5_1079689,overcome_prostatitis_lubricity_wonderbread_vulcan_uranus,1079689,5,9,630,639,0
5_2657739,overcome_jealousy_stimulation_bacon_uranus_saturn,2657739,5,9,1319,1328,0
5_5304889,overcome_grief_aesthetics_wonderbread_saturn_earth,5304889,5,9,627,636,0
6_895075,eats_marzipan_tofu,895075,6,1,0,1,0
6_3659869,food_beef,3659869,6,1,0,1,0
5_3363440,noop_craves_grief_beef,3363440,5,1,875,876,0
6_1930663,food_flounder,1930663,6,1,0,1,0
6_6634256,eats_onion_snickers,6634256,6,1,0,1,0
5_6521440,succumb_jealousy_aesthetics_bacon_vulcan_uranus,6521440,5,7,629,636,0
5_2590390,succumb_abrasion_aesthetics_lamb_saturn_earth,2590390,5,7,1102,1109,0
5_7627690,succumb_laceration_stimulation_wonderbread_uranus_saturn,7627690,5,7,639,646,0
5_3194690,succumb_abrasion_stimulation_tofu_uranus_saturn,3194690,5,7,698,705,0
5_459240,succumb_jealousy_stimulation_lemon_saturn_earth,459240,5,7,688,695,0
5_2840040,feast_aesthetics_marzipan_beef_pennsylvania_oregon,2840040,5,7,1158,1165,0
5_130440,overcome_sciatica_lubricity_lamb_uranus_saturn,130440,5,9,1363,1372,0
5_6772290,overcome_sciatica_lubricity_wonderbread_vulcan_uranus,6772290,5,9,747,756,0
5_5243790,overcome_abrasion_expectation_wonderbread_vulcan_uranus,5243790,5,9,287,296,0
5_1015490,overcome_abrasion_stimulation_wonderbread_vulcan_uranus,1015490,5,9,663,672,0
5_589340,overcome_abrasion_aesthetics_ham_saturn_earth,589340,5,9,1435,1444,0
5_3688340,overcome_jealousy_achievement_wonderbread_uranus_saturn,3688340,5,9,832,841,0
5_5845390,overcome_jealousy_stimulation_marzipan_saturn_earth,5845390,5,9,1187,1196,0
5_4034040,overcome_jealousy_aesthetics_beef_saturn_earth,4034040,5,9,1060,1069,0
5_2326340,overcome_laceration_expectation_wonderbread_vulcan_uranus,2326340,5,9,737,746,0
5_3666641,succumb_jealousy_aesthetics_haroset_vulcan_uranus,3666641,5,7,744,751,0
5_7193141,succumb_boils_lubricity_onion_saturn_earth,7193141,5,7,657,664,0
6_6580064,craves_boils_onion,6580064,6,1,60,61,0
5_5947641,succumb_boils_aesthetics_beef_saturn_earth,5947641,5,7,1187,1194,0
5_973541,succumb_sciatica_stimulation_lobster_vulcan_uranus,973541,5,7,1220,1227,0
5_7015141,succumb_abrasion_lubricity_tofu_uranus_saturn,7015141,5,7,687,694,0
5_1703691,succumb_anger_lubricity_ham_vulcan_uranus,1703691,5,7,601,608,0
5_5308791,feast_aesthetics_marzipan_tofu_pennsylvania_oregon,5308791,5,7,1158,1165,0
5_347891,overcome_sciatica_lubricity_haroset_vulcan_uranus,347891,5,9,1043,1052,0
5_3556041,overcome_depression_learning_snickers_saturn_earth,3556041,5,9,170,179,0
5_7372641,overcome_angina_stimulation_ham_vulcan_uranus,7372641,5,9,616,625,0
5_2843491,overcome_hangover_expectation_okra_saturn_earth,2843491,5,9,170,179,0
5_1889941,overcome_hangover_stimulation_wonderbread_vulcan_uranus,1889941,5,9,632,641,0
5_2616341,overcome_prostatitis_entertainment_beef_vulcan_uranus,2616341,5,9,917,926,0
5_4227391,overcome_prostatitis_lubricity_beef_saturn_earth,4227391,5,9,600,609,0
5_7282541,overcome_jealousy_stimulation_lemon_saturn_earth,7282541,5,9,1191,1200,0
5_4897941,overcome_jealousy_entertainment_wonderbread_vulcan_uranus,4897941,5,9,887,896,0
5_4651841,overcome_jealousy_lubricity_lemon_vulcan_uranus,4651841,5,9,1205,1214,0
5_4311441,overcome_laceration_stimulation_bacon_saturn_earth,4311441,5,9,1322,1331,0
5_7025991,overcome_laceration_stimulation_marzipan_uranus_saturn,7025991,5,9,655,664,0
5_6962491,overcome_laceration_entertainment_tofu_vulcan_uranus,6962491,5,9,1325,1334,0
5_3271791,overcome_grief_learning_wonderbread_saturn_earth,3271791,5,9,627,636,0
5_6430441,overcome_grief_stimulation_beef_saturn_earth,6430441,5,9,1282,1291,0
5_3077091,overcome_grief_aesthetics_flounder_uranus_saturn,3077091,5,9,956,965,0
5_2346841,overcome_grief_aesthetics_wonderbread_uranus_saturn,2346841,5,9,627,636,0
6_1180739,pain_laceration,1180739,6,1,0,1,0
5_4951942,succumb_angina_lubricity_flounder_vulcan_uranus,4951942,5,7,584,591,0
5_6852542,succumb_abrasion_lubricity_flounder_saturn_earth,6852542,5,7,653,660,0
5_331992,feast_aesthetics_marzipan_wonderbread_bavaria_manitoba,331992,5,7,1022,1029,0
5_4003392,feast_aesthetics_marzipan_cantelope_pennsylvania_oregon,4003392,5,7,1158,1165,0
5_4293092,overcome_boils_expectation_wonderbread_uranus_saturn,4293092,5,9,728,737,0
5_64792,overcome_boils_stimulation_wonderbread_uranus_saturn,64792,5,9,1086,1095,0
5_605242,overcome_jealousy_learning_wonderbread_saturn_earth,605242,5,9,925,934,0
5_272742,overcome_jealousy_entertainment_beef_vulcan_uranus,272742,5,9,899,908,0
5_410542,overcome_jealousy_aesthetics_flounder_uranus_saturn,410542,5,9,972,981,0
5_1678892,overcome_laceration_stimulation_tofu_saturn_earth,1678892,5,9,675,684,0
5_7993392,overcome_loneliness_stimulation_tofu_vulcan_uranus,7993392,5,9,597,606,0
5_1482342,overcome_grief_stimulation_ham_saturn_earth,1482342,5,9,1273,1282,0
6_3590140,orbits_uranus_saturn,3590140,6,1,0,1,0
6_1484863,eats_lobster_haroset,1484863,6,1,0,1,0
6_1370260,pain_anxiety,1370260,6,1,0,1,0
5_3698793,succumb_anger_stimulation_ham_uranus_saturn,3698793,5,7,621,628,0
5_3047493,succumb_anger_stimulation_lemon_uranus_saturn,3047493,5,7,621,628,0
5_6224943,succumb_laceration_entertainment_flounder_vulcan_uranus,6224943,5,7,947,954,0
5_2624293,succumb_abrasion_stimulation_flounder_vulcan_uranus,2624293,5,7,668,675,0
5_3403593,succumb_jealousy_stimulation_marzipan_uranus_saturn,3403593,5,7,703,710,0
5_3121143,succumb_anger_lubricity_lamb_vulcan_uranus,3121143,5,7,598,605,0
5_1847143,feast_aesthetics_marzipan_beef_manitoba_pennsylvania,1847143,5,7,1022,1029,0
5_1606743,overcome_boils_achievement_wonderbread_vulcan_uranus,1606743,5,9,659,668,0
6_3294198,fears_boils_achievement,3294198,6,2,51,53,0
5_5932793,overcome_boils_lubricity_tofu_saturn_earth,5932793,5,9,634,643,0
5_4088543,overcome_sciatica_stimulation_lamb_vulcan_uranus,4088543,5,9,1359,1368,0
5_1093743,overcome_sciatica_lubricity_bacon_saturn_earth,1093743,5,9,1320,1329,0
5_4705793,overcome_prostatitis_expectation_wonderbread_saturn_earth,4705793,5,9,234,243,0
5_1265793,overcome_prostatitis_stimulation_cantelope_saturn_earth,1265793,5,9,633,642,0
5_2370943,overcome_prostatitis_lubricity_beef_vulcan_uranus,2370943,5,9,616,625,0
6_3456443,pain_grief,3456443,6,1,0,1,0
6_5631791,pain_loneliness,5631791,6,1,0,1,0
5_7820694,succumb_boils_lubricity_marzipan_vulcan_uranus,7820694,5,7,616,623,0
5_6059844,succumb_prostatitis_lubricity_lamb_uranus_saturn,6059844,5,7,615,622,0
5_5622744,succumb_grief_love_flounder_vulcan_uranus,5622744,5,7,800,807,0
5_6570044,succumb_depression_achievement_wonderbread_saturn_earth,6570044,5,7,141,148,0
5_856444,succumb_anger_aesthetics_haroset_uranus_saturn,856444,5,7,958,965,0
5_3923994,succumb_boils_stimulation_flounder_saturn_earth,3923994,5,7,674,681,0
5_3957244,overcome_abrasion_lubricity_wonderbread_vulcan_uranus,3957244,5,9,683,692,0
5_997694,overcome_hangover_stimulation_onion_uranus_saturn,997694,5,9,834,843,0
5_5250294,overcome_prostatitis_lubricity_wonderbread_uranus_saturn,5250294,5,9,623,632,0
5_3115594,overcome_laceration_lubricity_ham_saturn_earth,3115594,5,9,1073,1082,0
5_7127744,overcome_grief_entertainment_beef_vulcan_uranus,7127744,5,9,893,902,0
5_5725994,overcome_grief_aesthetics_lamb_vulcan_uranus,5725994,5,9,953,962,0
6_6616492,eats_lemon_cantelope,6616492,6,1,0,1,0
6_4889270,eats_flounder_haroset,4889270,6,1,0,1,0
5_2519795,succumb_abrasion_aesthetics_beef_saturn_earth,2519795,5,7,1107,1114,0
5_980395,succumb_boils_aesthetics_ham_saturn_earth,980395,5,7,1187,1194,0
5_4882795,succumb_abrasion_stimulation_wonderbread_uranus_saturn,4882795,5,7,663,670,0
5_7004995,succumb_hangover_learning_onion_vulcan_uranus,7004995,5,7,188,195,0
5_3765295,succumb_abrasion_lubricity_onion_saturn_earth,3765295,5,7,717,724,0
5_65395,succumb_anger_lubricity_flounder_vulcan_uranus,65395,5,7,598,605,0
5_1176045,succumb_anger_entertainment_lemon_vulcan_uranus,1176045,5,7,919,926,0
5_5684845,succumb_jealousy_lubricity_ham_vulcan_uranus,5684845,5,7,693,700,0
5_6466845,feast_entertainment_lamb_beef_bavaria_manitoba,6466845,5,7,838,845,0
5_2304645,feast_lubricity_ham_lemon_bavaria_manitoba,2304645,5,7,1245,1252,0
5_742295,overcome_sciatica_stimulation_flounder_vulcan_uranus,742295,5,9,1366,1375,0
5_5186095,overcome_abrasion_stimulation_wonderbread_uranus_saturn,5186095,5,9,663,672,0
5_4628145,overcome_prostatitis_stimulation_tofu_saturn_earth,4628145,5,9,651,660,0
5_6496945,overcome_laceration_expectation_wonderbread_uranus_saturn,6496945,5,9,738,747,0
5_7150245,overcome_laceration_stimulation_flounder_uranus_saturn,7150245,5,9,647,656,0
5_873646,noop_fears_grief_expectation,873646,5,1,784,785,0
5_3290796,succumb_boils_lubricity_lobster_saturn_earth,3290796,5,7,1191,1198,0
6_872979,craves_boils_lobster,872979,6,1,111,112,0
5_5757246,succumb_hangover_stimulation_wonderbread_uranus_saturn,5757246,5,7,629,636,0
5_3520096,succumb_abrasion_aesthetics_lamb_uranus_saturn,3520096,5,7,1102,1109,0
5_7407546,succumb_abrasion_lubricity_lobster_saturn_earth,7407546,5,7,1234,1241,0
5_170396,overcome_boils_lubricity_wonderbread_saturn_earth,170396,5,9,634,643,0
5_991946,overcome_boils_lubricity_haroset_saturn_earth,991946,5,9,601,610,0
5_6728046,overcome_abrasion_achievement_wonderbread_vulcan_uranus,6728046,5,9,217,226,0
5_947696,overcome_jealousy_stimulation_ham_vulcan_uranus,947696,5,9,692,701,0
5_7795146,overcome_jealousy_entertainment_ham_vulcan_uranus,7795146,5,9,899,908,0
5_3810596,overcome_laceration_achievement_wonderbread_vulcan_uranus,3810596,5,9,669,678,0
6_6857847,attacks_manitoba_pennsylvania,6857847,6,1,0,1,0
5_7468697,noop_locale_ham_manitoba,7468697,5,1,1172,1173,0
6_2286682,eats_marzipan_beef,2286682,6,1,0,1,0
5_43597,noop_craves_laceration_ham,43597,5,1,629,630,0
6_7813070,pain_abrasion,7813070,6,1,0,1,0
5_7021997,succumb_angina_stimulation_flounder_vulcan_uranus,7021997,5,7,616,623,0
5_4916647,succumb_prostatitis_lubricity_tofu_uranus_saturn,4916647,5,7,634,641,0
5_1062997,succumb_abrasion_love_tofu_vulcan_uranus,1062997,5,7,862,869,0
5_7608497,succumb_laceration_aesthetics_flounder_saturn_earth,7608497,5,7,1018,1025,0
5_3667447,succumb_laceration_entertainment_lemon_vulcan_uranus,3667447,5,7,991,998,0
5_2963097,succumb_sciatica_achievement_wonderbread_saturn_earth,2963097,5,7,390,397,0
5_6287247,succumb_depression_stimulation_onion_saturn_earth,6287247,5,7,687,694,0
5_4678647,succumb_sciatica_entertainment_haroset_vulcan_uranus,4678647,5,7,588,595,0
5_7046197,succumb_jealousy_lubricity_flounder_vulcan_uranus,7046197,5,7,690,697,0
5_1088397,overcome_abrasion_entertainment_ham_vulcan_uranus,1088397,5,9,1311,1320,0
5_7180247,overcome_abrasion_lubricity_haroset_vulcan_uranus,7180247,5,9,652,661,0
5_504497,overcome_prostatitis_love_cantelope_vulcan_uranus,504497,5,9,805,814,0
5_24097,overcome_prostatitis_stimulation_beef_vulcan_uranus,24097,5,9,638,647,0
5_4480297,overcome_jealousy_love_lemon_vulcan_uranus,4480297,5,9,806,815,0
5_393597,overcome_jealousy_stimulation_lemon_vulcan_uranus,393597,5,9,1190,1199,0
5_1191847,overcome_laceration_entertainment_ham_vulcan_uranus,1191847,5,9,1281,1290,0
5_7283697,overcome_laceration_lubricity_haroset_vulcan_uranus,7283697,5,9,681,690,0
6_560444,eats_wonderbread_snickers,560444,6,1,0,1,0
6_2161368,pleasure_expectation,2161368,6,1,0,1,0
5_7944948,succumb_boils_lubricity_flounder_vulcan_uranus,7944948,5,7,600,607,0
5_6794898,succumb_abrasion_stimulation_flounder_uranus_saturn,6794898,5,7,668,675,0
5_7291748,succumb_anger_lubricity_lamb_uranus_saturn,7291748,5,7,591,598,0
5_5777348,overcome_boils_achievement_wonderbread_uranus_saturn,5777348,5,9,660,669,0
5_2754298,overcome_boils_lubricity_ham_vulcan_uranus,2754298,5,9,603,612,0
5_4842398,overcome_abrasion_lubricity_cantelope_saturn_earth,4842398,5,9,651,660,0
5_2367148,overcome_anger_stimulation_lemon_saturn_earth,2367148,5,9,1165,1174,0
5_464298,overcome_prostatitis_stimulation_cantelope_uranus_saturn,464298,5,9,639,648,0
5_6541548,overcome_prostatitis_lubricity_beef_uranus_saturn,6541548,5,9,600,609,0
6_7159023,pain_depression,7159023,6,1,0,1,0
6_7480922,planet_uranus,7480922,6,1,0,1,0
6_7835272,food_snickers,7835272,6,1,0,1,0
5_5327349,succumb_laceration_love_cantelope_vulcan_uranus,5327349,5,7,843,850,0
5_3316249,succumb_laceration_aesthetics_lobster_saturn_earth,3316249,5,7,700,707,0
5_7958899,succumb_grief_stimulation_wonderbread_saturn_earth,7958899,5,7,814,821,0
5_5210749,succumb_sciatica_stimulation_haroset_vulcan_uranus,5210749,5,7,739,746,0
5_7653449,succumb_laceration_lubricity_lemon_vulcan_uranus,7653449,5,7,678,685,0
5_7384849,succumb_anger_love_beef_vulcan_uranus,7384849,5,7,763,770,0
6_2107776,craves_anger_beef,2107776,6,1,81,82,0
5_3139599,succumb_prostatitis_stimulation_lemon_vulcan_uranus,3139599,5,7,638,645,0
5_2949699,succumb_grief_lubricity_flounder_uranus_saturn,2949699,5,7,813,820,0
5_935349,overcome_boils_aesthetics_haroset_vulcan_uranus,935349,5,9,1116,1125,0
5_1078849,overcome_boils_aesthetics_flounder_vulcan_uranus,1078849,5,9,1304,1313,0
5_3853049,overcome_abrasion_stimulation_haroset_vulcan_uranus,3853049,5,9,666,675,0
5_4171749,overcome_jealousy_lubricity_marzipan_vulcan_uranus,4171749,5,9,1209,1218,0
7_387999,craves_lubricity_lobster,387999,7,85,0,85,0
7_5529098,fears_jealousy_lubricity,5529098,7,25,0,25,0
7_929998,craves_jealousy_cantelope,929998,7,85,0,85,0
7_2806898,craves_sciatica_ham,2806898,7,116,0,116,0
7_6618897,craves_jealousy_beef,6618897,7,18,0,18,0
7_1344146,locale_snickers_manitoba,1344146,7,14,0,14,0
7_6863696,fears_jealousy_entertainment,6863696,7,40,0,40,0
7_7699444,fears_angina_love,7699444,7,41,0,41,0
7_6864294,craves_entertainment_flounder,6864294,7,74,0,74,0
7_4605843,craves_love_lobster,4605843,7,67,0,67,0
7_2423393,craves_grief_marzipan,2423393,7,102,0,102,0
7_3682892,fears_anxiety_expectation,3682892,7,28,0,28,0
7_6011242,craves_stimulation_lobster,6011242,7,92,0,92,0
7_4128492,craves_expectation_onion,4128492,7,24,0,24,0
7_6360942,craves_entertainment_onion,6360942,7,110,0,110,0
7_6141141,fears_abrasion_learning,6141141,7,30,0,30,0
7_6110440,craves_jealousy_lamb,6110440,7,18,0,18,0
7_4769340,fears_anxiety_learning,4769340,7,17,0,17,0
7_6936290,craves_aesthetics_beef,6936290,7,89,0,89,0
7_5227290,craves_jealousy_tofu,5227290,7,88,0,88,0
7_3033139,craves_entertainment_cantelope,3033139,7,88,0,88,0
7_809839,fears_anger_love,809839,7,40,0,40,0
7_3385988,craves_grief_ham,3385988,7,86,0,86,0
7_5357538,craves_entertainment_beef,5357538,7,78,0,78,0
7_2576538,craves_love_flounder,2576538,7,62,0,62,0
7_2538387,craves_entertainment_ham,2538387,7,79,0,79,0
7_4317787,craves_entertainment_lemon,4317787,7,80,0,80,0
7_1265535,locale_haroset_manitoba,1265535,7,63,0,63,0
7_3791185,craves_aesthetics_cantelope,3791185,7,120,0,120,0
7_222734,craves_jealousy_haroset,222734,7,18,0,18,0
7_6290134,craves_love_haroset,6290134,7,26,0,26,0
7_2875084,craves_learning_snickers,2875084,7,11,0,11,0
7_5903734,fears_boils_learning,5903734,7,56,0,56,0
7_4939384,craves_angina_cantelope,4939384,7,80,0,80,0
7_6977933,fears_loneliness_love,6977933,7,77,0,77,0
7_6427833,craves_aesthetics_lamb,6427833,7,85,0,85,0
7_5544683,craves_aesthetics_tofu,5544683,7,123,0,123,0
7_4957332,craves_stimulation_bacon,4957332,7,109,0,109,0
7_3965931,craves_entertainment_tofu,3965931,7,92,0,92,0
7_4849081,craves_entertainment_lamb,4849081,7,75,0,75,0
7_929030,craves_aesthetics_flounder,929030,7,84,0,84,0
7_4484680,fears_jealousy_love,4484680,7,37,0,37,0
7_4015280,craves_anger_cantelope,4015280,7,80,0,80,0
7_4058429,craves_love_marzipan,4058429,7,64,0,64,0
7_5363829,fears_jealousy_stimulation,5363829,7,21,0,21,0
7_3001779,craves_jealousy_bacon,3001779,7,47,0,47,0
7_872979,craves_boils_lobster,872979,7,110,0,110,0
7_3042878,fears_jealousy_achievement,3042878,7,81,0,81,0
7_1133227,craves_learning_onion,1133227,7,13,0,13,0
7_4108876,craves_lubricity_bacon,4108876,7,111,0,111,0
7_1511676,craves_jealousy_flounder,1511676,7,19,0,19,0
7_1529026,fears_laceration_learning,1529026,7,50,0,50,0
7_2107776,craves_anger_beef,2107776,7,80,0,80,0
7_5950375,craves_laceration_bacon,5950375,7,126,0,126,0
7_2404175,craves_learning_okra,2404175,7,14,0,14,0
7_2533325,craves_love_ham,2533325,7,63,0,63,0
7_342073,craves_abrasion_lobster,342073,7,79,0,79,0
7_428472,craves_aesthetics_lemon,428472,7,111,0,111,0
7_2410921,craves_aesthetics_marzipan,2410921,7,114,0,114,0
7_804720,craves_jealousy_wonderbread,804720,7,21,0,21,0
7_6539420,craves_jealousy_lobster,6539420,7,34,0,34,0
7_2574568,craves_jealousy_ham,2574568,7,19,0,19,0
7_2993567,craves_jealousy_marzipan,2993567,7,22,0,22,0
7_2657767,craves_love_onion,2657767,7,76,0,76,0
7_7363867,fears_loneliness_entertainment,7363867,7,104,0,104,0
7_4061666,craves_love_beef,4061666,7,61,0,61,0
7_6317015,craves_grief_beef,6317015,7,88,0,88,0
7_2299014,harmony_learning_earth,2299014,7,8,0,8,0
7_4602914,fears_jealousy_expectation,4602914,7,85,0,85,0
7_2678414,craves_angina_lobster,2678414,7,106,0,106,0
7_614612,craves_love_lemon,614612,7,63,0,63,0
7_3583812,fears_prostatitis_learning,3583812,7,27,0,27,0
7_1913612,craves_grief_lemon,1913612,7,100,0,100,0
7_7186611,craves_jealousy_lemon,7186611,7,21,0,21,0
7_3967861,locale_ham_bavaria,3967861,7,124,0,124,0
7_4906211,craves_anger_lobster,4906211,7,107,0,107,0
7_2087561,craves_sciatica_beef,2087561,7,116,0,116,0
7_3553209,craves_love_lamb,3553209,7,62,0,62,0
7_2670059,craves_love_tofu,2670059,7,66,0,66,0
7_345208,craves_entertainment_marzipan,345208,7,83,0,83,0
7_4430757,craves_love_bacon,4430757,7,82,0,82,0
7_1579104,craves_sciatica_lamb,1579104,7,103,0,103,0
7_2544554,craves_aesthetics_ham,2544554,7,88,0,88,0
7_5508353,craves_sciatica_flounder,5508353,7,102,0,102,0
7_7711852,fears_jealousy_aesthetics,7711852,7,28,0,28,0
7_1501452,craves_love_cantelope,1501452,7,61,0,61,0
7_5436552,fears_anxiety_love,5436552,7,87,0,87,0
7_4812851,craves_angina_beef,4812851,7,80,0,80,0
7_274283,succumb_depression_aesthetics_wonderbread_uranus_saturn,274283,7,1,0,1,0
7_1733858,succumb_depression_aesthetics_wonderbread_saturn_earth,1733858,7,1,0,1,0
7_4104655,succumb_depression_aesthetics_wonderbread_vulcan_uranus,4104655,7,1,0,1,0
7_3653896,fears_anger_aesthetics,3653896,7,58,0,58,0
7_908042,craves_aesthetics_haroset,908042,7,48,0,48,0
7_4530591,fears_depression_entertainment,4530591,7,60,0,60,0
7_3032587,craves_depression_onion,3032587,7,10,0,10,0
7_2799034,locale_bacon_manitoba,2799034,7,23,0,23,0
7_7517629,fears_depression_learning,7517629,7,10,0,10,0
7_4297379,fears_depression_stimulation,4297379,7,25,0,25,0
7_7224728,craves_aesthetics_lobster,7224728,7,23,0,23,0
7_1976428,fears_depression_achievement,1976428,7,10,0,10,0
7_4700324,craves_depression_snickers,4700324,7,10,0,10,0
7_4561120,craves_depression_wonderbread,4561120,7,10,0,10,0
7_2128520,fears_depression_lubricity,2128520,7,34,0,34,0
7_4244617,craves_aesthetics_bacon,4244617,7,22,0,22,0
7_3536464,fears_depression_expectation,3536464,7,10,0,10,0
7_7179962,fears_depression_love,7179962,7,78,0,78,0
7_7412205,craves_depression_okra,7412205,7,10,0,10,0
7_223572,fears_angina_aesthetics,223572,7,58,0,58,0
7_7440497,succumb_angina_lubricity_ham_vulcan_uranus,7440497,7,1,0,1,0
7_810747,succumb_angina_lubricity_lemon_uranus_saturn,810747,7,1,0,1,0
7_4951942,succumb_angina_lubricity_flounder_vulcan_uranus,4951942,7,1,0,1,0
7_1518391,succumb_angina_lubricity_flounder_saturn_earth,1518391,7,1,0,1,0
7_7564688,succumb_angina_lubricity_lamb_vulcan_uranus,7564688,7,1,0,1,0
7_1684381,succumb_angina_lubricity_ham_saturn_earth,1684381,7,1,0,1,0
7_3464631,succumb_angina_lubricity_haroset_uranus_saturn,3464631,7,1,0,1,0
7_2216181,succumb_angina_lubricity_lamb_saturn_earth,2216181,7,1,0,1,0
7_5236381,succumb_angina_lubricity_lemon_saturn_earth,5236381,7,1,0,1,0
7_3610125,succumb_angina_lubricity_ham_uranus_saturn,3610125,7,1,0,1,0
7_1121570,succumb_angina_lubricity_flounder_uranus_saturn,1121570,7,1,0,1,0
7_4641119,succumb_angina_lubricity_lemon_vulcan_uranus,4641119,7,1,0,1,0
7_3734316,succumb_angina_lubricity_lamb_uranus_saturn,3734316,7,1,0,1,0
7_5371763,succumb_angina_lubricity_haroset_saturn_earth,5371763,7,1,0,1,0
7_6105303,succumb_angina_lubricity_lobster_saturn_earth,6105303,7,1,0,1,0
7_3294198,fears_boils_achievement,3294198,7,50,0,50,0
7_6505494,craves_angina_ham,6505494,7,11,0,11,0
7_4304394,craves_angina_lamb,4304394,7,43,0,43,0
7_6631441,craves_lubricity_cantelope,6631441,7,34,0,34,0
7_4319540,fears_dread_lubricity,4319540,7,35,0,35,0
7_5215288,craves_angina_flounder,5215288,7,12,0,12,0
7_2950086,craves_lubricity_tofu,2950086,7,35,0,35,0
7_2335886,craves_lubricity_onion,2335886,7,40,0,40,0
7_4854234,fears_boils_expectation,4854234,7,54,0,54,0
7_6580064,craves_boils_onion,6580064,7,59,0,59,0
7_3222479,fears_hangover_lubricity,3222479,7,34,0,34,0
7_6847927,fears_loneliness_lubricity,6847927,7,31,0,31,0
7_828927,fears_angina_entertainment,828927,7,56,0,56,0
7_894524,craves_angina_lemon,894524,7,12,0,12,0
7_4947268,craves_lubricity_wonderbread,4947268,7,24,0,24,0
7_597652,fears_angina_stimulation,597652,7,30,0,30,0
7_4422260,craves_lubricity_marzipan,4422260,7,33,0,33,0
7_4117151,craves_boils_wonderbread,4117151,7,44,0,44,0
7_4362705,craves_angina_haroset,4362705,7,15,0,15,0
7_2652512,fears_anxiety_lubricity,2652512,7,49,0,49,0
7_1403974,craves_boils_tofu,1403974,7,47,0,47,0
7_1063198,feast_love_tofu_onion_bavaria_manitoba,1063198,7,1,0,1,0
7_1823234,feast_lubricity_tofu_marzipan_bavaria_manitoba,1823234,7,1,0,1,0
7_1466434,feast_love_tofu_marzipan_bavaria_manitoba,1466434,7,1,0,1,0
7_7592181,feast_stimulation_tofu_marzipan_bavaria_manitoba,7592181,7,1,0,1,0
7_3834623,feast_stimulation_tofu_onion_bavaria_manitoba,3834623,7,1,0,1,0
7_4728159,feast_entertainment_tofu_marzipan_bavaria_manitoba,4728159,7,1,0,1,0
7_4812954,feast_lubricity_tofu_onion_bavaria_manitoba,4812954,7,1,0,1,0
7_6721903,feast_entertainment_tofu_onion_bavaria_manitoba,6721903,7,1,0,1,0
7_3184342,craves_stimulation_onion,3184342,7,33,0,33,0
7_4177385,craves_laceration_onion,4177385,7,55,0,55,0
7_602031,craves_abrasion_onion,602031,7,30,0,30,0
7_3005221,craves_prostatitis_onion,3005221,7,26,0,26,0
7_7320002,craves_loneliness_onion,7320002,7,17,0,17,0
7_4459027,locale_tofu_bavaria,4459027,7,2,0,2,0
7_4443807,fears_anxiety_stimulation,4443807,7,41,0,41,0
7_3291842,overcome_boils_stimulation_cantelope_uranus_saturn,3291842,7,1,0,1,0
7_1578989,overcome_boils_lubricity_cantelope_saturn_earth,1578989,7,1,0,1,0
7_5811286,overcome_boils_entertainment_cantelope_vulcan_uranus,5811286,7,1,0,1,0
7_4527235,overcome_boils_stimulation_cantelope_saturn_earth,4527235,7,1,0,1,0
7_4107482,overcome_boils_love_cantelope_vulcan_uranus,4107482,7,1,0,1,0
7_4463076,overcome_boils_lubricity_cantelope_vulcan_uranus,4463076,7,1,0,1,0
7_7122214,overcome_boils_stimulation_cantelope_vulcan_uranus,7122214,7,1,0,1,0
7_632704,overcome_boils_lubricity_cantelope_uranus_saturn,632704,7,1,0,1,0
7_5615149,fears_boils_stimulation,5615149,7,24,0,24,0
7_7185198,craves_boils_ham,7185198,7,19,0,19,0
7_1497644,fears_boils_love,1497644,7,44,0,44,0
7_7080594,craves_boils_flounder,7080594,7,18,0,18,0
7_2795581,craves_boils_beef,2795581,7,18,0,18,0
7_2287124,craves_boils_lamb,2287124,7,18,0,18,0
7_3359573,fears_boils_entertainment,3359573,7,59,0,59,0
7_561508,craves_boils_marzipan,561508,7,19,0,19,0
7_5022204,fears_boils_lubricity,5022204,7,18,0,18,0
7_4536909,craves_boils_lemon,4536909,7,18,0,18,0
7_2557270,craves_boils_haroset,2557270,7,41,0,41,0
7_5962620,fears_boils_aesthetics,5962620,7,27,0,27,0
7_3534048,locale_marzipan_pennsylvania,3534048,7,3,0,3,0
7_2339897,locale_beef_oregon,2339897,7,63,0,63,0
7_6870746,locale_marzipan_oregon,6870746,7,37,0,37,0
7_7514601,locale_marzipan_manitoba,7514601,7,3,0,3,0
7_6026349,fears_hangover_love,6026349,7,78,0,78,0
7_804392,fears_dread_love,804392,7,76,0,76,0
7_2054340,fears_prostatitis_love,2054340,7,77,0,77,0
7_5019078,fears_grief_love,5019078,7,52,0,52,0
7_7424527,harmony_love_vulcan,7424527,7,6,0,6,0
7_7954321,fears_sciatica_love,7954321,7,59,0,59,0
7_7670121,fears_abrasion_love,7670121,7,40,0,40,0
7_7041704,craves_love_wonderbread,7041704,7,58,0,58,0
7_3246453,fears_laceration_love,3246453,7,39,0,39,0
7_2249450,fears_angina_lubricity,2249450,7,28,0,28,0
7_467550,fears_jealousy_learning,467550,7,87,0,87,0
7_145348,feast_lubricity_marzipan_tofu_bavaria_manitoba,145348,7,1,0,1,0
7_3929698,feast_entertainment_marzipan_beef_bavaria_manitoba,3929698,7,1,0,1,0
7_5914295,feast_stimulation_marzipan_tofu_bavaria_manitoba,5914295,7,1,0,1,0
7_331992,feast_aesthetics_marzipan_wonderbread_bavaria_manitoba,331992,7,1,0,1,0
7_2447884,feast_lubricity_marzipan_cantelope_bavaria_manitoba,2447884,7,1,0,1,0
7_5782733,feast_aesthetics_marzipan_tofu_bavaria_manitoba,5782733,7,1,0,1,0
7_4549577,feast_stimulation_marzipan_wonderbread_bavaria_manitoba,4549577,7,1,0,1,0
7_7789525,feast_love_marzipan_tofu_bavaria_manitoba,7789525,7,1,0,1,0
7_5452724,feast_entertainment_marzipan_cantelope_bavaria_manitoba,5452724,7,1,0,1,0
7_667973,feast_love_marzipan_beef_bavaria_manitoba,667973,7,1,0,1,0
7_1024773,feast_lubricity_marzipan_beef_bavaria_manitoba,1024773,7,1,0,1,0
7_3050273,feast_entertainment_marzipan_tofu_bavaria_manitoba,3050273,7,1,0,1,0
7_6142471,feast_lubricity_marzipan_wonderbread_bavaria_manitoba,6142471,7,1,0,1,0
7_6793720,feast_stimulation_marzipan_beef_bavaria_manitoba,6793720,7,1,0,1,0
7_6916969,feast_aesthetics_marzipan_cantelope_bavaria_manitoba,6916969,7,1,0,1,0
7_2068663,feast_stimulation_marzipan_cantelope_bavaria_manitoba,2068663,7,1,0,1,0
7_2484961,feast_love_marzipan_wonderbread_bavaria_manitoba,2484961,7,1,0,1,0
7_5206710,feast_love_marzipan_cantelope_bavaria_manitoba,5206710,7,1,0,1,0
7_3289810,feast_entertainment_marzipan_wonderbread_bavaria_manitoba,3289810,7,1,0,1,0
7_6662158,feast_aesthetics_marzipan_beef_bavaria_manitoba,6662158,7,1,0,1,0
7_5445350,locale_marzipan_bavaria,5445350,7,3,0,3,0
7_4467745,overcome_loneliness_lubricity_tofu_saturn_earth,4467745,7,1,0,1,0
7_7993392,overcome_loneliness_stimulation_tofu_vulcan_uranus,7993392,7,1,0,1,0
7_4972740,overcome_loneliness_love_tofu_vulcan_uranus,4972740,7,1,0,1,0
7_3957732,overcome_loneliness_entertainment_tofu_vulcan_uranus,3957732,7,1,0,1,0
7_7894728,overcome_loneliness_lubricity_tofu_vulcan_uranus,7894728,7,1,0,1,0
7_5218222,overcome_loneliness_stimulation_tofu_saturn_earth,5218222,7,1,0,1,0
7_4163020,overcome_loneliness_stimulation_tofu_uranus_saturn,4163020,7,1,0,1,0
7_4064356,overcome_loneliness_lubricity_tofu_uranus_saturn,4064356,7,1,0,1,0
7_327295,craves_loneliness_marzipan,327295,7,7,0,7,0
7_1586642,fears_loneliness_stimulation,1586642,7,24,0,24,0
7_6848749,overcome_depression_learning_wonderbread_vulcan_uranus,6848749,7,1,0,1,0
7_6179999,succumb_sciatica_learning_wonderbread_uranus_saturn,6179999,7,1,0,1,0
7_4074396,overcome_depression_learning_onion_vulcan_uranus,4074396,7,1,0,1,0
7_7142696,succumb_depression_learning_wonderbread_uranus_saturn,7142696,7,1,0,1,0
7_3304289,overcome_sciatica_learning_wonderbread_vulcan_uranus,3304289,7,1,0,1,0
7_6526837,overcome_depression_learning_snickers_vulcan_uranus,6526837,7,1,0,1,0
7_5541634,overcome_laceration_learning_wonderbread_vulcan_uranus,5541634,7,1,0,1,0
7_7656083,overcome_hangover_learning_wonderbread_vulcan_uranus,7656083,7,1,0,1,0
7_1114632,overcome_dread_learning_wonderbread_vulcan_uranus,1114632,7,1,0,1,0
7_6481182,overcome_abrasion_learning_wonderbread_vulcan_uranus,6481182,7,1,0,1,0
7_3214131,overcome_jealousy_learning_wonderbread_vulcan_uranus,3214131,7,1,0,1,0
7_5767630,overcome_grief_learning_wonderbread_vulcan_uranus,5767630,7,1,0,1,0
7_3948425,overcome_hangover_learning_okra_vulcan_uranus,3948425,7,1,0,1,0
7_5020674,succumb_depression_learning_okra_uranus_saturn,5020674,7,1,0,1,0
7_3174623,succumb_hangover_learning_onion_uranus_saturn,3174623,7,1,0,1,0
7_1824168,overcome_boils_learning_wonderbread_vulcan_uranus,1824168,7,1,0,1,0
7_1688017,overcome_hangover_learning_snickers_vulcan_uranus,1688017,7,1,0,1,0
7_2733167,succumb_dread_learning_wonderbread_uranus_saturn,2733167,7,1,0,1,0
7_4151816,overcome_anxiety_learning_onion_vulcan_uranus,4151816,7,1,0,1,0
7_2530816,succumb_hangover_learning_wonderbread_uranus_saturn,2530816,7,1,0,1,0
7_7386165,succumb_grief_learning_wonderbread_uranus_saturn,7386165,7,1,0,1,0
7_1683363,succumb_hangover_learning_okra_uranus_saturn,1683363,7,1,0,1,0
7_1886754,succumb_anxiety_learning_onion_uranus_saturn,1886754,7,1,0,1,0
7_6563703,overcome_prostatitis_learning_wonderbread_vulcan_uranus,6563703,7,1,0,1,0
7_5221003,overcome_depression_learning_okra_vulcan_uranus,5221003,7,1,0,1,0
7_2660153,succumb_depression_learning_snickers_uranus_saturn,2660153,7,1,0,1,0
7_3306552,succumb_hangover_learning_snickers_uranus_saturn,3306552,7,1,0,1,0
7_1421700,succumb_depression_learning_onion_uranus_saturn,1421700,7,1,0,1,0
7_6793985,harmony_learning_vulcan,6793985,7,2,0,2,0
7_1222810,harmony_learning_saturn,1222810,7,2,0,2,0
7_3810596,overcome_laceration_achievement_wonderbread_vulcan_uranus,3810596,7,1,0,1,0
7_6496945,overcome_laceration_expectation_wonderbread_uranus_saturn,6496945,7,1,0,1,0
7_2326340,overcome_laceration_expectation_wonderbread_vulcan_uranus,2326340,7,1,0,1,0
7_3482186,overcome_laceration_entertainment_wonderbread_vulcan_uranus,3482186,7,1,0,1,0
7_5111784,overcome_laceration_aesthetics_wonderbread_vulcan_uranus,5111784,7,1,0,1,0
7_3236184,overcome_laceration_love_wonderbread_vulcan_uranus,3236184,7,1,0,1,0
7_6929782,overcome_laceration_stimulation_wonderbread_saturn_earth,6929782,7,1,0,1,0
7_7632871,overcome_laceration_lubricity_wonderbread_uranus_saturn,7632871,7,1,0,1,0
7_3462266,overcome_laceration_lubricity_wonderbread_vulcan_uranus,3462266,7,1,0,1,0
7_3887862,overcome_laceration_lubricity_wonderbread_saturn_earth,3887862,7,1,0,1,0
7_1281412,overcome_laceration_aesthetics_wonderbread_uranus_saturn,1281412,7,1,0,1,0
7_1711262,overcome_laceration_learning_wonderbread_uranus_saturn,1711262,7,1,0,1,0
7_3645954,overcome_laceration_learning_wonderbread_saturn_earth,3645954,7,1,0,1,0
7_6571253,overcome_laceration_expectation_wonderbread_saturn_earth,6571253,7,1,0,1,0
7_3456752,overcome_laceration_aesthetics_wonderbread_saturn_earth,3456752,7,1,0,1,0
7_7981201,overcome_laceration_achievement_wonderbread_uranus_saturn,7981201,7,1,0,1,0
7_7614098,craves_laceration_tofu,7614098,7,24,0,24,0
7_4834197,craves_laceration_cantelope,4834197,7,21,0,21,0
7_2122245,fears_laceration_expectation,2122245,7,48,0,48,0
7_808089,craves_laceration_flounder,808089,7,20,0,20,0
7_5233736,fears_laceration_lubricity,5233736,7,23,0,23,0
7_562209,fears_laceration_achievement,562209,7,44,0,44,0
7_2883160,fears_laceration_stimulation,2883160,7,19,0,19,0
7_7814663,craves_laceration_haroset,7814663,7,19,0,19,0
7_496271,craves_laceration_lamb,496271,7,19,0,19,0
7_2833922,craves_laceration_ham,2833922,7,22,0,22,0
7_6130372,craves_laceration_lobster,6130372,7,41,0,41,0
7_4107973,fears_laceration_aesthetics,4107973,7,22,0,22,0
7_5591775,fears_laceration_entertainment,5591775,7,45,0,45,0
7_1004728,craves_laceration_beef,1004728,7,19,0,19,0
7_2134230,craves_laceration_lemon,2134230,7,19,0,19,0
7_2289980,craves_laceration_marzipan,2289980,7,20,0,20,0
7_5777348,overcome_boils_achievement_wonderbread_uranus_saturn,5777348,7,1,0,1,0
7_170396,overcome_boils_lubricity_wonderbread_saturn_earth,170396,7,1,0,1,0
7_1606743,overcome_boils_achievement_wonderbread_vulcan_uranus,1606743,7,1,0,1,0
7_64792,overcome_boils_stimulation_wonderbread_uranus_saturn,64792,7,1,0,1,0
7_4293092,overcome_boils_expectation_wonderbread_uranus_saturn,4293092,7,1,0,1,0
7_122487,overcome_boils_expectation_wonderbread_vulcan_uranus,122487,7,1,0,1,0
7_3179286,overcome_boils_aesthetics_wonderbread_uranus_saturn,3179286,7,1,0,1,0
7_5408782,overcome_boils_entertainment_wonderbread_vulcan_uranus,5408782,7,1,0,1,0
7_826679,overcome_boils_stimulation_wonderbread_saturn_earth,826679,7,1,0,1,0
7_5994773,overcome_boils_learning_wonderbread_uranus_saturn,5994773,7,1,0,1,0
7_3901719,overcome_boils_aesthetics_wonderbread_saturn_earth,3901719,7,1,0,1,0
7_3895164,overcome_boils_stimulation_wonderbread_vulcan_uranus,3895164,7,1,0,1,0
7_7009658,overcome_boils_aesthetics_wonderbread_vulcan_uranus,7009658,7,1,0,1,0
7_5444154,overcome_boils_learning_wonderbread_saturn_earth,5444154,7,1,0,1,0
7_468150,overcome_boils_expectation_wonderbread_saturn_earth,468150,7,1,0,1,0
7_6544850,overcome_boils_love_wonderbread_vulcan_uranus,6544850,7,1,0,1,0
7_3190749,craves_lubricity_ham,3190749,7,32,0,32,0
7_4341693,craves_lubricity_beef,4341693,7,30,0,30,0
7_2072290,craves_lubricity_haroset,2072290,7,29,0,29,0
7_3833236,craves_lubricity_lamb,3833236,7,27,0,27,0
7_6638384,fears_anger_lubricity,6638384,7,27,0,27,0
7_1599319,craves_anger_lamb,1599319,7,43,0,43,0
7_2940369,craves_lubricity_flounder,2940369,7,29,0,29,0
7_7367121,harmony_lubricity_uranus,7367121,7,13,0,13,0
7_3862428,harmony_lubricity_vulcan,3862428,7,19,0,19,0
7_44280,locale_lemon_manitoba,44280,7,33,0,33,0
7_292731,craves_lubricity_lemon,292731,7,30,0,30,0
7_2399100,craves_boils_cantelope,2399100,7,18,0,18,0
7_3344601,craves_loneliness_tofu,3344601,7,5,0,5,0
7_3046200,locale_tofu_manitoba,3046200,7,12,0,12,0
7_2928243,harmony_love_uranus,2928243,7,14,0,14,0
7_3837243,craves_anxiety_onion,3837243,7,4,0,4,0
7_5255941,locale_lamb_bosnia,5255941,7,41,0,41,0
7_3077091,overcome_grief_aesthetics_flounder_uranus_saturn,3077091,7,1,0,1,0
7_7376241,overcome_grief_stimulation_flounder_uranus_saturn,7376241,7,1,0,1,0
7_6324440,overcome_grief_lubricity_flounder_saturn_earth,6324440,7,1,0,1,0
7_1994837,overcome_grief_aesthetics_flounder_saturn_earth,1994837,7,1,0,1,0
7_3205636,overcome_grief_stimulation_flounder_vulcan_uranus,3205636,7,1,0,1,0
7_7320633,overcome_grief_lubricity_flounder_uranus_saturn,7320633,7,1,0,1,0
7_3150028,overcome_grief_lubricity_flounder_vulcan_uranus,3150028,7,1,0,1,0
7_6907463,overcome_grief_aesthetics_flounder_vulcan_uranus,6907463,7,1,0,1,0
7_573955,overcome_grief_stimulation_flounder_saturn_earth,573955,7,1,0,1,0
7_4925402,overcome_grief_entertainment_flounder_vulcan_uranus,4925402,7,1,0,1,0
7_1606144,fears_grief_lubricity,1606144,7,37,0,37,0
7_4546428,craves_grief_wonderbread,4546428,7,22,0,22,0
7_6044426,fears_grief_stimulation,6044426,7,34,0,34,0
7_5021913,fears_grief_entertainment,5021913,7,30,0,30,0
7_5474563,craves_grief_lobster,5474563,7,16,0,16,0
7_5808558,craves_grief_lamb,5808558,7,26,0,26,0
7_5729757,craves_grief_bacon,5729757,7,26,0,26,0
7_7158854,craves_grief_haroset,7158854,7,26,0,26,0
7_3557753,fears_grief_aesthetics,3557753,7,18,0,18,0
7_5283511,fears_grief_expectation,5283511,7,41,0,41,0
7_7765619,fears_grief_learning,7765619,7,43,0,43,0
7_3723475,fears_grief_achievement,3723475,7,36,0,36,0
7_3773194,overcome_anger_stimulation_haroset_uranus_saturn,3773194,7,1,0,1,0
7_2410744,overcome_anger_love_haroset_vulcan_uranus,2410744,7,1,0,1,0
7_6279329,overcome_anger_stimulation_haroset_saturn_earth,6279329,7,1,0,1,0
7_5227378,overcome_anger_aesthetics_haroset_uranus_saturn,5227378,7,1,0,1,0
7_1056773,overcome_anger_aesthetics_haroset_vulcan_uranus,1056773,7,1,0,1,0
7_7603566,overcome_anger_stimulation_haroset_vulcan_uranus,7603566,7,1,0,1,0
7_1184359,overcome_anger_entertainment_haroset_vulcan_uranus,1184359,7,1,0,1,0
7_7869405,overcome_anger_lubricity_haroset_uranus_saturn,7869405,7,1,0,1,0
7_3201202,overcome_anger_lubricity_haroset_saturn_earth,3201202,7,1,0,1,0
7_7035101,overcome_anger_aesthetics_haroset_saturn_earth,7035101,7,1,0,1,0
7_3698800,overcome_anger_lubricity_haroset_vulcan_uranus,3698800,7,1,0,1,0
7_3934647,fears_anger_entertainment,3934647,7,56,0,56,0
7_587956,craves_anger_ham,587956,7,12,0,12,0
7_6654103,fears_anger_stimulation,6654103,7,28,0,28,0
7_7461953,craves_anger_flounder,7461953,7,11,0,11,0
7_4480323,craves_anger_lemon,4480323,7,11,0,11,0
7_7021997,succumb_angina_stimulation_flounder_vulcan_uranus,7021997,7,1,0,1,0
7_5973186,succumb_angina_stimulation_lemon_uranus_saturn,5973186,7,1,0,1,0
7_1802581,succumb_angina_stimulation_lemon_vulcan_uranus,1802581,7,1,0,1,0
7_5107579,succumb_angina_stimulation_ham_uranus_saturn,5107579,7,1,0,1,0
7_1252677,succumb_angina_stimulation_ham_saturn_earth,1252677,7,1,0,1,0
7_3191625,succumb_angina_stimulation_flounder_uranus_saturn,3191625,7,1,0,1,0
7_4537709,succumb_angina_stimulation_lemon_saturn_earth,4537709,7,1,0,1,0
7_5808250,succumb_angina_stimulation_flounder_saturn_earth,5808250,7,1,0,1,0
7_1449880,fears_dread_stimulation,1449880,7,26,0,26,0
7_3955115,craves_stimulation_wonderbread,3955115,7,16,0,16,0
7_4703614,craves_stimulation_tofu,4703614,7,27,0,27,0
7_5586764,craves_stimulation_lamb,5586764,7,22,0,22,0
7_3796608,craves_stimulation_marzipan,3796608,7,26,0,26,0
7_1239506,fears_hangover_stimulation,1239506,7,25,0,25,0
7_5347858,feast_entertainment_lobster_haroset_bavaria_manitoba,5347858,7,1,0,1,0
7_7467054,feast_entertainment_lobster_bacon_bavaria_manitoba,7467054,7,1,0,1,0
7_7423494,craves_entertainment_wonderbread,7423494,7,38,0,38,0
7_3931593,craves_entertainment_haroset,3931593,7,40,0,40,0
7_4236582,fears_hangover_entertainment,4236582,7,60,0,60,0
7_137328,fears_abrasion_entertainment,137328,7,57,0,57,0
7_5623675,fears_dread_entertainment,5623675,7,57,0,57,0
7_132955,craves_entertainment_bacon,132955,7,44,0,44,0
7_2810155,fears_prostatitis_entertainment,2810155,7,60,0,60,0
7_7837246,succumb_jealousy_aesthetics_haroset_uranus_saturn,7837246,7,1,0,1,0
7_4775145,succumb_jealousy_aesthetics_lamb_saturn_earth,4775145,7,1,0,1,0
7_3666641,succumb_jealousy_aesthetics_haroset_vulcan_uranus,3666641,7,1,0,1,0
7_7403790,succumb_jealousy_aesthetics_lobster_saturn_earth,7403790,7,1,0,1,0
7_6521440,succumb_jealousy_aesthetics_bacon_vulcan_uranus,6521440,7,1,0,1,0
7_3712289,succumb_jealousy_aesthetics_bacon_saturn_earth,3712289,7,1,0,1,0
7_3600038,succumb_jealousy_aesthetics_lobster_uranus_saturn,3600038,7,1,0,1,0
7_2748986,succumb_jealousy_aesthetics_lamb_uranus_saturn,2748986,7,1,0,1,0
7_374230,succumb_jealousy_aesthetics_flounder_uranus_saturn,374230,7,1,0,1,0
7_2691068,succumb_jealousy_aesthetics_bacon_uranus_saturn,2691068,7,1,0,1,0
7_4069667,succumb_jealousy_aesthetics_ham_saturn_earth,4069667,7,1,0,1,0
7_7430410,succumb_jealousy_aesthetics_lobster_vulcan_uranus,7430410,7,1,0,1,0
7_5891006,succumb_jealousy_aesthetics_flounder_saturn_earth,5891006,7,1,0,1,0
7_6670250,succumb_jealousy_aesthetics_haroset_saturn_earth,6670250,7,1,0,1,0
7_4704550,succumb_jealousy_aesthetics_beef_saturn_earth,4704550,7,1,0,1,0
7_1088397,overcome_abrasion_entertainment_ham_vulcan_uranus,1088397,7,1,0,1,0
7_589340,overcome_abrasion_aesthetics_ham_saturn_earth,589340,7,1,0,1,0
7_5006189,overcome_abrasion_stimulation_ham_saturn_earth,5006189,7,1,0,1,0
7_2507781,overcome_abrasion_lubricity_ham_saturn_earth,2507781,7,1,0,1,0
7_3313824,overcome_abrasion_aesthetics_ham_uranus_saturn,3313824,7,1,0,1,0
7_6375123,overcome_abrasion_lubricity_ham_uranus_saturn,6375123,7,1,0,1,0
7_2204518,overcome_abrasion_lubricity_ham_vulcan_uranus,2204518,7,1,0,1,0
7_4483052,overcome_abrasion_love_ham_vulcan_uranus,4483052,7,1,0,1,0
7_7207743,craves_abrasion_wonderbread,7207743,7,18,0,18,0
7_1444924,fears_abrasion_achievement,1444924,7,24,0,24,0
7_7185267,craves_abrasion_flounder,7185267,7,19,0,19,0
7_3004960,fears_abrasion_expectation,3004960,7,28,0,28,0
7_6559853,craves_abrasion_lemon,6559853,7,18,0,18,0
7_411754,craves_abrasion_tofu,411754,7,20,0,20,0
7_1294904,craves_abrasion_lamb,1294904,7,18,0,18,0
7_5192457,craves_abrasion_cantelope,5192457,7,18,0,18,0
7_2767507,fears_abrasion_aesthetics,2767507,7,26,0,26,0
7_1803361,craves_abrasion_beef,1803361,7,18,0,18,0
7_2026364,craves_abrasion_haroset,2026364,7,18,0,18,0
7_3765875,fears_abrasion_stimulation,3765875,7,19,0,19,0
7_1790580,fears_abrasion_lubricity,1790580,7,19,0,19,0
7_666181,craves_abrasion_marzipan,666181,7,19,0,19,0
7_1192447,overcome_abrasion_love_lemon_vulcan_uranus,1192447,7,1,0,1,0
7_5858430,overcome_abrasion_stimulation_lemon_uranus_saturn,5858430,7,1,0,1,0
7_1592579,overcome_abrasion_lubricity_lemon_uranus_saturn,1592579,7,1,0,1,0
7_4248829,overcome_abrasion_entertainment_lemon_vulcan_uranus,4248829,7,1,0,1,0
7_4662276,overcome_abrasion_stimulation_lemon_saturn_earth,4662276,7,1,0,1,0
7_1687825,overcome_abrasion_stimulation_lemon_vulcan_uranus,1687825,7,1,0,1,0
7_1392118,overcome_abrasion_aesthetics_lemon_saturn_earth,1392118,7,1,0,1,0
7_988916,overcome_abrasion_lubricity_lemon_saturn_earth,988916,7,1,0,1,0
7_5422951,overcome_abrasion_lubricity_lemon_vulcan_uranus,5422951,7,1,0,1,0
7_55452,craves_abrasion_ham,55452,7,22,0,22,0
7_5327349,succumb_laceration_love_cantelope_vulcan_uranus,5327349,7,1,0,1,0
7_7512148,succumb_laceration_love_lamb_vulcan_uranus,7512148,7,1,0,1,0
7_3314788,succumb_laceration_love_ham_vulcan_uranus,3314788,7,1,0,1,0
7_2286783,succumb_laceration_love_flounder_vulcan_uranus,2286783,7,1,0,1,0
7_7192833,succumb_laceration_love_lemon_vulcan_uranus,7192833,7,1,0,1,0
7_5441782,succumb_laceration_love_beef_vulcan_uranus,5441782,7,1,0,1,0
7_2162529,succumb_laceration_love_marzipan_vulcan_uranus,2162529,7,1,0,1,0
7_5986378,succumb_laceration_love_wonderbread_vulcan_uranus,5986378,7,1,0,1,0
7_3766222,succumb_laceration_love_lobster_vulcan_uranus,3766222,7,1,0,1,0
7_2453,succumb_laceration_love_haroset_vulcan_uranus,2453,7,1,0,1,0
7_6368951,succumb_laceration_love_tofu_vulcan_uranus,6368951,7,1,0,1,0
7_3146901,craves_laceration_wonderbread,3146901,7,21,0,21,0
7_839449,succumb_grief_aesthetics_lobster_saturn_earth,839449,7,1,0,1,0
7_5768295,succumb_grief_aesthetics_lamb_saturn_earth,5768295,7,1,0,1,0
7_5651945,succumb_grief_aesthetics_bacon_vulcan_uranus,5651945,7,1,0,1,0
7_7164284,succumb_grief_aesthetics_lobster_vulcan_uranus,7164284,7,1,0,1,0
7_3135932,succumb_grief_aesthetics_ham_saturn_earth,3135932,7,1,0,1,0
7_5624880,succumb_grief_aesthetics_flounder_saturn_earth,5624880,7,1,0,1,0
7_2310529,succumb_grief_aesthetics_wonderbread_uranus_saturn,2310529,7,1,0,1,0
7_1927425,succumb_grief_aesthetics_bacon_saturn_earth,1927425,7,1,0,1,0
7_1821573,succumb_grief_aesthetics_bacon_uranus_saturn,1821573,7,1,0,1,0
7_964122,succumb_grief_aesthetics_lamb_uranus_saturn,964122,7,1,0,1,0
7_7571120,succumb_grief_aesthetics_haroset_uranus_saturn,7571120,7,1,0,1,0
7_4254767,succumb_grief_aesthetics_flounder_uranus_saturn,4254767,7,1,0,1,0
7_3400515,succumb_grief_aesthetics_haroset_vulcan_uranus,3400515,7,1,0,1,0
7_3333912,succumb_grief_aesthetics_lobster_uranus_saturn,3333912,7,1,0,1,0
7_105909,succumb_grief_aesthetics_haroset_saturn_earth,105909,7,1,0,1,0
7_54106,succumb_grief_aesthetics_wonderbread_saturn_earth,54106,7,1,0,1,0
7_6140901,succumb_grief_aesthetics_wonderbread_vulcan_uranus,6140901,7,1,0,1,0
7_5697700,succumb_grief_aesthetics_beef_saturn_earth,5697700,7,1,0,1,0
7_941502,craves_grief_flounder,941502,7,27,0,27,0
7_817593,overcome_anger_entertainment_flounder_vulcan_uranus,817593,7,1,0,1,0
7_4330090,overcome_anger_aesthetics_flounder_uranus_saturn,4330090,7,1,0,1,0
7_3281138,overcome_anger_aesthetics_flounder_saturn_earth,3281138,7,1,0,1,0
7_159485,overcome_anger_aesthetics_flounder_vulcan_uranus,159485,7,1,0,1,0
7_4436329,overcome_anger_lubricity_flounder_vulcan_uranus,4436329,7,1,0,1,0
7_103928,overcome_anger_stimulation_flounder_uranus_saturn,103928,7,1,0,1,0
7_5923165,overcome_anger_lubricity_flounder_saturn_earth,5923165,7,1,0,1,0
7_605957,overcome_anger_lubricity_flounder_uranus_saturn,605957,7,1,0,1,0
7_1826954,overcome_anger_stimulation_flounder_saturn_earth,1826954,7,1,0,1,0
7_3934300,overcome_anger_stimulation_flounder_vulcan_uranus,3934300,7,1,0,1,0
7_2734050,overcome_anger_love_flounder_vulcan_uranus,2734050,7,1,0,1,0
7_6590502,craves_anger_haroset,6590502,7,12,0,12,0
7_1619342,locale_okra_manitoba,1619342,7,12,0,12,0
7_2455781,craves_expectation_snickers,2455781,7,12,0,12,0
7_6885171,craves_expectation_okra,6885171,7,11,0,11,0
7_1908395,succumb_anger_stimulation_haroset_saturn_earth,1908395,7,1,0,1,0
7_3047493,succumb_anger_stimulation_lemon_uranus_saturn,3047493,7,1,0,1,0
7_3698793,succumb_anger_stimulation_ham_uranus_saturn,3698793,7,1,0,1,0
7_5552835,succumb_anger_stimulation_flounder_uranus_saturn,5552835,7,1,0,1,0
7_1382230,succumb_anger_stimulation_flounder_vulcan_uranus,1382230,7,1,0,1,0
7_3004630,succumb_anger_stimulation_flounder_saturn_earth,3004630,7,1,0,1,0
7_4950870,succumb_anger_stimulation_haroset_uranus_saturn,4950870,7,1,0,1,0
7_6877865,succumb_anger_stimulation_lemon_vulcan_uranus,6877865,7,1,0,1,0
7_780265,succumb_anger_stimulation_haroset_vulcan_uranus,780265,7,1,0,1,0
7_4810109,succumb_anger_stimulation_ham_saturn_earth,4810109,7,1,0,1,0
7_3932458,succumb_anger_stimulation_lemon_saturn_earth,3932458,7,1,0,1,0
7_6541548,overcome_prostatitis_lubricity_beef_uranus_saturn,6541548,7,1,0,1,0
7_24097,overcome_prostatitis_stimulation_beef_vulcan_uranus,24097,7,1,0,1,0
7_2370943,overcome_prostatitis_lubricity_beef_vulcan_uranus,2370943,7,1,0,1,0
7_4227391,overcome_prostatitis_lubricity_beef_saturn_earth,4227391,7,1,0,1,0
7_2616341,overcome_prostatitis_entertainment_beef_vulcan_uranus,2616341,7,1,0,1,0
7_2973371,overcome_prostatitis_aesthetics_beef_saturn_earth,2973371,7,1,0,1,0
7_4155716,overcome_prostatitis_stimulation_beef_saturn_earth,4155716,7,1,0,1,0
7_6123062,overcome_prostatitis_love_beef_vulcan_uranus,6123062,7,1,0,1,0
7_5551508,overcome_prostatitis_aesthetics_beef_uranus_saturn,5551508,7,1,0,1,0
7_4194702,overcome_prostatitis_stimulation_beef_uranus_saturn,4194702,7,1,0,1,0
7_3734046,craves_prostatitis_tofu,3734046,7,16,0,16,0
7_4617196,craves_prostatitis_lamb,4617196,7,15,0,15,0
7_58194,craves_prostatitis_wonderbread,58194,7,15,0,15,0
7_5866392,fears_prostatitis_stimulation,5866392,7,20,0,20,0
7_3545441,fears_prostatitis_achievement,3545441,7,21,0,21,0
7_2119382,fears_prostatitis_aesthetics,2119382,7,32,0,32,0
7_5105477,fears_prostatitis_expectation,5105477,7,25,0,25,0
7_962066,craves_prostatitis_lemon,962066,7,15,0,15,0
7_3048718,craves_prostatitis_marzipan,3048718,7,14,0,14,0
7_3194470,fears_prostatitis_lubricity,3194470,7,27,0,27,0
7_7047677,craves_prostatitis_cantelope,7047677,7,15,0,15,0
7_742295,overcome_sciatica_stimulation_flounder_vulcan_uranus,742295,7,1,0,1,0
7_7471426,overcome_sciatica_stimulation_flounder_saturn_earth,7471426,7,1,0,1,0
7_1552973,overcome_sciatica_aesthetics_flounder_saturn_earth,1552973,7,1,0,1,0
7_6878769,overcome_sciatica_lubricity_flounder_uranus_saturn,6878769,7,1,0,1,0
7_2708164,overcome_sciatica_lubricity_flounder_vulcan_uranus,2708164,7,1,0,1,0
7_2572256,overcome_sciatica_lubricity_flounder_saturn_earth,2572256,7,1,0,1,0
7_4912900,overcome_sciatica_stimulation_flounder_uranus_saturn,4912900,7,1,0,1,0
7_6255097,craves_sciatica_wonderbread,6255097,7,18,0,18,0
7_384688,harmony_aesthetics_vulcan,384688,7,12,0,12,0
7_582138,craves_sciatica_haroset,582138,7,18,0,18,0
7_4553354,fears_sciatica_lubricity,4553354,7,33,0,33,0
7_1288709,fears_hangover_aesthetics,1288709,7,28,0,28,0
7_2052314,fears_sciatica_expectation,2052314,7,23,0,23,0
7_4101071,locale_lobster_manitoba,4101071,7,44,0,44,0
7_6898824,craves_sciatica_lobster,6898824,7,18,0,18,0
7_5951675,fears_sciatica_aesthetics,5951675,7,16,0,16,0
7_4464227,fears_sciatica_learning,4464227,7,25,0,25,0
7_3121428,craves_sciatica_bacon,3121428,7,14,0,14,0
7_492278,fears_sciatica_achievement,492278,7,18,0,18,0
7_2813229,fears_sciatica_stimulation,2813229,7,28,0,28,0
7_658980,craves_aesthetics_wonderbread,658980,7,17,0,17,0
7_2102130,fears_dread_aesthetics,2102130,7,25,0,25,0
7_7153580,fears_sciatica_entertainment,7153580,7,42,0,42,0
7_3889381,harmony_aesthetics_uranus,3889381,7,10,0,10,0
7_1269400,fears_depression_aesthetics,1269400,7,28,0,28,0
7_6990583,overcome_abrasion_stimulation_lamb_vulcan_uranus,6990583,7,1,0,1,0
7_7891030,overcome_abrasion_aesthetics_lamb_uranus_saturn,7891030,7,1,0,1,0
7_1919880,overcome_abrasion_aesthetics_lamb_saturn_earth,1919880,7,1,0,1,0
7_4981179,overcome_abrasion_lubricity_lamb_saturn_earth,4981179,7,1,0,1,0
7_7487828,overcome_abrasion_lubricity_lamb_uranus_saturn,7487828,7,1,0,1,0
7_3720425,overcome_abrasion_aesthetics_lamb_vulcan_uranus,3720425,7,1,0,1,0
7_3317223,overcome_abrasion_lubricity_lamb_vulcan_uranus,3317223,7,1,0,1,0
7_5625419,overcome_abrasion_entertainment_lamb_vulcan_uranus,5625419,7,1,0,1,0
7_4495467,overcome_abrasion_stimulation_lamb_saturn_earth,4495467,7,1,0,1,0
7_3160211,overcome_abrasion_stimulation_lamb_uranus_saturn,3160211,7,1,0,1,0
7_2550606,overcome_abrasion_love_lamb_vulcan_uranus,2550606,7,1,0,1,0
7_4862586,feast_aesthetics_ham_lemon_manitoba_pennsylvania,4862586,7,1,0,1,0
7_2355633,feast_aesthetics_ham_flounder_pennsylvania_oregon,2355633,7,1,0,1,0
7_3626727,feast_aesthetics_ham_flounder_manitoba_pennsylvania,3626727,7,1,0,1,0
7_1853775,feast_aesthetics_ham_flounder_goias_bosnia,1853775,7,1,0,1,0
7_5459904,feast_aesthetics_ham_lemon_goias_bosnia,5459904,7,1,0,1,0
7_2997853,feast_aesthetics_ham_lemon_oregon_goias,2997853,7,1,0,1,0
7_7392701,feast_aesthetics_ham_flounder_oregon_goias,7392701,7,1,0,1,0
7_3351501,feast_aesthetics_ham_lemon_pennsylvania_oregon,3351501,7,1,0,1,0
7_7489832,succumb_sciatica_lubricity_wonderbread_uranus_saturn,7489832,7,1,0,1,0
7_1966426,succumb_sciatica_lubricity_haroset_uranus_saturn,1966426,7,1,0,1,0
7_355622,succumb_sciatica_lubricity_wonderbread_saturn_earth,355622,7,1,0,1,0
7_3771966,succumb_sciatica_lubricity_haroset_saturn_earth,3771966,7,1,0,1,0
7_4505506,succumb_sciatica_lubricity_lobster_saturn_earth,4505506,7,1,0,1,0
7_4815849,overcome_anxiety_expectation_onion_uranus_saturn,4815849,7,1,0,1,0
7_5868596,overcome_depression_expectation_snickers_uranus_saturn,5868596,7,1,0,1,0
7_6303596,succumb_hangover_expectation_wonderbread_saturn_earth,6303596,7,1,0,1,0
7_2522443,overcome_hangover_expectation_onion_uranus_saturn,2522443,7,1,0,1,0
7_7754539,succumb_hangover_expectation_snickers_saturn_earth,7754539,7,1,0,1,0
7_3920438,succumb_hangover_expectation_onion_saturn_earth,3920438,7,1,0,1,0
7_3164387,overcome_dread_expectation_wonderbread_uranus_saturn,3164387,7,1,0,1,0
7_4306136,overcome_hangover_expectation_okra_uranus_saturn,4306136,7,1,0,1,0
7_2204084,overcome_jealousy_expectation_wonderbread_uranus_saturn,2204084,7,1,0,1,0
7_6473534,succumb_hangover_expectation_okra_saturn_earth,6473534,7,1,0,1,0
7_6675930,overcome_hangover_expectation_snickers_uranus_saturn,6675930,7,1,0,1,0
7_996828,overcome_prostatitis_expectation_wonderbread_uranus_saturn,996828,7,1,0,1,0
7_4444027,succumb_anxiety_expectation_onion_saturn_earth,4444027,7,1,0,1,0
7_1957177,succumb_sciatica_expectation_wonderbread_saturn_earth,1957177,7,1,0,1,0
7_2386476,succumb_depression_expectation_onion_saturn_earth,2386476,7,1,0,1,0
7_5564124,succumb_depression_expectation_wonderbread_saturn_earth,5564124,7,1,0,1,0
7_2287869,overcome_hangover_expectation_wonderbread_uranus_saturn,2287869,7,1,0,1,0
7_1413418,overcome_abrasion_expectation_wonderbread_uranus_saturn,1413418,7,1,0,1,0
7_7345117,overcome_depression_expectation_wonderbread_uranus_saturn,7345117,7,1,0,1,0
7_1958866,succumb_dread_expectation_wonderbread_saturn_earth,1958866,7,1,0,1,0
7_7361263,overcome_depression_expectation_onion_uranus_saturn,7361263,7,1,0,1,0
7_2521913,succumb_depression_expectation_snickers_saturn_earth,2521913,7,1,0,1,0
7_1740408,overcome_sciatica_expectation_wonderbread_uranus_saturn,1740408,7,1,0,1,0
7_5779958,succumb_depression_expectation_okra_saturn_earth,5779958,7,1,0,1,0
7_1199656,overcome_depression_expectation_okra_uranus_saturn,1199656,7,1,0,1,0
7_7213551,overcome_grief_expectation_wonderbread_uranus_saturn,7213551,7,1,0,1,0
7_2966295,harmony_expectation_uranus,2966295,7,2,0,2,0
7_7462579,harmony_expectation_vulcan,7462579,7,2,0,2,0
7_1739057,harmony_expectation_earth,1739057,7,8,0,8,0
7_7944948,succumb_boils_lubricity_flounder_vulcan_uranus,7944948,7,1,0,1,0
7_3290796,succumb_boils_lubricity_lobster_saturn_earth,3290796,7,1,0,1,0
7_7820694,succumb_boils_lubricity_marzipan_vulcan_uranus,7820694,7,1,0,1,0
7_1514841,succumb_boils_lubricity_beef_uranus_saturn,1514841,7,1,0,1,0
7_7193141,succumb_boils_lubricity_onion_saturn_earth,7193141,7,1,0,1,0
7_5301639,succumb_boils_lubricity_beef_saturn_earth,5301639,7,1,0,1,0
7_1029536,succumb_boils_lubricity_marzipan_saturn_earth,1029536,7,1,0,1,0
7_5372234,succumb_boils_lubricity_lamb_saturn_earth,5372234,7,1,0,1,0
7_5209032,succumb_boils_lubricity_cantelope_saturn_earth,5209032,7,1,0,1,0
7_1810380,succumb_boils_lubricity_cantelope_uranus_saturn,1810380,7,1,0,1,0
7_7415579,succumb_boils_lubricity_lamb_vulcan_uranus,7415579,7,1,0,1,0
7_1092529,succumb_boils_lubricity_flounder_saturn_earth,1092529,7,1,0,1,0
7_6766178,succumb_boils_lubricity_ham_uranus_saturn,6766178,7,1,0,1,0
7_2643728,succumb_boils_lubricity_lemon_uranus_saturn,2643728,7,1,0,1,0
7_4114576,succumb_boils_lubricity_flounder_uranus_saturn,4114576,7,1,0,1,0
7_7541173,succumb_boils_lubricity_ham_saturn_earth,7541173,7,1,0,1,0
7_2595573,succumb_boils_lubricity_ham_vulcan_uranus,2595573,7,1,0,1,0
7_5087272,succumb_boils_lubricity_lemon_saturn_earth,5087272,7,1,0,1,0
7_3990322,succumb_boils_lubricity_marzipan_uranus_saturn,3990322,7,1,0,1,0
7_3038769,succumb_boils_lubricity_haroset_uranus_saturn,3038769,7,1,0,1,0
7_5774068,succumb_boils_lubricity_tofu_saturn_earth,5774068,7,1,0,1,0
7_5345213,succumb_boils_lubricity_beef_vulcan_uranus,5345213,7,1,0,1,0
7_2442010,succumb_boils_lubricity_tofu_uranus_saturn,2442010,7,1,0,1,0
7_3585207,succumb_boils_lubricity_lamb_uranus_saturn,3585207,7,1,0,1,0
7_2557256,succumb_boils_lubricity_haroset_saturn_earth,2557256,7,1,0,1,0
7_2827055,succumb_boils_lubricity_wonderbread_uranus_saturn,2827055,7,1,0,1,0
7_5619303,succumb_boils_lubricity_wonderbread_saturn_earth,5619303,7,1,0,1,0
7_5640752,succumb_boils_lubricity_cantelope_vulcan_uranus,5640752,7,1,0,1,0
7_6474100,succumb_boils_lubricity_lemon_vulcan_uranus,6474100,7,1,0,1,0
7_7771449,overcome_grief_aesthetics_haroset_vulcan_uranus,7771449,7,1,0,1,0
7_2520195,overcome_grief_stimulation_haroset_uranus_saturn,2520195,7,1,0,1,0
7_4993028,overcome_grief_stimulation_haroset_saturn_earth,4993028,7,1,0,1,0
7_3941077,overcome_grief_aesthetics_haroset_uranus_saturn,3941077,7,1,0,1,0
7_7436376,overcome_grief_aesthetics_haroset_saturn_earth,7436376,7,1,0,1,0
7_4100075,overcome_grief_lubricity_haroset_vulcan_uranus,4100075,7,1,0,1,0
7_6669823,overcome_grief_entertainment_haroset_vulcan_uranus,6669823,7,1,0,1,0
7_6350567,overcome_grief_stimulation_haroset_vulcan_uranus,6350567,7,1,0,1,0
7_6859466,overcome_grief_lubricity_haroset_saturn_earth,6859466,7,1,0,1,0
7_2078856,overcome_grief_love_haroset_vulcan_uranus,2078856,7,1,0,1,0
7_269703,overcome_grief_lubricity_haroset_uranus_saturn,269703,7,1,0,1,0
7_5847386,overcome_abrasion_stimulation_tofu_vulcan_uranus,5847386,7,1,0,1,0
7_6344631,overcome_abrasion_lubricity_tofu_uranus_saturn,6344631,7,1,0,1,0
7_2174026,overcome_abrasion_lubricity_tofu_vulcan_uranus,2174026,7,1,0,1,0
7_4482222,overcome_abrasion_entertainment_tofu_vulcan_uranus,4482222,7,1,0,1,0
7_2017014,overcome_abrasion_stimulation_tofu_uranus_saturn,2017014,7,1,0,1,0
7_5383013,overcome_abrasion_lubricity_tofu_saturn_earth,5383013,7,1,0,1,0
7_1407409,overcome_abrasion_love_tofu_vulcan_uranus,1407409,7,1,0,1,0
7_4897301,overcome_abrasion_stimulation_tofu_saturn_earth,4897301,7,1,0,1,0
7_4088543,overcome_sciatica_stimulation_lamb_vulcan_uranus,4088543,7,1,0,1,0
7_130440,overcome_sciatica_lubricity_lamb_uranus_saturn,130440,7,1,0,1,0
7_5327485,overcome_sciatica_lubricity_lamb_saturn_earth,5327485,7,1,0,1,0
7_1233734,overcome_sciatica_stimulation_lamb_saturn_earth,1233734,7,1,0,1,0
7_258171,overcome_sciatica_stimulation_lamb_uranus_saturn,258171,7,1,0,1,0
7_2563469,overcome_sciatica_aesthetics_lamb_saturn_earth,2563469,7,1,0,1,0
7_3960812,overcome_sciatica_lubricity_lamb_vulcan_uranus,3960812,7,1,0,1,0
7_5546013,feast_entertainment_bacon_wonderbread_bavaria_manitoba,5546013,7,1,0,1,0
7_4744463,feast_entertainment_bacon_lobster_bavaria_manitoba,4744463,7,1,0,1,0
7_2247302,craves_entertainment_lobster,2247302,7,22,0,22,0
7_3853049,overcome_abrasion_stimulation_haroset_vulcan_uranus,3853049,7,1,0,1,0
7_2486199,overcome_boils_stimulation_lamb_vulcan_uranus,2486199,7,1,0,1,0
7_6151748,succumb_boils_stimulation_beef_uranus_saturn,6151748,7,1,0,1,0
7_6794898,succumb_abrasion_stimulation_flounder_uranus_saturn,6794898,7,1,0,1,0
7_393597,overcome_jealousy_stimulation_lemon_vulcan_uranus,393597,7,1,0,1,0
7_7138897,overcome_boils_stimulation_marzipan_vulcan_uranus,7138897,7,1,0,1,0
7_3527847,succumb_jealousy_stimulation_flounder_uranus_saturn,3527847,7,1,0,1,0
7_947696,overcome_jealousy_stimulation_ham_vulcan_uranus,947696,7,1,0,1,0
7_5144146,succumb_sciatica_stimulation_lobster_uranus_saturn,5144146,7,1,0,1,0
7_5757246,succumb_hangover_stimulation_wonderbread_uranus_saturn,5757246,7,1,0,1,0
7_4882795,succumb_abrasion_stimulation_wonderbread_uranus_saturn,4882795,7,1,0,1,0
7_5108144,overcome_laceration_stimulation_beef_vulcan_uranus,5108144,7,1,0,1,0
7_6670644,succumb_abrasion_stimulation_marzipan_uranus_saturn,6670644,7,1,0,1,0
7_3403593,succumb_jealousy_stimulation_marzipan_uranus_saturn,3403593,7,1,0,1,0
7_352742,overcome_grief_stimulation_lamb_vulcan_uranus,352742,7,1,0,1,0
7_7987342,succumb_abrasion_stimulation_haroset_uranus_saturn,7987342,7,1,0,1,0
7_1889941,overcome_hangover_stimulation_wonderbread_vulcan_uranus,1889941,7,1,0,1,0
7_7372641,overcome_angina_stimulation_ham_vulcan_uranus,7372641,7,1,0,1,0
7_1015490,overcome_abrasion_stimulation_wonderbread_vulcan_uranus,1015490,7,1,0,1,0
7_4158390,succumb_prostatitis_stimulation_beef_uranus_saturn,4158390,7,1,0,1,0
7_7461640,succumb_grief_stimulation_lobster_uranus_saturn,7461640,7,1,0,1,0
7_3194690,succumb_abrasion_stimulation_tofu_uranus_saturn,3194690,7,1,0,1,0
7_7627690,succumb_laceration_stimulation_wonderbread_uranus_saturn,7627690,7,1,0,1,0
7_6947189,overcome_depression_stimulation_wonderbread_vulcan_uranus,6947189,7,1,0,1,0
7_459688,overcome_anger_stimulation_ham_vulcan_uranus,459688,7,1,0,1,0
7_652137,overcome_jealousy_stimulation_flounder_vulcan_uranus,652137,7,1,0,1,0
7_7447787,overcome_jealousy_stimulation_lobster_vulcan_uranus,7447787,7,1,0,1,0
7_221137,succumb_boils_stimulation_lamb_uranus_saturn,221137,7,1,0,1,0
7_4337887,succumb_abrasion_stimulation_lamb_uranus_saturn,4337887,7,1,0,1,0
7_3273587,succumb_laceration_stimulation_flounder_uranus_saturn,3273587,7,1,0,1,0
7_2855386,overcome_laceration_stimulation_marzipan_vulcan_uranus,2855386,7,1,0,1,0
7_6042036,succumb_boils_stimulation_cantelope_uranus_saturn,6042036,7,1,0,1,0
7_4887786,succumb_jealousy_stimulation_beef_uranus_saturn,4887786,7,1,0,1,0
7_5209785,succumb_sciatica_stimulation_wonderbread_uranus_saturn,5209785,7,1,0,1,0
7_474885,succumb_depression_stimulation_wonderbread_uranus_saturn,474885,7,1,0,1,0
7_4955135,succumb_laceration_stimulation_tofu_uranus_saturn,4955135,7,1,0,1,0
7_3794934,overcome_abrasion_stimulation_marzipan_vulcan_uranus,3794934,7,1,0,1,0
7_3750134,succumb_abrasion_stimulation_lobster_uranus_saturn,3750134,7,1,0,1,0
7_527883,overcome_jealousy_stimulation_marzipan_vulcan_uranus,527883,7,1,0,1,0
7_949983,overcome_sciatica_stimulation_bacon_vulcan_uranus,949983,7,1,0,1,0
7_415833,overcome_boils_stimulation_beef_vulcan_uranus,415833,7,1,0,1,0
7_3309433,succumb_loneliness_stimulation_marzipan_uranus_saturn,3309433,7,1,0,1,0
7_3149333,succumb_laceration_stimulation_marzipan_uranus_saturn,3149333,7,1,0,1,0
7_7540482,overcome_jealousy_stimulation_beef_vulcan_uranus,7540482,7,1,0,1,0
7_2012132,succumb_jealousy_stimulation_lemon_uranus_saturn,2012132,7,1,0,1,0
7_118932,succumb_laceration_stimulation_ham_uranus_saturn,118932,7,1,0,1,0
7_6098332,succumb_laceration_stimulation_lamb_uranus_saturn,6098332,7,1,0,1,0
7_516981,succumb_prostatitis_stimulation_wonderbread_uranus_saturn,516981,7,1,0,1,0
7_6724730,overcome_laceration_stimulation_haroset_vulcan_uranus,6724730,7,1,0,1,0
7_1342480,overcome_sciatica_stimulation_wonderbread_vulcan_uranus,1342480,7,1,0,1,0
7_1380377,succumb_sciatica_stimulation_haroset_uranus_saturn,1380377,7,1,0,1,0
7_1518477,succumb_abrasion_stimulation_ham_uranus_saturn,1518477,7,1,0,1,0
7_3724375,overcome_grief_stimulation_ham_vulcan_uranus,3724375,7,1,0,1,0
7_1791275,overcome_laceration_stimulation_lemon_vulcan_uranus,1791275,7,1,0,1,0
7_7172225,overcome_abrasion_stimulation_cantelope_vulcan_uranus,7172225,7,1,0,1,0
7_2543575,succumb_laceration_stimulation_cantelope_uranus_saturn,2543575,7,1,0,1,0
7_5547324,succumb_boils_stimulation_lemon_uranus_saturn,5547324,7,1,0,1,0
7_6815623,overcome_grief_stimulation_wonderbread_vulcan_uranus,6815623,7,1,0,1,0
7_7442272,succumb_laceration_stimulation_haroset_uranus_saturn,7442272,7,1,0,1,0
7_1609871,overcome_jealousy_stimulation_lamb_vulcan_uranus,1609871,7,1,0,1,0
7_3697871,succumb_grief_stimulation_haroset_uranus_saturn,3697871,7,1,0,1,0
7_4824171,succumb_grief_stimulation_flounder_uranus_saturn,4824171,7,1,0,1,0
7_2267521,succumb_abrasion_stimulation_beef_uranus_saturn,2267521,7,1,0,1,0
7_4294670,overcome_prostatitis_stimulation_cantelope_vulcan_uranus,4294670,7,1,0,1,0
7_5642169,succumb_dread_stimulation_wonderbread_uranus_saturn,5642169,7,1,0,1,0
7_105669,succumb_jealousy_stimulation_bacon_uranus_saturn,105669,7,1,0,1,0
7_3684018,overcome_jealousy_stimulation_haroset_vulcan_uranus,3684018,7,1,0,1,0
7_2829268,succumb_prostatitis_stimulation_cantelope_uranus_saturn,2829268,7,1,0,1,0
7_2568518,succumb_sciatica_stimulation_bacon_uranus_saturn,2568518,7,1,0,1,0
7_5925568,succumb_laceration_stimulation_lemon_uranus_saturn,5925568,7,1,0,1,0
7_4702167,overcome_grief_stimulation_bacon_vulcan_uranus,4702167,7,1,0,1,0
7_4920217,overcome_abrasion_stimulation_beef_vulcan_uranus,4920217,7,1,0,1,0
7_747367,succumb_jealousy_stimulation_ham_uranus_saturn,747367,7,1,0,1,0
7_7889767,succumb_abrasion_stimulation_cantelope_uranus_saturn,7889767,7,1,0,1,0
7_951266,overcome_prostatitis_stimulation_tofu_vulcan_uranus,951266,7,1,0,1,0
7_4027966,succumb_laceration_stimulation_beef_uranus_saturn,4027966,7,1,0,1,0
7_6173515,overcome_angina_stimulation_lemon_vulcan_uranus,6173515,7,3,0,3,0
7_6913214,succumb_loneliness_stimulation_tofu_uranus_saturn,6913214,7,1,0,1,0
7_3205064,succumb_laceration_stimulation_lobster_uranus_saturn,3205064,7,1,0,1,0
7_6488111,overcome_jealousy_stimulation_bacon_vulcan_uranus,6488111,7,1,0,1,0
7_5247061,overcome_sciatica_stimulation_haroset_vulcan_uranus,5247061,7,1,0,1,0
7_7818311,succumb_jealousy_stimulation_haroset_uranus_saturn,7818311,7,1,0,1,0
7_5673461,succumb_jealousy_stimulation_wonderbread_uranus_saturn,5673461,7,1,0,1,0
7_7178510,overcome_laceration_stimulation_lamb_vulcan_uranus,7178510,7,1,0,1,0
7_6940560,succumb_boils_stimulation_ham_uranus_saturn,6940560,7,1,0,1,0
7_7744760,succumb_prostatitis_stimulation_marzipan_uranus_saturn,7744760,7,1,0,1,0
7_3306360,succumb_abrasion_stimulation_lemon_uranus_saturn,3306360,7,1,0,1,0
7_2113359,overcome_grief_stimulation_lobster_vulcan_uranus,2113359,7,1,0,1,0
7_2766459,overcome_dread_stimulation_wonderbread_vulcan_uranus,2766459,7,1,0,1,0
7_706209,overcome_boils_stimulation_lemon_vulcan_uranus,706209,7,1,0,1,0
7_880709,succumb_boils_stimulation_flounder_uranus_saturn,880709,7,1,0,1,0
7_5085559,succumb_prostatitis_stimulation_tofu_uranus_saturn,5085559,7,1,0,1,0
7_6088657,succumb_grief_stimulation_lamb_uranus_saturn,6088657,7,1,0,1,0
7_1806156,overcome_jealousy_stimulation_wonderbread_vulcan_uranus,1806156,7,1,0,1,0
7_6228756,succumb_prostatitis_stimulation_lamb_uranus_saturn,6228756,7,1,0,1,0
7_1690356,succumb_grief_stimulation_wonderbread_uranus_saturn,1690356,7,1,0,1,0
7_3877455,overcome_prostatitis_stimulation_marzipan_vulcan_uranus,3877455,7,1,0,1,0
7_6207355,overcome_anger_stimulation_lemon_vulcan_uranus,6207355,7,1,0,1,0
7_6135955,overcome_angina_stimulation_haroset_vulcan_uranus,6135955,7,1,0,1,0
7_3701455,overcome_boils_stimulation_ham_vulcan_uranus,3701455,7,1,0,1,0
7_756455,succumb_boils_stimulation_marzipan_uranus_saturn,756455,7,1,0,1,0
7_1542305,succumb_grief_stimulation_bacon_uranus_saturn,1542305,7,1,0,1,0
7_4019105,succumb_laceration_stimulation_bacon_uranus_saturn,4019105,7,1,0,1,0
7_7310204,succumb_prostatitis_stimulation_lemon_uranus_saturn,7310204,7,1,0,1,0
7_6283353,overcome_grief_stimulation_beef_vulcan_uranus,6283353,7,1,0,1,0
7_4271803,overcome_angina_stimulation_flounder_vulcan_uranus,4271803,7,1,0,1,0
7_1009853,overcome_sciatica_stimulation_lobster_vulcan_uranus,1009853,7,1,0,1,0
7_521953,overcome_boils_stimulation_haroset_vulcan_uranus,521953,7,1,0,1,0
7_3581103,succumb_jealousy_stimulation_lobster_uranus_saturn,3581103,7,1,0,1,0
7_1343002,overcome_boils_stimulation_tofu_vulcan_uranus,1343002,7,1,0,1,0
7_6958152,succumb_jealousy_stimulation_lamb_uranus_saturn,6958152,7,1,0,1,0
7_7263151,overcome_boils_stimulation_flounder_vulcan_uranus,7263151,7,1,0,1,0
7_598900,overcome_prostatitis_stimulation_wonderbread_vulcan_uranus,598900,7,1,0,1,0
7_5789489,harmony_stimulation_vulcan,5789489,7,9,0,9,0
7_794907,harmony_stimulation_earth,794907,7,3,0,3,0
7_218314,harmony_stimulation_saturn,218314,7,3,0,3,0
7_1863234,overcome_depression_learning_okra_saturn_earth,1863234,7,1,0,1,0
7_1390631,overcome_depression_learning_okra_uranus_saturn,1390631,7,1,0,1,0
7_5030028,overcome_depression_expectation_okra_vulcan_uranus,5030028,7,1,0,1,0
7_331051,overcome_depression_expectation_okra_saturn_earth,331051,7,1,0,1,0
7_7229304,succumb_prostatitis_entertainment_marzipan_vulcan_uranus,7229304,7,1,0,1,0
7_3477531,harmony_entertainment_uranus,3477531,7,13,0,13,0
7_5125653,craves_prostatitis_beef,5125653,7,15,0,15,0
7_2305583,overcome_angina_stimulation_haroset_uranus_saturn,2305583,7,1,0,1,0
7_6060432,overcome_angina_love_haroset_vulcan_uranus,6060432,7,1,0,1,0
7_5617266,overcome_angina_stimulation_haroset_saturn_earth,5617266,7,1,0,1,0
7_4565315,overcome_angina_aesthetics_haroset_uranus_saturn,4565315,7,1,0,1,0
7_7001261,overcome_angina_aesthetics_haroset_saturn_earth,7001261,7,1,0,1,0
7_394710,overcome_angina_aesthetics_haroset_vulcan_uranus,394710,7,1,0,1,0
7_7575357,overcome_angina_entertainment_haroset_vulcan_uranus,7575357,7,1,0,1,0
7_4701253,overcome_angina_lubricity_haroset_saturn_earth,4701253,7,1,0,1,0
7_6194395,overcome_anger_lubricity_ham_saturn_earth,6194395,7,1,0,1,0
7_4630293,overcome_anger_stimulation_ham_uranus_saturn,4630293,7,1,0,1,0
7_2611343,overcome_anger_love_ham_vulcan_uranus,2611343,7,1,0,1,0
7_247238,overcome_anger_aesthetics_ham_saturn_earth,247238,7,1,0,1,0
7_5607927,overcome_anger_entertainment_ham_vulcan_uranus,5607927,7,1,0,1,0
7_5438824,overcome_anger_stimulation_ham_saturn_earth,5438824,7,1,0,1,0
7_6033021,overcome_anger_lubricity_ham_uranus_saturn,6033021,7,1,0,1,0
7_1862416,overcome_anger_lubricity_ham_vulcan_uranus,1862416,7,1,0,1,0
7_3746459,overcome_anger_aesthetics_ham_uranus_saturn,3746459,7,1,0,1,0
7_6662125,succumb_hangover_stimulation_wonderbread_saturn_earth,6662125,7,1,0,1,0
7_7821209,succumb_hangover_stimulation_onion_saturn_earth,7821209,7,1,0,1,0
7_478591,fears_hangover_expectation,478591,7,10,0,10,0
7_1141187,craves_stimulation_lemon,1141187,7,24,0,24,0
7_1447385,craves_stimulation_ham,1447385,7,24,0,24,0
7_1750334,craves_hangover_snickers,1750334,7,10,0,10,0
7_7695533,craves_stimulation_haroset,7695533,7,22,0,22,0
7_6919532,fears_hangover_achievement,6919532,7,10,0,10,0
7_3848180,craves_hangover_onion,3848180,7,10,0,10,0
7_2802576,fears_hangover_learning,2802576,7,10,0,10,0
7_4681374,craves_hangover_wonderbread,4681374,7,10,0,10,0
7_6095221,craves_stimulation_beef,6095221,7,22,0,22,0
7_6484069,craves_stimulation_cantelope,6484069,7,23,0,23,0
7_2314717,craves_stimulation_flounder,2314717,7,24,0,24,0
7_2633557,craves_hangover_okra,2633557,7,10,0,10,0
7_3353748,succumb_dread_achievement_wonderbread_uranus_saturn,3353748,7,1,0,1,0
7_2964786,succumb_dread_achievement_wonderbread_saturn_earth,2964786,7,1,0,1,0
7_7184120,succumb_dread_achievement_wonderbread_vulcan_uranus,7184120,7,1,0,1,0
7_150287,fears_dread_learning,150287,7,14,0,14,0
7_688965,fears_dread_expectation,688965,7,12,0,12,0
7_7952859,craves_dread_wonderbread,7952859,7,7,0,7,0
7_1482738,feast_love_bacon_lobster_bavaria_manitoba,1482738,7,1,0,1,0
7_2482178,feast_love_bacon_wonderbread_bavaria_manitoba,2482178,7,1,0,1,0
7_2843491,overcome_hangover_expectation_okra_saturn_earth,2843491,7,1,0,1,0
7_4921137,overcome_hangover_learning_okra_saturn_earth,4921137,7,1,0,1,0
7_135531,overcome_hangover_expectation_okra_vulcan_uranus,135531,7,1,0,1,0
7_118053,overcome_hangover_learning_okra_uranus_saturn,118053,7,1,0,1,0
7_3867199,overcome_angina_stimulation_lemon_saturn_earth,3867199,7,1,0,1,0
7_2367148,overcome_anger_stimulation_lemon_saturn_earth,2367148,7,1,0,1,0
7_4634146,overcome_laceration_stimulation_lobster_saturn_earth,4634146,7,1,0,1,0
7_4628145,overcome_prostatitis_stimulation_tofu_saturn_earth,4628145,7,1,0,1,0
7_7190944,overcome_jealousy_stimulation_ham_saturn_earth,7190944,7,1,0,1,0
7_6872543,overcome_jealousy_stimulation_lobster_saturn_earth,6872543,7,1,0,1,0
7_1265793,overcome_prostatitis_stimulation_cantelope_saturn_earth,1265793,7,1,0,1,0
7_359343,overcome_angina_stimulation_flounder_saturn_earth,359343,7,1,0,1,0
7_1482342,overcome_grief_stimulation_ham_saturn_earth,1482342,7,1,0,1,0
7_1678892,overcome_laceration_stimulation_tofu_saturn_earth,1678892,7,1,0,1,0
7_157892,overcome_boils_stimulation_lemon_saturn_earth,157892,7,1,0,1,0
7_6430441,overcome_grief_stimulation_beef_saturn_earth,6430441,7,1,0,1,0
7_4311441,overcome_laceration_stimulation_bacon_saturn_earth,4311441,7,1,0,1,0
7_7282541,overcome_jealousy_stimulation_lemon_saturn_earth,7282541,7,1,0,1,0
7_5845390,overcome_jealousy_stimulation_marzipan_saturn_earth,5845390,7,1,0,1,0
7_1420337,overcome_abrasion_stimulation_haroset_saturn_earth,1420337,7,1,0,1,0
7_6501036,overcome_grief_stimulation_lamb_saturn_earth,6501036,7,1,0,1,0
7_5908383,overcome_jealousy_stimulation_flounder_saturn_earth,5908383,7,1,0,1,0
7_6643533,overcome_hangover_stimulation_onion_saturn_earth,6643533,7,1,0,1,0
7_3557683,overcome_depression_stimulation_wonderbread_saturn_earth,3557683,7,1,0,1,0
7_1732283,overcome_boils_stimulation_ham_saturn_earth,1732283,7,1,0,1,0
7_6743779,overcome_jealousy_stimulation_bacon_saturn_earth,6743779,7,1,0,1,0
7_2184177,overcome_angina_stimulation_ham_saturn_earth,2184177,7,1,0,1,0
7_885125,overcome_laceration_stimulation_marzipan_saturn_earth,885125,7,1,0,1,0
7_2683325,overcome_boils_stimulation_marzipan_saturn_earth,2683325,7,1,0,1,0
7_243724,overcome_laceration_stimulation_cantelope_saturn_earth,243724,7,1,0,1,0
7_1774474,overcome_laceration_stimulation_ham_saturn_earth,1774474,7,1,0,1,0
7_1221474,overcome_sciatica_stimulation_bacon_saturn_earth,1221474,7,1,0,1,0
7_5064322,overcome_prostatitis_stimulation_wonderbread_saturn_earth,5064322,7,1,0,1,0
7_4424872,overcome_abrasion_stimulation_beef_saturn_earth,4424872,7,1,0,1,0
7_1183272,overcome_abrasion_stimulation_cantelope_saturn_earth,1183272,7,1,0,1,0
7_6014421,overcome_abrasion_stimulation_marzipan_saturn_earth,6014421,7,1,0,1,0
7_6407521,overcome_boils_stimulation_beef_saturn_earth,6407521,7,1,0,1,0
7_5726568,overcome_grief_stimulation_lobster_saturn_earth,5726568,7,1,0,1,0
7_948118,overcome_laceration_stimulation_flounder_saturn_earth,948118,7,1,0,1,0
7_5628518,overcome_abrasion_stimulation_wonderbread_saturn_earth,5628518,7,1,0,1,0
7_2746318,overcome_boils_stimulation_flounder_saturn_earth,2746318,7,1,0,1,0
7_6478116,overcome_boils_stimulation_lamb_saturn_earth,6478116,7,1,0,1,0
7_6192364,overcome_sciatica_stimulation_wonderbread_saturn_earth,6192364,7,1,0,1,0
7_4551164,overcome_sciatica_stimulation_haroset_saturn_earth,4551164,7,1,0,1,0
7_1206463,overcome_laceration_stimulation_beef_saturn_earth,1206463,7,1,0,1,0
7_3653762,overcome_jealousy_stimulation_beef_saturn_earth,3653762,7,1,0,1,0
7_7995211,overcome_grief_stimulation_wonderbread_saturn_earth,7995211,7,1,0,1,0
7_5733459,overcome_prostatitis_stimulation_marzipan_saturn_earth,5733459,7,1,0,1,0
7_1277058,overcome_laceration_stimulation_lamb_saturn_earth,1277058,7,1,0,1,0
7_3724357,overcome_jealousy_stimulation_lamb_saturn_earth,3724357,7,1,0,1,0
7_2353707,overcome_dread_stimulation_wonderbread_saturn_earth,2353707,7,1,0,1,0
7_3900606,overcome_laceration_stimulation_haroset_saturn_earth,3900606,7,1,0,1,0
7_2537806,overcome_hangover_stimulation_wonderbread_saturn_earth,2537806,7,1,0,1,0
7_4714755,overcome_anxiety_stimulation_onion_saturn_earth,4714755,7,1,0,1,0
7_6157905,overcome_boils_stimulation_haroset_saturn_earth,6157905,7,1,0,1,0
7_5284704,overcome_sciatica_stimulation_lobster_saturn_earth,5284704,7,1,0,1,0
7_4850203,overcome_laceration_stimulation_lemon_saturn_earth,4850203,7,1,0,1,0
7_6139003,overcome_jealousy_stimulation_haroset_saturn_earth,6139003,7,1,0,1,0
7_3537053,overcome_depression_stimulation_onion_saturn_earth,3537053,7,1,0,1,0
7_2318702,overcome_jealousy_stimulation_wonderbread_saturn_earth,2318702,7,1,0,1,0
7_5486650,overcome_grief_stimulation_bacon_saturn_earth,5486650,7,1,0,1,0
7_6879950,overcome_boils_stimulation_tofu_saturn_earth,6879950,7,1,0,1,0
7_1293205,harmony_stimulation_uranus,1293205,7,7,0,7,0
7_871795,overcome_grief_stimulation_bacon_uranus_saturn,871795,7,1,0,1,0
7_4086635,overcome_grief_aesthetics_bacon_vulcan_uranus,4086635,7,1,0,1,0
7_4927284,overcome_grief_lubricity_bacon_saturn_earth,4927284,7,1,0,1,0
7_4839884,overcome_grief_entertainment_bacon_vulcan_uranus,4839884,7,1,0,1,0
7_2858925,overcome_grief_aesthetics_bacon_saturn_earth,2858925,7,1,0,1,0
7_256263,overcome_grief_aesthetics_bacon_uranus_saturn,256263,7,1,0,1,0
7_1613712,overcome_grief_love_bacon_vulcan_uranus,1613712,7,1,0,1,0
7_3520096,succumb_abrasion_aesthetics_lamb_uranus_saturn,3520096,7,1,0,1,0
7_2519795,succumb_abrasion_aesthetics_beef_saturn_earth,2519795,7,1,0,1,0
7_2590390,succumb_abrasion_aesthetics_lamb_saturn_earth,2590390,7,1,0,1,0
7_343821,succumb_anxiety_stimulation_onion_saturn_earth,343821,7,1,0,1,0
7_4705793,overcome_prostatitis_expectation_wonderbread_saturn_earth,4705793,7,1,0,1,0
7_5269989,overcome_abrasion_expectation_wonderbread_saturn_earth,5269989,7,1,0,1,0
7_5833835,overcome_sciatica_expectation_wonderbread_saturn_earth,5833835,7,1,0,1,0
7_813984,overcome_anxiety_expectation_onion_saturn_earth,813984,7,1,0,1,0
7_7636682,overcome_grief_expectation_wonderbread_saturn_earth,7636682,7,1,0,1,0
7_1995178,overcome_dread_expectation_wonderbread_saturn_earth,1995178,7,1,0,1,0
7_2179277,overcome_hangover_expectation_wonderbread_saturn_earth,2179277,7,1,0,1,0
7_5974976,overcome_depression_expectation_snickers_saturn_earth,5974976,7,1,0,1,0
7_1960173,overcome_jealousy_expectation_wonderbread_saturn_earth,1960173,7,1,0,1,0
7_2742762,overcome_hangover_expectation_onion_saturn_earth,2742762,7,1,0,1,0
7_7637259,overcome_depression_expectation_onion_saturn_earth,7637259,7,1,0,1,0
7_3199154,overcome_depression_expectation_wonderbread_saturn_earth,3199154,7,1,0,1,0
7_7790851,overcome_hangover_expectation_snickers_saturn_earth,7790851,7,1,0,1,0
7_1891404,harmony_expectation_saturn,1891404,7,2,0,2,0
7_4842398,overcome_abrasion_lubricity_cantelope_saturn_earth,4842398,7,1,0,1,0
7_7381388,overcome_abrasion_love_cantelope_vulcan_uranus,7381388,7,1,0,1,0
7_7794172,overcome_abrasion_lubricity_cantelope_vulcan_uranus,7794172,7,1,0,1,0
7_2931612,overcome_abrasion_entertainment_cantelope_vulcan_uranus,2931612,7,1,0,1,0
7_3341853,overcome_abrasion_stimulation_cantelope_uranus_saturn,3341853,7,1,0,1,0
7_3963800,overcome_abrasion_lubricity_cantelope_uranus_saturn,3963800,7,1,0,1,0
7_5633593,overcome_boils_entertainment_marzipan_vulcan_uranus,5633593,7,1,0,1,0
7_360279,overcome_boils_lubricity_marzipan_uranus_saturn,360279,7,1,0,1,0
7_3501678,overcome_boils_love_marzipan_vulcan_uranus,3501678,7,1,0,1,0
7_359026,overcome_boils_lubricity_marzipan_saturn_earth,359026,7,1,0,1,0
7_3308525,overcome_boils_stimulation_marzipan_uranus_saturn,3308525,7,1,0,1,0
7_3096721,overcome_boils_aesthetics_marzipan_saturn_earth,3096721,7,1,0,1,0
7_4523347,overcome_grief_stimulation_lamb_uranus_saturn,4523347,7,1,0,1,0
7_7686496,overcome_grief_lubricity_lamb_saturn_earth,7686496,7,1,0,1,0
7_5725994,overcome_grief_aesthetics_lamb_vulcan_uranus,5725994,7,1,0,1,0
7_1197133,overcome_grief_entertainment_lamb_vulcan_uranus,1197133,7,1,0,1,0
7_3963981,overcome_grief_lubricity_lamb_uranus_saturn,3963981,7,1,0,1,0
7_1895622,overcome_grief_aesthetics_lamb_uranus_saturn,1895622,7,1,0,1,0
7_6397010,overcome_grief_aesthetics_lamb_saturn_earth,6397010,7,1,0,1,0
7_7794353,overcome_grief_lubricity_lamb_vulcan_uranus,7794353,7,1,0,1,0
7_3578699,feast_entertainment_marzipan_tofu_pennsylvania_oregon,3578699,7,1,0,1,0
7_5864098,feast_entertainment_marzipan_cantelope_manitoba_pennsylvania,5864098,7,1,0,1,0
7_382898,feast_entertainment_marzipan_beef_manitoba_pennsylvania,382898,7,1,0,1,0
7_1109948,feast_entertainment_marzipan_beef_pennsylvania_oregon,1109948,7,1,0,1,0
7_1111985,feast_entertainment_marzipan_cantelope_pennsylvania_oregon,1111985,7,1,0,1,0
7_7722281,feast_entertainment_marzipan_wonderbread_manitoba_pennsylvania,7722281,7,1,0,1,0
7_4836223,feast_entertainment_marzipan_wonderbread_pennsylvania_oregon,4836223,7,1,0,1,0
7_4692517,feast_entertainment_marzipan_tofu_manitoba_pennsylvania,4692517,7,1,0,1,0
7_7061695,feast_stimulation_marzipan_wonderbread_pennsylvania_oregon,7061695,7,1,0,1,0
7_88593,feast_stimulation_marzipan_cantelope_manitoba_pennsylvania,88593,7,1,0,1,0
7_6445540,feast_stimulation_marzipan_wonderbread_manitoba_pennsylvania,6445540,7,1,0,1,0
7_3873239,feast_stimulation_marzipan_tofu_pennsylvania_oregon,3873239,7,1,0,1,0
7_1404488,feast_stimulation_marzipan_beef_pennsylvania_oregon,1404488,7,1,0,1,0
7_4999814,feast_stimulation_marzipan_beef_manitoba_pennsylvania,4999814,7,1,0,1,0
7_3573257,feast_stimulation_marzipan_cantelope_pennsylvania_oregon,3573257,7,1,0,1,0
7_1308456,feast_stimulation_marzipan_tofu_manitoba_pennsylvania,1308456,7,1,0,1,0
7_3962347,harmony_achievement_earth,3962347,7,8,0,8,0
7_2984277,harmony_achievement_saturn,2984277,7,7,0,7,0
7_4844127,succumb_hangover_aesthetics_wonderbread_vulcan_uranus,4844127,7,1,0,1,0
7_5237174,succumb_hangover_aesthetics_wonderbread_saturn_earth,5237174,7,1,0,1,0
7_1013755,succumb_hangover_aesthetics_wonderbread_uranus_saturn,1013755,7,1,0,1,0
7_5715987,overcome_boils_lubricity_lemon_saturn_earth,5715987,7,1,0,1,0
7_917733,overcome_boils_entertainment_lemon_vulcan_uranus,917733,7,1,0,1,0
7_3575228,overcome_boils_lubricity_lemon_uranus_saturn,3575228,7,1,0,1,0
7_5027470,overcome_boils_love_lemon_vulcan_uranus,5027470,7,1,0,1,0
7_3374767,overcome_boils_aesthetics_lemon_saturn_earth,3374767,7,1,0,1,0
7_4876814,overcome_boils_stimulation_lemon_uranus_saturn,4876814,7,1,0,1,0
7_7405600,overcome_boils_lubricity_lemon_vulcan_uranus,7405600,7,1,0,1,0
7_4648643,overcome_dread_achievement_wonderbread_uranus_saturn,4648643,7,1,0,1,0
7_6288488,overcome_dread_lubricity_wonderbread_vulcan_uranus,6288488,7,1,0,1,0
7_478038,overcome_dread_achievement_wonderbread_vulcan_uranus,478038,7,1,0,1,0
7_7461837,overcome_dread_lubricity_wonderbread_saturn_earth,7461837,7,1,0,1,0
7_5285237,overcome_dread_learning_wonderbread_uranus_saturn,5285237,7,1,0,1,0
7_2643175,overcome_dread_love_wonderbread_vulcan_uranus,2643175,7,1,0,1,0
7_6282974,overcome_dread_aesthetics_wonderbread_saturn_earth,6282974,7,1,0,1,0
7_3630267,overcome_dread_entertainment_wonderbread_vulcan_uranus,3630267,7,1,0,1,0
7_2458116,overcome_dread_lubricity_wonderbread_uranus_saturn,2458116,7,1,0,1,0
7_2441016,overcome_dread_learning_wonderbread_saturn_earth,2441016,7,1,0,1,0
7_4706314,overcome_dread_aesthetics_wonderbread_uranus_saturn,4706314,7,1,0,1,0
7_6937064,overcome_dread_stimulation_wonderbread_uranus_saturn,6937064,7,1,0,1,0
7_535709,overcome_dread_aesthetics_wonderbread_vulcan_uranus,535709,7,1,0,1,0
7_6994759,overcome_dread_expectation_wonderbread_vulcan_uranus,6994759,7,1,0,1,0
7_7129906,fears_dread_achievement,7129906,7,7,0,7,0
7_5661286,feast_love_lamb_haroset_oregon_goias,5661286,7,1,0,1,0
7_7478636,feast_love_lamb_beef_goias_bosnia,7478636,7,1,0,1,0
7_5016585,feast_love_lamb_beef_oregon_goias,5016585,7,1,0,1,0
7_2040829,feast_love_lamb_haroset_bavaria_manitoba,2040829,7,1,0,1,0
7_3565718,feast_love_lamb_haroset_pennsylvania_oregon,3565718,7,1,0,1,0
7_2073263,feast_love_lamb_haroset_manitoba_pennsylvania,2073263,7,1,0,1,0
7_122360,feast_love_lamb_haroset_goias_bosnia,122360,7,1,0,1,0
7_2475506,feast_love_lamb_beef_bavaria_manitoba,2475506,7,1,0,1,0
7_6976806,feast_love_lamb_beef_pennsylvania_oregon,6976806,7,1,0,1,0
7_3839051,feast_love_lamb_beef_manitoba_pennsylvania,3839051,7,1,0,1,0
7_1631598,feast_lubricity_marzipan_wonderbread_manitoba_pennsylvania,1631598,7,1,0,1,0
7_3304294,feast_lubricity_marzipan_cantelope_pennsylvania_oregon,3304294,7,1,0,1,0
7_5379035,feast_lubricity_marzipan_beef_manitoba_pennsylvania,5379035,7,1,0,1,0
7_7482733,feast_lubricity_marzipan_cantelope_manitoba_pennsylvania,7482733,7,1,0,1,0
7_1687677,feast_lubricity_marzipan_tofu_manitoba_pennsylvania,1687677,7,1,0,1,0
7_614424,feast_lubricity_marzipan_tofu_pennsylvania_oregon,614424,7,1,0,1,0
7_6454858,feast_lubricity_marzipan_wonderbread_pennsylvania_oregon,6454858,7,1,0,1,0
7_6146650,feast_lubricity_marzipan_beef_pennsylvania_oregon,6146650,7,1,0,1,0
7_7840197,succumb_hangover_learning_snickers_saturn_earth,7840197,7,1,0,1,0
7_321444,overcome_anxiety_learning_onion_uranus_saturn,321444,7,1,0,1,0
7_7474894,overcome_sciatica_learning_wonderbread_uranus_saturn,7474894,7,1,0,1,0
7_2533744,succumb_depression_learning_okra_saturn_earth,2533744,7,1,0,1,0
7_3618692,succumb_dread_learning_wonderbread_saturn_earth,3618692,7,1,0,1,0
7_5586892,succumb_hangover_learning_wonderbread_saturn_earth,5586892,7,1,0,1,0
7_119989,succumb_hangover_learning_onion_saturn_earth,119989,7,1,0,1,0
7_3989637,succumb_hangover_learning_okra_saturn_earth,3989637,7,1,0,1,0
7_7384736,overcome_jealousy_learning_wonderbread_uranus_saturn,7384736,7,1,0,1,0
7_6306235,succumb_depression_learning_snickers_saturn_earth,6306235,7,1,0,1,0
7_2733331,overcome_prostatitis_learning_wonderbread_uranus_saturn,2733331,7,1,0,1,0
7_1521380,succumb_anxiety_learning_onion_saturn_earth,1521380,7,1,0,1,0
7_3018377,overcome_depression_learning_wonderbread_uranus_saturn,3018377,7,1,0,1,0
7_244024,overcome_depression_learning_onion_uranus_saturn,244024,7,1,0,1,0
7_2131973,succumb_sciatica_learning_wonderbread_saturn_earth,2131973,7,1,0,1,0
7_5858622,overcome_hangover_learning_snickers_uranus_saturn,5858622,7,1,0,1,0
7_354266,succumb_depression_learning_wonderbread_saturn_earth,354266,7,1,0,1,0
7_2696465,overcome_depression_learning_snickers_uranus_saturn,2696465,7,1,0,1,0
7_3825711,overcome_hangover_learning_wonderbread_uranus_saturn,3825711,7,1,0,1,0
7_2650810,overcome_abrasion_learning_wonderbread_uranus_saturn,2650810,7,1,0,1,0
7_1937258,overcome_grief_learning_wonderbread_uranus_saturn,1937258,7,1,0,1,0
7_3457300,succumb_depression_learning_onion_saturn_earth,3457300,7,1,0,1,0
7_2297701,harmony_learning_uranus,2297701,7,2,0,2,0
7_7127799,succumb_laceration_stimulation_tofu_saturn_earth,7127799,7,1,0,1,0
7_7600397,succumb_laceration_stimulation_lemon_saturn_earth,7600397,7,1,0,1,0
7_4368043,succumb_laceration_stimulation_cantelope_saturn_earth,4368043,7,1,0,1,0
7_1705289,succumb_laceration_stimulation_onion_saturn_earth,1705289,7,1,0,1,0
7_5433039,succumb_laceration_stimulation_marzipan_saturn_earth,5433039,7,1,0,1,0
7_7858338,succumb_laceration_stimulation_beef_vulcan_uranus,7858338,7,1,0,1,0
7_7035436,succumb_laceration_stimulation_lobster_vulcan_uranus,7035436,7,1,0,1,0
7_7061635,succumb_laceration_stimulation_bacon_saturn_earth,7061635,7,1,0,1,0
7_5496032,succumb_laceration_stimulation_flounder_saturn_earth,5496032,7,1,0,1,0
7_1927727,succumb_laceration_stimulation_lamb_vulcan_uranus,1927727,7,1,0,1,0
7_1293775,succumb_laceration_stimulation_wonderbread_saturn_earth,1293775,7,1,0,1,0
7_6655370,succumb_laceration_stimulation_beef_saturn_earth,6655370,7,1,0,1,0
7_3271667,succumb_laceration_stimulation_haroset_vulcan_uranus,3271667,7,1,0,1,0
7_6725965,succumb_laceration_stimulation_lamb_saturn_earth,6725965,7,1,0,1,0
7_1754963,succumb_laceration_stimulation_lemon_vulcan_uranus,1754963,7,1,0,1,0
7_2605711,succumb_laceration_stimulation_haroset_saturn_earth,2605711,7,1,0,1,0
7_7103959,succumb_laceration_stimulation_flounder_vulcan_uranus,7103959,7,1,0,1,0
7_6979705,succumb_laceration_stimulation_marzipan_vulcan_uranus,6979705,7,1,0,1,0
7_3339251,succumb_laceration_stimulation_lobster_saturn_earth,3339251,7,1,0,1,0
7_2952150,succumb_laceration_stimulation_ham_saturn_earth,2952150,7,1,0,1,0
7_3070140,feast_aesthetics_lamb_haroset_oregon_goias,3070140,7,1,0,1,0
7_1075334,feast_lubricity_lamb_haroset_oregon_goias,1075334,7,1,0,1,0
7_2708932,feast_stimulation_lamb_beef_oregon_goias,2708932,7,1,0,1,0
7_1685627,feast_entertainment_lamb_beef_oregon_goias,1685627,7,1,0,1,0
7_3081722,feast_aesthetics_lamb_beef_oregon_goias,3081722,7,1,0,1,0
7_3218010,feast_lubricity_lamb_beef_oregon_goias,3218010,7,1,0,1,0
7_4440354,feast_stimulation_lamb_haroset_oregon_goias,4440354,7,1,0,1,0
7_3832902,feast_entertainment_lamb_haroset_oregon_goias,3832902,7,1,0,1,0
7_7957589,locale_lamb_manitoba,7957589,7,4,0,4,0
7_7086086,locale_lamb_pennsylvania,7086086,7,4,0,4,0
7_7037277,locale_lamb_oregon,7037277,7,4,0,4,0
7_71424,locale_lamb_bavaria,71424,7,4,0,4,0
7_2814490,harmony_aesthetics_saturn,2814490,7,6,0,6,0
7_6292230,harmony_lubricity_saturn,6292230,7,6,0,6,0
7_5323336,locale_ham_manitoba,5323336,7,4,0,4,0
7_7946530,locale_ham_pennsylvania,7946530,7,4,0,4,0
7_2114526,locale_ham_bosnia,2114526,7,4,0,4,0
7_7012217,locale_flounder_oregon,7012217,7,4,0,4,0
7_157616,locale_ham_goias,157616,7,4,0,4,0
7_3895862,locale_ham_oregon,3895862,7,4,0,4,0
7_1089845,overcome_abrasion_stimulation_beef_uranus_saturn,1089845,7,1,0,1,0
7_480240,overcome_abrasion_love_beef_vulcan_uranus,480240,7,1,0,1,0
7_1849285,overcome_abrasion_aesthetics_beef_saturn_earth,1849285,7,1,0,1,0
7_4910584,overcome_abrasion_lubricity_beef_saturn_earth,4910584,7,1,0,1,0
7_5820664,overcome_abrasion_aesthetics_beef_uranus_saturn,5820664,7,1,0,1,0
7_5417462,overcome_abrasion_lubricity_beef_uranus_saturn,5417462,7,1,0,1,0
7_1246857,overcome_abrasion_lubricity_beef_vulcan_uranus,1246857,7,1,0,1,0
7_3555053,overcome_abrasion_entertainment_beef_vulcan_uranus,3555053,7,1,0,1,0
7_6870948,feast_love_beef_lemon_bavaria_manitoba,6870948,7,1,0,1,0
7_6915697,feast_lubricity_beef_lamb_bavaria_manitoba,6915697,7,1,0,1,0
7_7253147,feast_entertainment_beef_marzipan_bavaria_manitoba,7253147,7,1,0,1,0
7_1641396,feast_stimulation_beef_lemon_bavaria_manitoba,1641396,7,1,0,1,0
7_2116192,feast_stimulation_beef_marzipan_bavaria_manitoba,2116192,7,1,0,1,0
7_6262540,feast_aesthetics_beef_lemon_bavaria_manitoba,6262540,7,1,0,1,0
7_4775790,feast_love_beef_lamb_bavaria_manitoba,4775790,7,1,0,1,0
7_1984630,feast_aesthetics_beef_marzipan_bavaria_manitoba,1984630,7,1,0,1,0
7_2619727,feast_lubricity_beef_lemon_bavaria_manitoba,2619727,7,1,0,1,0
7_4528676,feast_entertainment_beef_lemon_bavaria_manitoba,4528676,7,1,0,1,0
7_4348222,feast_lubricity_beef_marzipan_bavaria_manitoba,4348222,7,1,0,1,0
7_3991422,feast_love_beef_marzipan_bavaria_manitoba,3991422,7,1,0,1,0
7_5523505,feast_aesthetics_beef_lamb_bavaria_manitoba,5523505,7,1,0,1,0
7_766152,feast_entertainment_beef_lamb_bavaria_manitoba,766152,7,1,0,1,0
7_4255301,feast_stimulation_beef_lamb_bavaria_manitoba,4255301,7,1,0,1,0
7_7015491,locale_beef_pennsylvania,7015491,7,2,0,2,0
7_5689671,locale_beef_bavaria,5689671,7,2,0,2,0
7_5918656,succumb_grief_expectation_wonderbread_uranus_saturn,5918656,7,1,0,1,0
7_1748051,succumb_grief_expectation_wonderbread_vulcan_uranus,1748051,7,1,0,1,0
7_4480297,overcome_jealousy_love_lemon_vulcan_uranus,4480297,7,1,0,1,0
7_4651841,overcome_jealousy_lubricity_lemon_vulcan_uranus,4651841,7,1,0,1,0
7_3173671,overcome_jealousy_lubricity_lemon_saturn_earth,3173671,7,1,0,1,0
7_821469,overcome_jealousy_lubricity_lemon_uranus_saturn,821469,7,1,0,1,0
7_4564202,overcome_jealousy_stimulation_lemon_uranus_saturn,4564202,7,1,0,1,0
7_7973815,harmony_entertainment_vulcan,7973815,7,3,0,3,0
7_2567359,succumb_depression_love_wonderbread_vulcan_uranus,2567359,7,1,0,1,0
7_7109798,feast_love_ham_lemon_pennsylvania_oregon,7109798,7,1,0,1,0
7_7417196,feast_love_ham_flounder_pennsylvania_oregon,7417196,7,1,0,1,0
7_5724287,feast_entertainment_ham_flounder_pennsylvania_oregon,5724287,7,1,0,1,0
7_7350636,feast_stimulation_ham_flounder_pennsylvania_oregon,7350636,7,1,0,1,0
7_3806225,feast_lubricity_ham_flounder_pennsylvania_oregon,3806225,7,1,0,1,0
7_5039721,feast_stimulation_ham_lemon_pennsylvania_oregon,5039721,7,1,0,1,0
7_1110459,feast_lubricity_ham_lemon_pennsylvania_oregon,1110459,7,1,0,1,0
7_2715751,feast_entertainment_ham_lemon_pennsylvania_oregon,2715751,7,1,0,1,0
7_1067745,feast_love_lemon_cantelope_bavaria_manitoba,1067745,7,1,0,1,0
7_4815740,feast_love_lemon_ham_bavaria_manitoba,4815740,7,1,0,1,0
7_6581411,feast_love_lemon_beef_bavaria_manitoba,6581411,7,1,0,1,0
7_2212255,succumb_anxiety_lubricity_onion_saturn_earth,2212255,7,1,0,1,0
7_4944137,harmony_lubricity_earth,4944137,7,3,0,3,0
7_7704846,overcome_grief_aesthetics_lobster_uranus_saturn,7704846,7,1,0,1,0
7_3534241,overcome_grief_aesthetics_lobster_vulcan_uranus,3534241,7,1,0,1,0
7_168939,overcome_grief_aesthetics_lobster_saturn_earth,168939,7,1,0,1,0
7_5842625,overcome_grief_love_lobster_vulcan_uranus,5842625,7,1,0,1,0
7_4033472,overcome_grief_lubricity_lobster_uranus_saturn,4033472,7,1,0,1,0
7_2432615,overcome_grief_entertainment_lobster_vulcan_uranus,2432615,7,1,0,1,0
7_6283964,overcome_grief_stimulation_lobster_uranus_saturn,6283964,7,1,0,1,0
7_7593006,overcome_grief_lubricity_lobster_saturn_earth,7593006,7,1,0,1,0
7_4889090,succumb_grief_entertainment_flounder_vulcan_uranus,4889090,7,1,0,1,0
7_1419040,succumb_grief_entertainment_haroset_vulcan_uranus,1419040,7,1,0,1,0
7_4764836,succumb_grief_entertainment_marzipan_vulcan_uranus,4764836,7,1,0,1,0
7_5362331,succumb_grief_entertainment_wonderbread_vulcan_uranus,5362331,7,1,0,1,0
7_4827176,succumb_grief_entertainment_lamb_vulcan_uranus,4827176,7,1,0,1,0
7_7924023,succumb_grief_entertainment_lemon_vulcan_uranus,7924023,7,1,0,1,0
7_6679712,succumb_grief_entertainment_ham_vulcan_uranus,6679712,7,1,0,1,0
7_2756810,succumb_grief_entertainment_beef_vulcan_uranus,2756810,7,1,0,1,0
7_6017560,succumb_grief_entertainment_bacon_vulcan_uranus,6017560,7,1,0,1,0
7_5182809,succumb_grief_entertainment_lobster_vulcan_uranus,5182809,7,1,0,1,0
7_7283697,overcome_laceration_lubricity_haroset_vulcan_uranus,7283697,7,1,0,1,0
7_4821686,overcome_laceration_entertainment_haroset_vulcan_uranus,4821686,7,1,0,1,0
7_6679027,overcome_laceration_aesthetics_haroset_vulcan_uranus,6679027,7,1,0,1,0
7_3453325,overcome_laceration_lubricity_haroset_uranus_saturn,3453325,7,1,0,1,0
7_2619021,overcome_laceration_aesthetics_haroset_saturn_earth,2619021,7,1,0,1,0
7_7332920,overcome_laceration_love_haroset_vulcan_uranus,7332920,7,1,0,1,0
7_2894358,overcome_laceration_stimulation_haroset_uranus_saturn,2894358,7,1,0,1,0
7_5684257,overcome_laceration_lubricity_haroset_saturn_earth,5684257,7,1,0,1,0
7_2848655,overcome_laceration_aesthetics_haroset_uranus_saturn,2848655,7,1,0,1,0
7_5267480,succumb_sciatica_expectation_wonderbread_vulcan_uranus,5267480,7,1,0,1,0
7_1437108,succumb_sciatica_expectation_wonderbread_uranus_saturn,1437108,7,1,0,1,0
7_3154346,succumb_depression_expectation_onion_vulcan_uranus,3154346,7,1,0,1,0
7_1991938,succumb_depression_expectation_snickers_uranus_saturn,1991938,7,1,0,1,0
7_4703185,succumb_depression_expectation_wonderbread_uranus_saturn,4703185,7,1,0,1,0
7_532580,succumb_depression_expectation_wonderbread_vulcan_uranus,532580,7,1,0,1,0
7_7780222,succumb_depression_expectation_okra_vulcan_uranus,7780222,7,1,0,1,0
7_5822310,succumb_depression_expectation_snickers_vulcan_uranus,5822310,7,1,0,1,0
7_7324951,succumb_depression_expectation_onion_uranus_saturn,7324951,7,1,0,1,0
7_3949850,succumb_depression_expectation_okra_uranus_saturn,3949850,7,1,0,1,0
7_3838791,feast_stimulation_lamb_beef_manitoba_pennsylvania,3838791,7,1,0,1,0
7_5170983,feast_stimulation_lamb_beef_goias_bosnia,5170983,7,1,0,1,0
7_7971729,feast_stimulation_lamb_haroset_bavaria_manitoba,7971729,7,1,0,1,0
7_4906729,feast_stimulation_lamb_beef_pennsylvania_oregon,4906729,7,1,0,1,0
7_529568,feast_stimulation_lamb_haroset_manitoba_pennsylvania,529568,7,1,0,1,0
7_1955017,feast_stimulation_lamb_beef_bavaria_manitoba,1955017,7,1,0,1,0
7_3499158,feast_stimulation_lamb_haroset_pennsylvania_oregon,3499158,7,1,0,1,0
7_6902405,feast_stimulation_lamb_haroset_goias_bosnia,6902405,7,1,0,1,0
7_7958899,succumb_grief_stimulation_wonderbread_saturn_earth,7958899,7,1,0,1,0
7_5676699,succumb_abrasion_stimulation_ham_saturn_earth,5676699,7,1,0,1,0
7_464298,overcome_prostatitis_stimulation_cantelope_uranus_saturn,464298,7,1,0,1,0
7_6287247,succumb_depression_stimulation_onion_saturn_earth,6287247,7,1,0,1,0
7_6060546,overcome_hangover_stimulation_wonderbread_uranus_saturn,6060546,7,1,0,1,0
7_7150245,overcome_laceration_stimulation_flounder_uranus_saturn,7150245,7,1,0,1,0
7_5186095,overcome_abrasion_stimulation_wonderbread_uranus_saturn,5186095,7,1,0,1,0
7_2317395,succumb_dread_stimulation_wonderbread_saturn_earth,2317395,7,1,0,1,0
7_997694,overcome_hangover_stimulation_onion_uranus_saturn,997694,7,1,0,1,0
7_3923994,succumb_boils_stimulation_flounder_saturn_earth,3923994,7,1,0,1,0
7_622094,succumb_grief_stimulation_haroset_saturn_earth,622094,7,1,0,1,0
7_2343143,overcome_angina_stimulation_lemon_uranus_saturn,2343143,7,1,0,1,0
7_962493,succumb_prostatitis_stimulation_cantelope_saturn_earth,962493,7,1,0,1,0
7_4822742,overcome_jealousy_stimulation_flounder_uranus_saturn,4822742,7,1,0,1,0
7_7025991,overcome_laceration_stimulation_marzipan_uranus_saturn,7025991,7,1,0,1,0
7_2422390,succumb_prostatitis_stimulation_wonderbread_saturn_earth,2422390,7,1,0,1,0
7_459240,succumb_jealousy_stimulation_lemon_saturn_earth,459240,7,1,0,1,0
7_2657739,overcome_jealousy_stimulation_bacon_uranus_saturn,2657739,7,1,0,1,0
7_7965539,overcome_abrasion_stimulation_marzipan_uranus_saturn,7965539,7,1,0,1,0
7_1416689,overcome_sciatica_stimulation_haroset_uranus_saturn,1416689,7,1,0,1,0
7_7378339,succumb_prostatitis_stimulation_tofu_saturn_earth,7378339,7,1,0,1,0
7_3348138,overcome_laceration_stimulation_lamb_uranus_saturn,3348138,7,1,0,1,0
7_4698488,overcome_jealousy_stimulation_marzipan_uranus_saturn,4698488,7,1,0,1,0
7_5120588,overcome_sciatica_stimulation_bacon_uranus_saturn,5120588,7,1,0,1,0
7_4586438,overcome_boils_stimulation_beef_uranus_saturn,4586438,7,1,0,1,0
7_53938,succumb_abrasion_stimulation_beef_saturn_earth,53938,7,1,0,1,0
7_5569536,succumb_grief_stimulation_lamb_saturn_earth,5569536,7,1,0,1,0
7_5513085,overcome_sciatica_stimulation_wonderbread_uranus_saturn,5513085,7,1,0,1,0
7_1355634,succumb_grief_stimulation_lobster_saturn_earth,1355634,7,1,0,1,0
7_47083,overcome_prostatitis_stimulation_marzipan_uranus_saturn,47083,7,1,0,1,0
7_2376983,overcome_anger_stimulation_lemon_uranus_saturn,2376983,7,1,0,1,0
7_124533,succumb_abrasion_stimulation_lamb_saturn_earth,124533,7,1,0,1,0
7_2452981,overcome_grief_stimulation_beef_uranus_saturn,2452981,7,1,0,1,0
7_441431,overcome_angina_stimulation_flounder_uranus_saturn,441431,7,1,0,1,0
7_1751631,succumb_grief_stimulation_flounder_saturn_earth,1751631,7,1,0,1,0
7_4170531,succumb_abrasion_stimulation_haroset_saturn_earth,4170531,7,1,0,1,0
7_7894980,overcome_grief_stimulation_ham_uranus_saturn,7894980,7,1,0,1,0
7_5961880,overcome_laceration_stimulation_lemon_uranus_saturn,5961880,7,1,0,1,0
7_3432779,overcome_boils_stimulation_flounder_uranus_saturn,3432779,7,1,0,1,0
7_5809078,succumb_jealousy_stimulation_marzipan_saturn_earth,5809078,7,1,0,1,0
7_6658127,overcome_laceration_stimulation_lobster_uranus_saturn,6658127,7,1,0,1,0
7_22677,overcome_abrasion_stimulation_haroset_uranus_saturn,22677,7,1,0,1,0
7_4308527,succumb_loneliness_stimulation_marzipan_saturn_earth,4308527,7,1,0,1,0
7_5780476,overcome_jealousy_stimulation_lamb_uranus_saturn,5780476,7,1,0,1,0
7_7854623,overcome_jealousy_stimulation_haroset_uranus_saturn,7854623,7,1,0,1,0
7_1277772,overcome_laceration_stimulation_beef_uranus_saturn,1277772,7,1,0,1,0
7_5121871,overcome_prostatitis_stimulation_tofu_uranus_saturn,5121871,7,1,0,1,0
7_5476021,succumb_boils_stimulation_beef_saturn_earth,5476021,7,1,0,1,0
7_7730821,succumb_prostatitis_stimulation_lemon_saturn_earth,7730821,7,1,0,1,0
7_33921,succumb_sciatica_stimulation_lobster_saturn_earth,33921,7,1,0,1,0
7_5872071,succumb_jealousy_stimulation_flounder_saturn_earth,5872071,7,1,0,1,0
7_6443021,succumb_jealousy_stimulation_wonderbread_saturn_earth,6443021,7,1,0,1,0
7_7945821,succumb_abrasion_stimulation_onion_saturn_earth,7945821,7,1,0,1,0
7_4904071,succumb_abrasion_stimulation_lobster_saturn_earth,4904071,7,1,0,1,0
7_888220,succumb_jealousy_stimulation_haroset_saturn_earth,888220,7,1,0,1,0
7_3542269,overcome_angina_stimulation_ham_uranus_saturn,3542269,7,1,0,1,0
7_1103568,succumb_boils_stimulation_ham_saturn_earth,1103568,7,1,0,1,0
7_3663368,succumb_loneliness_stimulation_onion_saturn_earth,3663368,7,1,0,1,0
7_3116817,overcome_depression_stimulation_wonderbread_uranus_saturn,3116817,7,1,0,1,0
7_526367,succumb_abrasion_stimulation_tofu_saturn_earth,526367,7,1,0,1,0
7_5546616,succumb_boils_stimulation_lamb_saturn_earth,5546616,7,1,0,1,0
7_3617415,overcome_jealousy_stimulation_lobster_uranus_saturn,3617415,7,1,0,1,0
7_1975165,succumb_boils_stimulation_cantelope_saturn_earth,1975165,7,1,0,1,0
7_5836514,overcome_depression_stimulation_onion_uranus_saturn,5836514,7,1,0,1,0
7_1835713,succumb_prostatitis_stimulation_onion_saturn_earth,1835713,7,1,0,1,0
7_5976761,overcome_jealousy_stimulation_wonderbread_uranus_saturn,5976761,7,1,0,1,0
7_3710110,overcome_jealousy_stimulation_beef_uranus_saturn,3710110,7,1,0,1,0
7_7872060,overcome_boils_stimulation_ham_uranus_saturn,7872060,7,1,0,1,0
7_6905910,succumb_prostatitis_stimulation_beef_saturn_earth,6905910,7,1,0,1,0
7_1621760,succumb_jealousy_stimulation_lobster_saturn_earth,1621760,7,1,0,1,0
7_7051960,succumb_grief_stimulation_bacon_saturn_earth,7051960,7,1,0,1,0
7_1751860,succumb_abrasion_stimulation_wonderbread_saturn_earth,1751860,7,1,0,1,0
7_5978109,succumb_abrasion_stimulation_marzipan_saturn_earth,5978109,7,1,0,1,0
7_5180458,overcome_sciatica_stimulation_lobster_uranus_saturn,5180458,7,1,0,1,0
7_4692558,overcome_boils_stimulation_haroset_uranus_saturn,4692558,7,1,0,1,0
7_7301358,succumb_sciatica_stimulation_haroset_saturn_earth,7301358,7,1,0,1,0
7_5513607,overcome_boils_stimulation_tofu_uranus_saturn,5513607,7,1,0,1,0
7_2315706,succumb_sciatica_stimulation_wonderbread_saturn_earth,2315706,7,1,0,1,0
7_4769505,overcome_prostatitis_stimulation_wonderbread_uranus_saturn,4769505,7,1,0,1,0
7_6976505,succumb_prostatitis_stimulation_lamb_saturn_earth,6976505,7,1,0,1,0
7_7921455,succumb_jealousy_stimulation_bacon_saturn_earth,7921455,7,1,0,1,0
7_7283805,succumb_jealousy_stimulation_beef_saturn_earth,7283805,7,1,0,1,0
7_6656804,overcome_boils_stimulation_lamb_uranus_saturn,6656804,7,1,0,1,0
7_7861454,succumb_jealousy_stimulation_ham_saturn_earth,7861454,7,1,0,1,0
7_7889354,succumb_abrasion_stimulation_cantelope_saturn_earth,7889354,7,1,0,1,0
7_5922653,succumb_depression_stimulation_wonderbread_saturn_earth,5922653,7,1,0,1,0
7_1723202,succumb_boils_stimulation_lemon_saturn_earth,1723202,7,1,0,1,0
7_2666152,succumb_loneliness_stimulation_tofu_saturn_earth,2666152,7,1,0,1,0
7_5839952,succumb_abrasion_stimulation_lemon_saturn_earth,5839952,7,1,0,1,0
7_6041102,succumb_abrasion_stimulation_flounder_saturn_earth,6041102,7,1,0,1,0
7_2985251,overcome_grief_stimulation_wonderbread_uranus_saturn,2985251,7,1,0,1,0
7_5118301,overcome_jealousy_stimulation_ham_uranus_saturn,5118301,7,1,0,1,0
7_3861001,succumb_boils_stimulation_marzipan_saturn_earth,3861001,7,1,0,1,0
7_1856801,succumb_prostatitis_stimulation_marzipan_saturn_earth,1856801,7,1,0,1,0
7_3291100,overcome_anxiety_stimulation_onion_uranus_saturn,3291100,7,1,0,1,0
7_2399150,succumb_sciatica_stimulation_bacon_saturn_earth,2399150,7,1,0,1,0
7_7354400,succumb_jealousy_stimulation_lamb_saturn_earth,7354400,7,1,0,1,0
7_1877294,feast_lubricity_flounder_haroset_bavaria_manitoba,1877294,7,1,0,1,0
7_5027623,feast_stimulation_flounder_ham_bavaria_manitoba,5027623,7,1,0,1,0
7_4841569,feast_entertainment_flounder_haroset_bavaria_manitoba,4841569,7,1,0,1,0
7_6571661,feast_aesthetics_flounder_haroset_bavaria_manitoba,6571661,7,1,0,1,0
7_1098361,feast_lubricity_flounder_ham_bavaria_manitoba,1098361,7,1,0,1,0
7_5136109,feast_stimulation_flounder_haroset_bavaria_manitoba,5136109,7,1,0,1,0
7_2703653,feast_entertainment_flounder_ham_bavaria_manitoba,2703653,7,1,0,1,0
7_3339403,feast_aesthetics_flounder_ham_bavaria_manitoba,3339403,7,1,0,1,0
7_7097700,feast_love_flounder_ham_bavaria_manitoba,7097700,7,1,0,1,0
7_3597041,locale_flounder_pennsylvania,3597041,7,2,0,2,0
7_1657041,locale_flounder_bavaria,1657041,7,2,0,2,0
7_605242,overcome_jealousy_learning_wonderbread_saturn_earth,605242,7,1,0,1,0
7_3271791,overcome_grief_learning_wonderbread_saturn_earth,3271791,7,1,0,1,0
7_3556041,overcome_depression_learning_snickers_saturn_earth,3556041,7,1,0,1,0
7_2168285,overcome_sciatica_learning_wonderbread_saturn_earth,2168285,7,1,0,1,0
7_7828234,overcome_depression_learning_onion_saturn_earth,7828234,7,1,0,1,0
7_2452880,overcome_anxiety_learning_onion_saturn_earth,2452880,7,1,0,1,0
7_3807329,overcome_depression_learning_wonderbread_saturn_earth,3807329,7,1,0,1,0
7_774273,overcome_abrasion_learning_wonderbread_saturn_earth,774273,7,1,0,1,0
7_6662521,overcome_hangover_learning_snickers_saturn_earth,6662521,7,1,0,1,0
7_493311,overcome_prostatitis_learning_wonderbread_saturn_earth,493311,7,1,0,1,0
7_5623204,overcome_hangover_learning_wonderbread_saturn_earth,5623204,7,1,0,1,0
7_7180247,overcome_abrasion_lubricity_haroset_vulcan_uranus,7180247,7,1,0,1,0
7_368386,overcome_abrasion_aesthetics_haroset_uranus_saturn,368386,7,1,0,1,0
7_5496330,overcome_abrasion_lubricity_haroset_saturn_earth,5496330,7,1,0,1,0
7_3349875,overcome_abrasion_lubricity_haroset_uranus_saturn,3349875,7,1,0,1,0
7_2515571,overcome_abrasion_aesthetics_haroset_saturn_earth,2515571,7,1,0,1,0
7_5316664,overcome_abrasion_entertainment_haroset_vulcan_uranus,5316664,7,1,0,1,0
7_4198758,overcome_abrasion_aesthetics_haroset_vulcan_uranus,4198758,7,1,0,1,0
7_6725107,overcome_abrasion_love_haroset_vulcan_uranus,6725107,7,1,0,1,0
7_1869492,succumb_dread_expectation_wonderbread_uranus_saturn,1869492,7,1,0,1,0
7_5699864,succumb_dread_expectation_wonderbread_vulcan_uranus,5699864,7,1,0,1,0
7_4519547,succumb_hangover_entertainment_wonderbread_vulcan_uranus,4519547,7,1,0,1,0
7_4678647,succumb_sciatica_entertainment_haroset_vulcan_uranus,4678647,7,1,0,1,0
7_6305247,succumb_abrasion_entertainment_beef_vulcan_uranus,6305247,7,1,0,1,0
7_3667447,succumb_laceration_entertainment_lemon_vulcan_uranus,3667447,7,1,0,1,0
7_1176045,succumb_anger_entertainment_lemon_vulcan_uranus,1176045,7,1,0,1,0
7_6224943,succumb_laceration_entertainment_flounder_vulcan_uranus,6224943,7,1,0,1,0
7_6810793,succumb_laceration_entertainment_lamb_vulcan_uranus,6810793,7,1,0,1,0
7_777291,succumb_boils_entertainment_ham_vulcan_uranus,777291,7,1,0,1,0
7_441439,succumb_sciatica_entertainment_lobster_vulcan_uranus,441439,7,1,0,1,0
7_6100689,succumb_laceration_entertainment_marzipan_vulcan_uranus,6100689,7,1,0,1,0
7_6278437,succumb_anger_entertainment_ham_vulcan_uranus,6278437,7,1,0,1,0
7_5981887,succumb_depression_entertainment_wonderbread_vulcan_uranus,5981887,7,1,0,1,0
7_3921687,succumb_boils_entertainment_beef_vulcan_uranus,3921687,7,1,0,1,0
7_3022936,succumb_jealousy_entertainment_beef_vulcan_uranus,3022936,7,1,0,1,0
7_4043486,succumb_jealousy_entertainment_lemon_vulcan_uranus,4043486,7,1,0,1,0
7_374636,succumb_abrasion_entertainment_lamb_vulcan_uranus,374636,7,1,0,1,0
7_4518386,succumb_laceration_entertainment_haroset_vulcan_uranus,4518386,7,1,0,1,0
7_7754586,succumb_dread_entertainment_wonderbread_vulcan_uranus,7754586,7,1,0,1,0
7_5721535,succumb_boils_entertainment_flounder_vulcan_uranus,5721535,7,1,0,1,0
7_781281,succumb_anger_entertainment_flounder_vulcan_uranus,781281,7,1,0,1,0
7_5597281,succumb_boils_entertainment_marzipan_vulcan_uranus,5597281,7,1,0,1,0
7_5601130,succumb_jealousy_entertainment_haroset_vulcan_uranus,5601130,7,1,0,1,0
7_3418878,succumb_angina_entertainment_flounder_vulcan_uranus,3418878,7,1,0,1,0
7_281178,succumb_laceration_entertainment_lobster_vulcan_uranus,281178,7,1,0,1,0
7_4740427,succumb_laceration_entertainment_beef_vulcan_uranus,4740427,7,1,0,1,0
7_5243076,succumb_jealousy_entertainment_ham_vulcan_uranus,5243076,7,1,0,1,0
7_6558774,succumb_abrasion_entertainment_marzipan_vulcan_uranus,6558774,7,1,0,1,0
7_2137023,succumb_jealousy_entertainment_bacon_vulcan_uranus,2137023,7,1,0,1,0
7_1363922,succumb_jealousy_entertainment_lobster_vulcan_uranus,1363922,7,1,0,1,0
7_2496319,succumb_sciatica_entertainment_wonderbread_vulcan_uranus,2496319,7,1,0,1,0
7_4212517,succumb_abrasion_entertainment_lemon_vulcan_uranus,4212517,7,1,0,1,0
7_3700066,succumb_sciatica_entertainment_bacon_vulcan_uranus,3700066,7,1,0,1,0
7_3979665,succumb_angina_entertainment_lemon_vulcan_uranus,3979665,7,1,0,1,0
7_3373212,succumb_jealousy_entertainment_flounder_vulcan_uranus,3373212,7,1,0,1,0
7_2095409,succumb_boils_entertainment_lemon_vulcan_uranus,2095409,7,1,0,1,0
7_3248958,succumb_jealousy_entertainment_marzipan_vulcan_uranus,3248958,7,1,0,1,0
7_3934553,succumb_anger_entertainment_haroset_vulcan_uranus,3934553,7,1,0,1,0
7_1203153,succumb_angina_entertainment_ham_vulcan_uranus,1203153,7,1,0,1,0
7_5992053,succumb_boils_entertainment_lamb_vulcan_uranus,5992053,7,1,0,1,0
7_5093302,succumb_jealousy_entertainment_lamb_vulcan_uranus,5093302,7,1,0,1,0
7_7127744,overcome_grief_entertainment_beef_vulcan_uranus,7127744,7,1,0,1,0
7_5723987,overcome_grief_lubricity_beef_vulcan_uranus,5723987,7,1,0,1,0
7_1893615,overcome_grief_lubricity_beef_uranus_saturn,1893615,7,1,0,1,0
7_7615901,overcome_grief_lubricity_beef_saturn_earth,7615901,7,1,0,1,0
7_7989638,feast_love_beef_lamb_pennsylvania_oregon,7989638,7,1,0,1,0
7_2027333,feast_love_beef_lemon_pennsylvania_oregon,2027333,7,1,0,1,0
7_2785080,feast_love_beef_lemon_manitoba_pennsylvania,2785080,7,1,0,1,0
7_7539176,feast_love_beef_marzipan_pennsylvania_oregon,7539176,7,1,0,1,0
7_4691811,feast_love_beef_lamb_manitoba_pennsylvania,4691811,7,1,0,1,0
7_6819309,feast_love_beef_marzipan_manitoba_pennsylvania,6819309,7,1,0,1,0
7_5397895,feast_lubricity_ham_flounder_oregon_goias,5397895,7,1,0,1,0
7_3134141,feast_lubricity_ham_lemon_oregon_goias,3134141,7,1,0,1,0
7_761938,feast_stimulation_ham_flounder_oregon_goias,761938,7,1,0,1,0
7_154486,feast_entertainment_ham_flounder_oregon_goias,154486,7,1,0,1,0
7_1982870,feast_love_ham_flounder_oregon_goias,1982870,7,1,0,1,0
7_4932716,feast_love_ham_lemon_oregon_goias,4932716,7,1,0,1,0
7_2625063,feast_stimulation_ham_lemon_oregon_goias,2625063,7,1,0,1,0
7_1601758,feast_entertainment_ham_lemon_oregon_goias,1601758,7,1,0,1,0
7_7932547,feast_stimulation_flounder_ham_manitoba_pennsylvania,7932547,7,1,0,1,0
7_3507238,feast_stimulation_flounder_haroset_pennsylvania_oregon,3507238,7,1,0,1,0
7_4704130,feast_stimulation_flounder_ham_pennsylvania_oregon,4704130,7,1,0,1,0
7_1995966,feast_stimulation_flounder_haroset_manitoba_pennsylvania,1995966,7,1,0,1,0
7_7476923,feast_aesthetics_bacon_lobster_bavaria_manitoba,7476923,7,1,0,1,0
7_394853,feast_aesthetics_bacon_wonderbread_bavaria_manitoba,394853,7,1,0,1,0
7_4770690,feast_love_flounder_ham_pennsylvania_oregon,4770690,7,1,0,1,0
7_4576090,feast_lubricity_flounder_haroset_pennsylvania_oregon,4576090,7,1,0,1,0
7_4522139,feast_aesthetics_flounder_haroset_pennsylvania_oregon,4522139,7,1,0,1,0
7_5721338,feast_entertainment_flounder_haroset_pennsylvania_oregon,5721338,7,1,0,1,0
7_3077781,feast_entertainment_flounder_ham_pennsylvania_oregon,3077781,7,1,0,1,0
7_6749570,feast_love_flounder_haroset_pennsylvania_oregon,6749570,7,1,0,1,0
7_1159719,feast_lubricity_flounder_ham_pennsylvania_oregon,1159719,7,1,0,1,0
7_7710104,feast_aesthetics_flounder_ham_pennsylvania_oregon,7710104,7,1,0,1,0
7_5825714,locale_flounder_manitoba,5825714,7,2,0,2,0
7_4171749,overcome_jealousy_lubricity_marzipan_vulcan_uranus,4171749,7,1,0,1,0
7_341377,overcome_jealousy_lubricity_marzipan_uranus_saturn,341377,7,1,0,1,0
7_4866915,overcome_jealousy_love_marzipan_vulcan_uranus,4866915,7,1,0,1,0
7_46414,overcome_jealousy_lubricity_marzipan_saturn_earth,46414,7,1,0,1,0
7_7795146,overcome_jealousy_entertainment_ham_vulcan_uranus,7795146,7,1,0,1,0
7_733794,overcome_jealousy_lubricity_ham_saturn_earth,733794,7,1,0,1,0
7_450139,overcome_jealousy_love_ham_vulcan_uranus,450139,7,1,0,1,0
7_4119535,overcome_jealousy_lubricity_ham_vulcan_uranus,4119535,7,1,0,1,0
7_5498579,overcome_jealousy_aesthetics_ham_uranus_saturn,5498579,7,1,0,1,0
7_289163,overcome_jealousy_lubricity_ham_uranus_saturn,289163,7,1,0,1,0
7_2504357,overcome_jealousy_aesthetics_ham_saturn_earth,2504357,7,1,0,1,0
7_6515348,overcome_prostatitis_lubricity_marzipan_vulcan_uranus,6515348,7,1,0,1,0
7_2684976,overcome_prostatitis_lubricity_marzipan_uranus_saturn,2684976,7,1,0,1,0
7_5421418,overcome_prostatitis_aesthetics_marzipan_saturn_earth,5421418,7,1,0,1,0
7_4087311,overcome_prostatitis_lubricity_marzipan_saturn_earth,4087311,7,1,0,1,0
7_1870259,overcome_prostatitis_entertainment_marzipan_vulcan_uranus,1870259,7,1,0,1,0
7_2268705,overcome_prostatitis_love_marzipan_vulcan_uranus,2268705,7,1,0,1,0
7_7602497,overcome_hangover_achievement_wonderbread_vulcan_uranus,7602497,7,1,0,1,0
7_6728046,overcome_abrasion_achievement_wonderbread_vulcan_uranus,6728046,7,1,0,1,0
7_6187441,succumb_depression_achievement_wonderbread_uranus_saturn,6187441,7,1,0,1,0
7_7055036,overcome_sciatica_achievement_wonderbread_vulcan_uranus,7055036,7,1,0,1,0
7_3468825,succumb_hangover_achievement_wonderbread_uranus_saturn,3468825,7,1,0,1,0
7_4658768,overcome_depression_achievement_wonderbread_vulcan_uranus,4658768,7,1,0,1,0
7_2921364,succumb_sciatica_achievement_wonderbread_uranus_saturn,2921364,7,1,0,1,0
7_7518712,overcome_jealousy_achievement_wonderbread_vulcan_uranus,7518712,7,1,0,1,0
7_7402912,succumb_grief_achievement_wonderbread_uranus_saturn,7402912,7,1,0,1,0
7_6311456,overcome_prostatitis_achievement_wonderbread_vulcan_uranus,6311456,7,1,0,1,0
7_4527202,overcome_grief_achievement_wonderbread_vulcan_uranus,4527202,7,1,0,1,0
7_554475,harmony_achievement_vulcan,554475,7,2,0,2,0
7_5777515,feast_lubricity_flounder_ham_manitoba_pennsylvania,5777515,7,1,0,1,0
7_1727003,feast_lubricity_flounder_haroset_manitoba_pennsylvania,1727003,7,1,0,1,0
7_3215560,succumb_grief_learning_wonderbread_vulcan_uranus,3215560,7,1,0,1,0
7_5909977,succumb_depression_lubricity_wonderbread_uranus_saturn,5909977,7,1,0,1,0
7_1318319,succumb_depression_lubricity_wonderbread_saturn_earth,1318319,7,1,0,1,0
7_1747201,succumb_depression_lubricity_onion_saturn_earth,1747201,7,1,0,1,0
7_6618547,overcome_laceration_aesthetics_beef_saturn_earth,6618547,7,1,0,1,0
7_82246,overcome_jealousy_aesthetics_bacon_saturn_earth,82246,7,1,0,1,0
7_1221343,overcome_jealousy_aesthetics_haroset_saturn_earth,1221343,7,1,0,1,0
7_6689142,overcome_laceration_aesthetics_lamb_saturn_earth,6689142,7,1,0,1,0
7_3684192,overcome_sciatica_aesthetics_haroset_saturn_earth,3684192,7,1,0,1,0
7_4034040,overcome_jealousy_aesthetics_beef_saturn_earth,4034040,7,1,0,1,0
7_5304889,overcome_grief_aesthetics_wonderbread_saturn_earth,5304889,7,1,0,1,0
7_6174686,overcome_laceration_aesthetics_lemon_saturn_earth,6174686,7,1,0,1,0
7_4104635,overcome_jealousy_aesthetics_lamb_saturn_earth,4104635,7,1,0,1,0
7_6454034,overcome_angina_aesthetics_ham_saturn_earth,6454034,7,1,0,1,0
7_1954883,overcome_jealousy_aesthetics_lobster_saturn_earth,1954883,7,1,0,1,0
7_4417732,overcome_sciatica_aesthetics_lobster_saturn_earth,4417732,7,1,0,1,0
7_3951730,overcome_abrasion_aesthetics_wonderbread_saturn_earth,3951730,7,1,0,1,0
7_6360130,overcome_abrasion_aesthetics_marzipan_saturn_earth,6360130,7,1,0,1,0
7_6766776,overcome_sciatica_aesthetics_wonderbread_saturn_earth,6766776,7,1,0,1,0
7_1074175,overcome_prostatitis_aesthetics_wonderbread_saturn_earth,1074175,7,1,0,1,0
7_2619075,overcome_angina_aesthetics_flounder_saturn_earth,2619075,7,1,0,1,0
7_5635924,overcome_laceration_aesthetics_bacon_saturn_earth,5635924,7,1,0,1,0
7_839422,overcome_laceration_aesthetics_marzipan_saturn_earth,839422,7,1,0,1,0
7_1139120,overcome_boils_aesthetics_ham_saturn_earth,1139120,7,1,0,1,0
7_902415,overcome_laceration_aesthetics_flounder_saturn_earth,902415,7,1,0,1,0
7_3159714,overcome_boils_aesthetics_flounder_saturn_earth,3159714,7,1,0,1,0
7_3140812,overcome_jealousy_aesthetics_flounder_saturn_earth,3140812,7,1,0,1,0
7_3352561,overcome_laceration_aesthetics_lobster_saturn_earth,3352561,7,1,0,1,0
7_689260,overcome_hangover_aesthetics_wonderbread_saturn_earth,689260,7,1,0,1,0
7_7689259,overcome_jealousy_aesthetics_wonderbread_saturn_earth,7689259,7,1,0,1,0
7_2037158,overcome_depression_aesthetics_wonderbread_saturn_earth,2037158,7,1,0,1,0
7_6576356,overcome_boils_aesthetics_beef_saturn_earth,6576356,7,1,0,1,0
7_4170905,overcome_laceration_aesthetics_ham_saturn_earth,4170905,7,1,0,1,0
7_1533955,overcome_boils_aesthetics_haroset_saturn_earth,1533955,7,1,0,1,0
7_7045953,overcome_angina_aesthetics_lemon_saturn_earth,7045953,7,1,0,1,0
7_6646951,overcome_boils_aesthetics_lamb_saturn_earth,6646951,7,1,0,1,0
7_5592600,overcome_sciatica_aesthetics_bacon_saturn_earth,5592600,7,1,0,1,0
7_4916647,succumb_prostatitis_lubricity_tofu_uranus_saturn,4916647,7,1,0,1,0
7_5877496,succumb_prostatitis_lubricity_tofu_saturn_earth,5877496,7,1,0,1,0
7_6059844,succumb_prostatitis_lubricity_lamb_uranus_saturn,6059844,7,1,0,1,0
7_7232890,succumb_prostatitis_lubricity_marzipan_uranus_saturn,7232890,7,1,0,1,0
7_1889239,succumb_prostatitis_lubricity_lamb_vulcan_uranus,1889239,7,1,0,1,0
7_7903989,succumb_prostatitis_lubricity_lemon_vulcan_uranus,7903989,7,1,0,1,0
7_3062285,succumb_prostatitis_lubricity_marzipan_vulcan_uranus,3062285,7,1,0,1,0
7_4606631,succumb_prostatitis_lubricity_wonderbread_saturn_earth,4606631,7,1,0,1,0
7_3989478,succumb_prostatitis_lubricity_beef_uranus_saturn,3989478,7,1,0,1,0
7_450623,succumb_prostatitis_lubricity_cantelope_saturn_earth,450623,7,1,0,1,0
7_5405067,succumb_prostatitis_lubricity_beef_saturn_earth,5405067,7,1,0,1,0
7_4073617,succumb_prostatitis_lubricity_lemon_uranus_saturn,4073617,7,1,0,1,0
7_2792416,succumb_prostatitis_lubricity_marzipan_saturn_earth,2792416,7,1,0,1,0
7_7615264,succumb_prostatitis_lubricity_wonderbread_uranus_saturn,7615264,7,1,0,1,0
7_5475662,succumb_prostatitis_lubricity_lamb_saturn_earth,5475662,7,1,0,1,0
7_7561909,succumb_prostatitis_lubricity_lemon_saturn_earth,7561909,7,1,0,1,0
7_7807157,succumb_prostatitis_lubricity_cantelope_uranus_saturn,7807157,7,1,0,1,0
7_3636552,succumb_prostatitis_lubricity_cantelope_vulcan_uranus,3636552,7,1,0,1,0
7_1666801,succumb_prostatitis_lubricity_onion_saturn_earth,1666801,7,1,0,1,0
7_7819850,succumb_prostatitis_lubricity_beef_vulcan_uranus,7819850,7,1,0,1,0
7_849844,overcome_jealousy_aesthetics_lobster_uranus_saturn,849844,7,1,0,1,0
7_4816985,overcome_jealousy_entertainment_lobster_vulcan_uranus,4816985,7,1,0,1,0
7_5819416,overcome_jealousy_lubricity_lobster_uranus_saturn,5819416,7,1,0,1,0
7_4680216,overcome_jealousy_aesthetics_lobster_vulcan_uranus,4680216,7,1,0,1,0
7_713912,overcome_jealousy_love_lobster_vulcan_uranus,713912,7,1,0,1,0
7_849158,overcome_jealousy_lubricity_lobster_saturn_earth,849158,7,1,0,1,0
7_828396,overcome_depression_achievement_wonderbread_uranus_saturn,828396,7,1,0,1,0
7_7818142,overcome_depression_love_wonderbread_vulcan_uranus,7818142,7,1,0,1,0
7_5910290,overcome_depression_aesthetics_wonderbread_uranus_saturn,5910290,7,1,0,1,0
7_1739685,overcome_depression_aesthetics_wonderbread_vulcan_uranus,1739685,7,1,0,1,0
7_5194977,overcome_depression_lubricity_wonderbread_saturn_earth,5194977,7,1,0,1,0
7_6213277,overcome_depression_lubricity_wonderbread_uranus_saturn,6213277,7,1,0,1,0
7_2042672,overcome_depression_lubricity_wonderbread_vulcan_uranus,2042672,7,1,0,1,0
7_3174512,overcome_depression_expectation_wonderbread_vulcan_uranus,3174512,7,1,0,1,0
7_6495159,overcome_depression_entertainment_wonderbread_vulcan_uranus,6495159,7,1,0,1,0
7_980395,succumb_boils_aesthetics_ham_saturn_earth,980395,7,1,0,1,0
7_5947641,succumb_boils_aesthetics_beef_saturn_earth,5947641,7,1,0,1,0
7_6018236,succumb_boils_aesthetics_lamb_saturn_earth,6018236,7,1,0,1,0
7_6427130,succumb_boils_aesthetics_flounder_uranus_saturn,6427130,7,1,0,1,0
7_6789757,succumb_boils_aesthetics_flounder_saturn_earth,6789757,7,1,0,1,0
7_941202,succumb_boils_aesthetics_lamb_uranus_saturn,941202,7,1,0,1,0
7_4897941,overcome_jealousy_entertainment_wonderbread_vulcan_uranus,4897941,7,1,0,1,0
7_3688340,overcome_jealousy_achievement_wonderbread_uranus_saturn,3688340,7,1,0,1,0
7_7694773,overcome_jealousy_lubricity_wonderbread_vulcan_uranus,7694773,7,1,0,1,0
7_5668522,overcome_jealousy_love_wonderbread_vulcan_uranus,5668522,7,1,0,1,0
7_1560359,overcome_jealousy_lubricity_wonderbread_saturn_earth,1560359,7,1,0,1,0
7_4671309,overcome_jealousy_aesthetics_wonderbread_uranus_saturn,4671309,7,1,0,1,0
7_6034456,overcome_jealousy_expectation_wonderbread_vulcan_uranus,6034456,7,1,0,1,0
7_500704,overcome_jealousy_aesthetics_wonderbread_vulcan_uranus,500704,7,1,0,1,0
7_3864401,overcome_jealousy_lubricity_wonderbread_uranus_saturn,3864401,7,1,0,1,0
7_935349,overcome_boils_aesthetics_haroset_vulcan_uranus,935349,7,1,0,1,0
7_991946,overcome_boils_lubricity_haroset_saturn_earth,991946,7,1,0,1,0
7_4101934,overcome_boils_love_haroset_vulcan_uranus,4101934,7,1,0,1,0
7_5105954,overcome_boils_aesthetics_haroset_uranus_saturn,5105954,7,1,0,1,0
7_5266653,overcome_boils_entertainment_haroset_vulcan_uranus,5266653,7,1,0,1,0
7_6052961,locale_beef_manitoba,6052961,7,2,0,2,0
7_2186495,feast_expectation_okra_wonderbread_bavaria_manitoba,2186495,7,1,0,1,0
7_1923741,feast_expectation_okra_snickers_bavaria_manitoba,1923741,7,1,0,1,0
7_4150653,craves_expectation_wonderbread,4150653,7,4,0,4,0
7_2330099,feast_stimulation_lobster_bacon_bavaria_manitoba,2330099,7,1,0,1,0
7_3429796,feast_lubricity_lobster_haroset_bavaria_manitoba,3429796,7,1,0,1,0
7_2198537,feast_aesthetics_lobster_bacon_bavaria_manitoba,2198537,7,1,0,1,0
7_4562129,feast_lubricity_lobster_bacon_bavaria_manitoba,4562129,7,1,0,1,0
7_4205329,feast_love_lobster_bacon_bavaria_manitoba,4205329,7,1,0,1,0
7_7040767,feast_love_lobster_haroset_bavaria_manitoba,7040767,7,1,0,1,0
7_6974207,feast_stimulation_lobster_haroset_bavaria_manitoba,6974207,7,1,0,1,0
7_1979204,feast_aesthetics_lobster_haroset_bavaria_manitoba,1979204,7,1,0,1,0
7_5244493,locale_lobster_bavaria,5244493,7,0,0,0,0
7_139886,overcome_laceration_love_lamb_vulcan_uranus,139886,7,1,0,1,0
7_4672621,overcome_laceration_aesthetics_lamb_uranus_saturn,4672621,7,1,0,1,0
7_561767,overcome_laceration_lubricity_lamb_saturn_earth,561767,7,1,0,1,0
7_502016,overcome_laceration_aesthetics_lamb_vulcan_uranus,502016,7,1,0,1,0
7_4256113,overcome_laceration_lubricity_lamb_uranus_saturn,4256113,7,1,0,1,0
7_104711,overcome_laceration_entertainment_lamb_vulcan_uranus,104711,7,1,0,1,0
7_85508,overcome_laceration_lubricity_lamb_vulcan_uranus,85508,7,1,0,1,0
7_6501770,feast_stimulation_beef_marzipan_pennsylvania_oregon,6501770,7,1,0,1,0
7_2718520,feast_stimulation_beef_lemon_manitoba_pennsylvania,2718520,7,1,0,1,0
7_3681262,feast_stimulation_beef_marzipan_manitoba_pennsylvania,3681262,7,1,0,1,0
7_5919561,feast_stimulation_beef_lamb_pennsylvania_oregon,5919561,7,1,0,1,0
7_152103,feast_stimulation_beef_lemon_pennsylvania_oregon,152103,7,1,0,1,0
7_4691551,feast_stimulation_beef_lamb_manitoba_pennsylvania,4691551,7,1,0,1,0
7_2949699,succumb_grief_lubricity_flounder_uranus_saturn,2949699,7,1,0,1,0
7_2754298,overcome_boils_lubricity_ham_vulcan_uranus,2754298,7,1,0,1,0
7_7291748,succumb_anger_lubricity_lamb_uranus_saturn,7291748,7,1,0,1,0
7_5874296,succumb_anger_lubricity_ham_uranus_saturn,5874296,7,1,0,1,0
7_3957244,overcome_abrasion_lubricity_wonderbread_vulcan_uranus,3957244,7,1,0,1,0
7_2204542,overcome_laceration_lubricity_lemon_vulcan_uranus,2204542,7,1,0,1,0
7_347891,overcome_sciatica_lubricity_haroset_vulcan_uranus,347891,7,1,0,1,0
7_7015141,succumb_abrasion_lubricity_tofu_uranus_saturn,7015141,7,1,0,1,0
7_6772290,overcome_sciatica_lubricity_wonderbread_vulcan_uranus,6772290,7,1,0,1,0
7_1079689,overcome_prostatitis_lubricity_wonderbread_vulcan_uranus,1079689,7,1,0,1,0
7_5433789,succumb_laceration_lubricity_lamb_uranus_saturn,5433789,7,1,0,1,0
7_6943288,overcome_laceration_lubricity_tofu_vulcan_uranus,6943288,7,1,0,1,0
7_538938,succumb_anger_lubricity_haroset_uranus_saturn,538938,7,1,0,1,0
7_7402938,succumb_anger_lubricity_lemon_uranus_saturn,7402938,7,1,0,1,0
7_3927488,succumb_abrasion_lubricity_cantelope_uranus_saturn,3927488,7,1,0,1,0
7_6498136,succumb_abrasion_lubricity_flounder_uranus_saturn,6498136,7,1,0,1,0
7_4674786,succumb_abrasion_lubricity_wonderbread_uranus_saturn,4674786,7,1,0,1,0
7_4909835,overcome_grief_lubricity_ham_vulcan_uranus,4909835,7,1,0,1,0
7_68235,overcome_angina_lubricity_ham_vulcan_uranus,68235,7,1,0,1,0
7_5786083,overcome_laceration_lubricity_ham_vulcan_uranus,5786083,7,1,0,1,0
7_4163833,overcome_anger_lubricity_lemon_vulcan_uranus,4163833,7,1,0,1,0
7_6373882,succumb_abrasion_lubricity_marzipan_uranus_saturn,6373882,7,1,0,1,0
7_5242032,succumb_loneliness_lubricity_tofu_uranus_saturn,5242032,7,1,0,1,0
7_5501978,overcome_jealousy_lubricity_lamb_vulcan_uranus,5501978,7,1,0,1,0
7_5973928,overcome_boils_lubricity_beef_vulcan_uranus,5973928,7,1,0,1,0
7_3823077,succumb_laceration_lubricity_lemon_uranus_saturn,3823077,7,1,0,1,0
7_2664876,overcome_laceration_lubricity_cantelope_vulcan_uranus,2664876,7,1,0,1,0
7_3215825,succumb_jealousy_lubricity_flounder_uranus_saturn,3215825,7,1,0,1,0
7_4230225,succumb_grief_lubricity_wonderbread_uranus_saturn,4230225,7,1,0,1,0
7_694774,overcome_hangover_lubricity_wonderbread_vulcan_uranus,694774,7,1,0,1,0
7_1854473,succumb_jealousy_lubricity_ham_uranus_saturn,1854473,7,1,0,1,0
7_3363423,succumb_laceration_lubricity_beef_uranus_saturn,3363423,7,1,0,1,0
7_6087972,succumb_abrasion_lubricity_beef_uranus_saturn,6087972,7,1,0,1,0
7_5222622,succumb_abrasion_lubricity_lemon_uranus_saturn,5222622,7,1,0,1,0
7_6016119,overcome_laceration_lubricity_beef_vulcan_uranus,6016119,7,1,0,1,0
7_5886019,overcome_jealousy_lubricity_haroset_vulcan_uranus,5886019,7,1,0,1,0
7_3774266,overcome_angina_lubricity_flounder_vulcan_uranus,3774266,7,1,0,1,0
7_2342116,succumb_jealousy_lubricity_lamb_uranus_saturn,2342116,7,1,0,1,0
7_3335266,succumb_grief_lubricity_lamb_uranus_saturn,3335266,7,1,0,1,0
7_4933316,succumb_laceration_lubricity_flounder_uranus_saturn,4933316,7,1,0,1,0
7_1412316,succumb_hangover_lubricity_wonderbread_uranus_saturn,1412316,7,1,0,1,0
7_940213,succumb_grief_lubricity_haroset_uranus_saturn,940213,7,1,0,1,0
7_3417013,succumb_laceration_lubricity_haroset_uranus_saturn,3417013,7,1,0,1,0
7_3431612,overcome_jealousy_lubricity_beef_vulcan_uranus,3431612,7,1,0,1,0
7_3298112,overcome_prostatitis_lubricity_tofu_vulcan_uranus,3298112,7,1,0,1,0
7_4809062,succumb_laceration_lubricity_marzipan_uranus_saturn,4809062,7,1,0,1,0
7_157361,succumb_abrasion_lubricity_lamb_uranus_saturn,157361,7,1,0,1,0
7_7513210,overcome_prostatitis_lubricity_cantelope_vulcan_uranus,7513210,7,1,0,1,0
7_7454060,overcome_abrasion_lubricity_marzipan_vulcan_uranus,7454060,7,1,0,1,0
7_5208310,succumb_dread_lubricity_wonderbread_uranus_saturn,5208310,7,1,0,1,0
7_3075809,overcome_angina_lubricity_lemon_vulcan_uranus,3075809,7,1,0,1,0
7_2057606,overcome_laceration_lubricity_flounder_vulcan_uranus,2057606,7,1,0,1,0
7_797805,succumb_abrasion_lubricity_haroset_uranus_saturn,797805,7,1,0,1,0
7_7504554,succumb_jealousy_lubricity_haroset_uranus_saturn,7504554,7,1,0,1,0
7_5310403,overcome_grief_lubricity_wonderbread_vulcan_uranus,5310403,7,1,0,1,0
7_4296003,overcome_jealousy_lubricity_flounder_vulcan_uranus,4296003,7,1,0,1,0
7_1804303,succumb_loneliness_lubricity_marzipan_uranus_saturn,1804303,7,1,0,1,0
7_1933352,overcome_laceration_lubricity_marzipan_vulcan_uranus,1933352,7,1,0,1,0
7_271750,succumb_jealousy_lubricity_beef_uranus_saturn,271750,7,1,0,1,0
7_4236000,succumb_anger_lubricity_flounder_uranus_saturn,4236000,7,1,0,1,0
7_1062997,succumb_abrasion_love_tofu_vulcan_uranus,1062997,7,1,0,1,0
7_2206194,succumb_abrasion_love_lamb_vulcan_uranus,2206194,7,1,0,1,0
7_4225933,succumb_abrasion_love_wonderbread_vulcan_uranus,4225933,7,1,0,1,0
7_135828,succumb_abrasion_love_beef_vulcan_uranus,135828,7,1,0,1,0
7_1356325,succumb_abrasion_love_ham_vulcan_uranus,1356325,7,1,0,1,0
7_1033722,succumb_abrasion_love_lemon_vulcan_uranus,1033722,7,1,0,1,0
7_50921,succumb_abrasion_love_cantelope_vulcan_uranus,50921,7,1,0,1,0
7_4517208,succumb_abrasion_love_marzipan_vulcan_uranus,4517208,7,1,0,1,0
7_5793607,succumb_abrasion_love_haroset_vulcan_uranus,5793607,7,1,0,1,0
7_1323893,succumb_sciatica_love_wonderbread_vulcan_uranus,1323893,7,1,0,1,0
7_816536,succumb_sciatica_love_bacon_vulcan_uranus,816536,7,1,0,1,0
7_4732330,succumb_sciatica_love_haroset_vulcan_uranus,4732330,7,1,0,1,0
7_495122,succumb_sciatica_love_lobster_vulcan_uranus,495122,7,1,0,1,0
7_1847143,feast_aesthetics_marzipan_beef_manitoba_pennsylvania,1847143,7,1,0,1,0
7_4003392,feast_aesthetics_marzipan_cantelope_pennsylvania_oregon,4003392,7,1,0,1,0
7_5308791,feast_aesthetics_marzipan_tofu_pennsylvania_oregon,5308791,7,1,0,1,0
7_2840040,feast_aesthetics_marzipan_beef_pennsylvania_oregon,2840040,7,1,0,1,0
7_1973982,feast_aesthetics_marzipan_cantelope_manitoba_pennsylvania,1973982,7,1,0,1,0
7_6156762,feast_aesthetics_marzipan_tofu_manitoba_pennsylvania,6156762,7,1,0,1,0
7_946107,feast_aesthetics_marzipan_wonderbread_pennsylvania_oregon,946107,7,1,0,1,0
7_210256,feast_aesthetics_marzipan_wonderbread_manitoba_pennsylvania,210256,7,1,0,1,0
7_584478,overcome_laceration_entertainment_lobster_vulcan_uranus,584478,7,1,0,1,0
7_6612424,overcome_laceration_aesthetics_lobster_uranus_saturn,6612424,7,1,0,1,0
7_2441819,overcome_laceration_aesthetics_lobster_vulcan_uranus,2441819,7,1,0,1,0
7_5825319,succumb_angina_aesthetics_ham_saturn_earth,5825319,7,1,0,1,0
7_310409,succumb_angina_aesthetics_flounder_uranus_saturn,310409,7,1,0,1,0
7_3796751,succumb_angina_aesthetics_flounder_saturn_earth,3796751,7,1,0,1,0
7_4007159,feast_aesthetics_lemon_cantelope_bavaria_manitoba,4007159,7,1,0,1,0
7_5563455,feast_aesthetics_lemon_ham_bavaria_manitoba,5563455,7,1,0,1,0
7_5973003,feast_aesthetics_lemon_beef_bavaria_manitoba,5973003,7,1,0,1,0
7_1191847,overcome_laceration_entertainment_ham_vulcan_uranus,1191847,7,1,0,1,0
7_3115594,overcome_laceration_lubricity_ham_saturn_earth,3115594,7,1,0,1,0
7_3473513,overcome_laceration_love_ham_vulcan_uranus,3473513,7,1,0,1,0
7_1955711,overcome_laceration_lubricity_ham_uranus_saturn,1955711,7,1,0,1,0
7_82109,overcome_laceration_aesthetics_ham_uranus_saturn,82109,7,1,0,1,0
7_3316249,succumb_laceration_aesthetics_lobster_saturn_earth,3316249,7,1,0,1,0
7_7608497,succumb_laceration_aesthetics_flounder_saturn_earth,7608497,7,1,0,1,0
7_5384132,succumb_laceration_aesthetics_haroset_vulcan_uranus,5384132,7,1,0,1,0
7_5317529,succumb_laceration_aesthetics_lobster_uranus_saturn,5317529,7,1,0,1,0
7_1146924,succumb_laceration_aesthetics_lobster_vulcan_uranus,1146924,7,1,0,1,0
7_7796223,succumb_laceration_aesthetics_beef_saturn_earth,7796223,7,1,0,1,0
7_7866818,succumb_laceration_aesthetics_lamb_saturn_earth,7866818,7,1,0,1,0
7_7999168,succumb_laceration_aesthetics_flounder_uranus_saturn,7999168,7,1,0,1,0
7_1553760,succumb_laceration_aesthetics_haroset_uranus_saturn,1553760,7,1,0,1,0
7_2582709,succumb_laceration_aesthetics_haroset_saturn_earth,2582709,7,1,0,1,0
7_2120551,succumb_laceration_aesthetics_lamb_uranus_saturn,2120551,7,1,0,1,0
7_7850787,overcome_anger_love_lemon_vulcan_uranus,7850787,7,1,0,1,0
7_333461,overcome_anger_lubricity_lemon_uranus_saturn,333461,7,1,0,1,0
7_1421551,overcome_anger_lubricity_lemon_saturn_earth,1421551,7,1,0,1,0
7_3191094,overcome_angina_love_lemon_vulcan_uranus,3191094,7,1,0,1,0
7_6531735,overcome_angina_entertainment_lemon_vulcan_uranus,6531735,7,1,0,1,0
7_6167881,overcome_angina_lubricity_lemon_saturn_earth,6167881,7,1,0,1,0
7_7246414,overcome_angina_lubricity_lemon_uranus_saturn,7246414,7,1,0,1,0
7_5703074,overcome_boils_aesthetics_lamb_vulcan_uranus,5703074,7,1,0,1,0
7_4213922,overcome_boils_lubricity_lamb_uranus_saturn,4213922,7,1,0,1,0
7_2362010,overcome_boils_entertainment_lamb_vulcan_uranus,2362010,7,1,0,1,0
7_5530959,overcome_boils_lubricity_lamb_saturn_earth,5530959,7,1,0,1,0
7_1872702,overcome_boils_aesthetics_lamb_uranus_saturn,1872702,7,1,0,1,0
7_7597451,overcome_boils_love_lamb_vulcan_uranus,7597451,7,1,0,1,0
7_1697991,overcome_depression_expectation_snickers_vulcan_uranus,1697991,7,1,0,1,0
7_2923645,overcome_hangover_love_wonderbread_vulcan_uranus,2923645,7,1,0,1,0
7_6118241,overcome_hangover_expectation_wonderbread_vulcan_uranus,6118241,7,1,0,1,0
7_4865379,overcome_hangover_lubricity_wonderbread_uranus_saturn,4865379,7,1,0,1,0
7_7161479,overcome_hangover_entertainment_wonderbread_vulcan_uranus,7161479,7,1,0,1,0
7_3772125,overcome_hangover_achievement_wonderbread_uranus_saturn,3772125,7,1,0,1,0
7_4890413,overcome_hangover_aesthetics_wonderbread_uranus_saturn,4890413,7,1,0,1,0
7_6002311,overcome_hangover_lubricity_wonderbread_saturn_earth,6002311,7,1,0,1,0
7_719808,overcome_hangover_aesthetics_wonderbread_vulcan_uranus,719808,7,1,0,1,0
7_281288,overcome_sciatica_lubricity_lobster_uranus_saturn,281288,7,1,0,1,0
7_7262982,overcome_sciatica_aesthetics_lobster_uranus_saturn,7262982,7,1,0,1,0
7_3327830,overcome_sciatica_lubricity_lobster_saturn_earth,3327830,7,1,0,1,0
7_3092377,overcome_sciatica_aesthetics_lobster_vulcan_uranus,3092377,7,1,0,1,0
7_1426622,overcome_sciatica_love_lobster_vulcan_uranus,1426622,7,1,0,1,0
7_3894502,overcome_sciatica_entertainment_lobster_vulcan_uranus,3894502,7,1,0,1,0
7_4451660,locale_lamb_goias,4451660,7,4,0,4,0
7_5932793,overcome_boils_lubricity_tofu_saturn_earth,5932793,7,1,0,1,0
7_1218813,overcome_boils_entertainment_tofu_vulcan_uranus,1218813,7,1,0,1,0
7_6454254,overcome_boils_love_tofu_vulcan_uranus,6454254,7,1,0,1,0
7_7299197,succumb_hangover_achievement_wonderbread_vulcan_uranus,7299197,7,1,0,1,0
7_6751736,succumb_sciatica_achievement_wonderbread_vulcan_uranus,6751736,7,1,0,1,0
7_2016836,succumb_depression_achievement_wonderbread_vulcan_uranus,2016836,7,1,0,1,0
7_3232307,succumb_grief_achievement_wonderbread_vulcan_uranus,3232307,7,1,0,1,0
7_4059168,harmony_achievement_uranus,4059168,7,2,0,2,0
7_4444921,feast_love_ham_flounder_goias_bosnia,4444921,7,1,0,1,0
7_7394767,feast_love_ham_lemon_goias_bosnia,7394767,7,1,0,1,0
7_6538810,feast_love_ham_lemon_manitoba_pennsylvania,6538810,7,1,0,1,0
7_5714052,feast_love_ham_flounder_manitoba_pennsylvania,5714052,7,1,0,1,0
7_6097893,succumb_abrasion_stimulation_beef_vulcan_uranus,6097893,7,1,0,1,0
7_2624293,succumb_abrasion_stimulation_flounder_vulcan_uranus,2624293,7,1,0,1,0
7_2500039,succumb_abrasion_stimulation_marzipan_vulcan_uranus,2500039,7,1,0,1,0
7_3816737,succumb_abrasion_stimulation_haroset_vulcan_uranus,3816737,7,1,0,1,0
7_7136732,succumb_abrasion_stimulation_lemon_vulcan_uranus,7136732,7,1,0,1,0
7_167282,succumb_abrasion_stimulation_lamb_vulcan_uranus,167282,7,1,0,1,0
7_7580506,succumb_abrasion_stimulation_lobster_vulcan_uranus,7580506,7,1,0,1,0
7_2012199,succumb_sciatica_aesthetics_lobster_uranus_saturn,2012199,7,1,0,1,0
7_5169740,succumb_sciatica_aesthetics_bacon_uranus_saturn,5169740,7,1,0,1,0
7_999135,succumb_sciatica_aesthetics_bacon_vulcan_uranus,999135,7,1,0,1,0
7_3163384,succumb_sciatica_aesthetics_beef_saturn_earth,3163384,7,1,0,1,0
7_3233979,succumb_sciatica_aesthetics_lamb_saturn_earth,3233979,7,1,0,1,0
7_1937273,succumb_sciatica_aesthetics_flounder_uranus_saturn,1937273,7,1,0,1,0
7_1132122,succumb_sciatica_aesthetics_haroset_saturn_earth,1132122,7,1,0,1,0
7_5842571,succumb_sciatica_aesthetics_lobster_vulcan_uranus,5842571,7,1,0,1,0
7_4303167,succumb_sciatica_aesthetics_flounder_saturn_earth,4303167,7,1,0,1,0
7_1221666,succumb_sciatica_aesthetics_bacon_saturn_earth,1221666,7,1,0,1,0
7_258363,succumb_sciatica_aesthetics_lamb_uranus_saturn,258363,7,1,0,1,0
7_3313713,succumb_sciatica_aesthetics_wonderbread_saturn_earth,3313713,7,1,0,1,0
7_4668313,succumb_sciatica_aesthetics_wonderbread_uranus_saturn,4668313,7,1,0,1,0
7_1865662,succumb_sciatica_aesthetics_lobster_saturn_earth,1865662,7,1,0,1,0
7_497708,succumb_sciatica_aesthetics_wonderbread_vulcan_uranus,497708,7,1,0,1,0
7_6249407,succumb_sciatica_aesthetics_haroset_uranus_saturn,6249407,7,1,0,1,0
7_2500956,succumb_sciatica_aesthetics_ham_saturn_earth,2500956,7,1,0,1,0
7_2078802,succumb_sciatica_aesthetics_haroset_vulcan_uranus,2078802,7,1,0,1,0
7_3471673,feast_learning_okra_snickers_bavaria_manitoba,3471673,7,1,0,1,0
7_4506403,feast_learning_okra_wonderbread_bavaria_manitoba,4506403,7,1,0,1,0
7_2138506,craves_learning_wonderbread,2138506,7,6,0,6,0
7_7082031,overcome_laceration_aesthetics_bacon_uranus_saturn,7082031,7,1,0,1,0
7_2911426,overcome_laceration_aesthetics_bacon_vulcan_uranus,2911426,7,1,0,1,0
7_7004995,succumb_hangover_learning_onion_vulcan_uranus,7004995,7,1,0,1,0
7_6361188,succumb_hangover_learning_wonderbread_vulcan_uranus,6361188,7,1,0,1,0
7_5513735,succumb_hangover_learning_okra_vulcan_uranus,5513735,7,1,0,1,0
7_7136924,succumb_hangover_learning_snickers_vulcan_uranus,7136924,7,1,0,1,0
7_7859946,feast_lubricity_ham_flounder_goias_bosnia,7859946,7,1,0,1,0
7_5596192,feast_lubricity_ham_lemon_goias_bosnia,5596192,7,1,0,1,0
7_3223989,feast_stimulation_ham_flounder_goias_bosnia,3223989,7,1,0,1,0
7_2616537,feast_entertainment_ham_flounder_goias_bosnia,2616537,7,1,0,1,0
7_5087114,feast_stimulation_ham_lemon_goias_bosnia,5087114,7,1,0,1,0
7_4063809,feast_entertainment_ham_lemon_goias_bosnia,4063809,7,1,0,1,0
7_7528243,succumb_grief_stimulation_haroset_vulcan_uranus,7528243,7,1,0,1,0
7_3291035,succumb_grief_stimulation_lobster_vulcan_uranus,3291035,7,1,0,1,0
7_653566,succumb_grief_stimulation_flounder_vulcan_uranus,653566,7,1,0,1,0
7_1918052,succumb_grief_stimulation_lamb_vulcan_uranus,1918052,7,1,0,1,0
7_410542,overcome_jealousy_aesthetics_flounder_uranus_saturn,410542,7,1,0,1,0
7_465631,overcome_jealousy_lubricity_flounder_uranus_saturn,465631,7,1,0,1,0
7_7249870,overcome_jealousy_entertainment_flounder_vulcan_uranus,7249870,7,1,0,1,0
7_4991169,overcome_jealousy_love_flounder_vulcan_uranus,4991169,7,1,0,1,0
7_4240914,overcome_jealousy_aesthetics_flounder_vulcan_uranus,4240914,7,1,0,1,0
7_109407,overcome_jealousy_lubricity_flounder_saturn_earth,109407,7,1,0,1,0
7_1839538,feast_lubricity_bacon_lobster_bavaria_manitoba,1839538,7,1,0,1,0
7_6784428,feast_lubricity_bacon_wonderbread_bavaria_manitoba,6784428,7,1,0,1,0
7_2009394,succumb_sciatica_learning_wonderbread_vulcan_uranus,2009394,7,1,0,1,0
7_1992186,succumb_loneliness_lubricity_onion_saturn_earth,1992186,7,1,0,1,0
7_6615430,succumb_loneliness_lubricity_marzipan_saturn_earth,6615430,7,1,0,1,0
7_96811,succumb_loneliness_lubricity_tofu_saturn_earth,96811,7,1,0,1,0
7_6505132,feast_aesthetics_lamb_haroset_pennsylvania_oregon,6505132,7,1,0,1,0
7_7955724,feast_lubricity_lamb_haroset_pennsylvania_oregon,7955724,7,1,0,1,0
7_977467,feast_lubricity_lamb_beef_pennsylvania_oregon,977467,7,1,0,1,0
7_3218509,feast_aesthetics_lamb_beef_pennsylvania_oregon,3218509,7,1,0,1,0
7_1872809,feast_entertainment_lamb_haroset_pennsylvania_oregon,1872809,7,1,0,1,0
7_2582759,feast_entertainment_lamb_beef_pennsylvania_oregon,2582759,7,1,0,1,0
7_2963097,succumb_sciatica_achievement_wonderbread_saturn_earth,2963097,7,1,0,1,0
7_6570044,succumb_depression_achievement_wonderbread_saturn_earth,6570044,7,1,0,1,0
7_2481084,overcome_prostatitis_achievement_wonderbread_uranus_saturn,2481084,7,1,0,1,0
7_696830,overcome_grief_achievement_wonderbread_uranus_saturn,696830,7,1,0,1,0
7_2897674,overcome_abrasion_achievement_wonderbread_uranus_saturn,2897674,7,1,0,1,0
7_7309516,succumb_hangover_achievement_wonderbread_saturn_earth,7309516,7,1,0,1,0
7_3224664,overcome_sciatica_achievement_wonderbread_uranus_saturn,3224664,7,1,0,1,0
7_7384849,succumb_anger_love_beef_vulcan_uranus,7384849,7,1,0,1,0
7_1906499,succumb_jealousy_love_lamb_vulcan_uranus,1906499,7,1,0,1,0
7_6846198,succumb_jealousy_love_wonderbread_vulcan_uranus,6846198,7,1,0,1,0
7_5734094,succumb_boils_love_lemon_vulcan_uranus,5734094,7,1,0,1,0
7_5622744,succumb_grief_love_flounder_vulcan_uranus,5622744,7,1,0,1,0
7_1734444,succumb_grief_love_haroset_vulcan_uranus,1734444,7,1,0,1,0
7_5531991,succumb_angina_love_ham_vulcan_uranus,5531991,7,1,0,1,0
7_7783389,succumb_jealousy_love_lobster_vulcan_uranus,7783389,7,1,0,1,0
7_5324389,succumb_jealousy_love_ham_vulcan_uranus,5324389,7,1,0,1,0
7_2320336,succumb_grief_love_bacon_vulcan_uranus,2320336,7,1,0,1,0
7_4208485,succumb_dread_love_wonderbread_vulcan_uranus,4208485,7,1,0,1,0
7_556434,succumb_anger_love_lemon_vulcan_uranus,556434,7,1,0,1,0
7_4976383,succumb_angina_love_beef_vulcan_uranus,4976383,7,1,0,1,0
7_2066332,succumb_anger_love_haroset_vulcan_uranus,2066332,7,1,0,1,0
7_3446381,succumb_prostatitis_love_marzipan_vulcan_uranus,3446381,7,1,0,1,0
7_6118731,succumb_prostatitis_love_tofu_vulcan_uranus,6118731,7,1,0,1,0
7_6556479,succumb_jealousy_love_flounder_vulcan_uranus,6556479,7,1,0,1,0
7_3627876,succumb_angina_love_cantelope_vulcan_uranus,3627876,7,1,0,1,0
7_2235676,succumb_jealousy_love_cantelope_vulcan_uranus,2235676,7,1,0,1,0
7_2575325,succumb_anger_love_flounder_vulcan_uranus,2575325,7,1,0,1,0
7_4344025,succumb_loneliness_love_tofu_vulcan_uranus,4344025,7,1,0,1,0
7_6432225,succumb_jealousy_love_marzipan_vulcan_uranus,6432225,7,1,0,1,0
7_4321572,succumb_jealousy_love_lemon_vulcan_uranus,4321572,7,1,0,1,0
7_4101321,succumb_hangover_love_wonderbread_vulcan_uranus,4101321,7,1,0,1,0
7_4019620,succumb_jealousy_love_haroset_vulcan_uranus,4019620,7,1,0,1,0
7_3062520,succumb_grief_love_lamb_vulcan_uranus,3062520,7,1,0,1,0
7_5599967,succumb_boils_love_lamb_vulcan_uranus,5599967,7,1,0,1,0
7_3478767,succumb_boils_love_cantelope_vulcan_uranus,3478767,7,1,0,1,0
7_64367,succumb_angina_love_lemon_vulcan_uranus,64367,7,1,0,1,0
7_1978464,succumb_anger_love_ham_vulcan_uranus,1978464,7,1,0,1,0
7_5498213,succumb_grief_love_lobster_vulcan_uranus,5498213,7,1,0,1,0
7_5191562,succumb_prostatitis_love_beef_vulcan_uranus,5191562,7,1,0,1,0
7_7837110,succumb_jealousy_love_beef_vulcan_uranus,7837110,7,1,0,1,0
7_2415109,succumb_jealousy_love_bacon_vulcan_uranus,2415109,7,1,0,1,0
7_7185308,succumb_anger_love_cantelope_vulcan_uranus,7185308,7,1,0,1,0
7_3467207,succumb_boils_love_flounder_vulcan_uranus,3467207,7,1,0,1,0
7_5901707,succumb_angina_love_haroset_vulcan_uranus,5901707,7,1,0,1,0
7_6463954,succumb_boils_love_ham_vulcan_uranus,6463954,7,1,0,1,0
7_311154,succumb_angina_love_flounder_vulcan_uranus,311154,7,1,0,1,0
7_5953404,succumb_prostatitis_love_cantelope_vulcan_uranus,5953404,7,1,0,1,0
7_3342953,succumb_boils_love_marzipan_vulcan_uranus,3342953,7,1,0,1,0
7_5976703,succumb_grief_love_wonderbread_vulcan_uranus,5976703,7,1,0,1,0
7_6116802,succumb_prostatitis_love_wonderbread_vulcan_uranus,6116802,7,1,0,1,0
7_763302,succumb_jealousy_love_tofu_vulcan_uranus,763302,7,1,0,1,0
7_3529601,succumb_boils_love_beef_vulcan_uranus,3529601,7,1,0,1,0
7_504497,overcome_prostatitis_love_cantelope_vulcan_uranus,504497,7,1,0,1,0
7_3682838,overcome_prostatitis_lubricity_cantelope_uranus_saturn,3682838,7,1,0,1,0
7_3903686,overcome_prostatitis_lubricity_cantelope_saturn_earth,3903686,7,1,0,1,0
7_2515022,overcome_prostatitis_entertainment_cantelope_vulcan_uranus,2515022,7,1,0,1,0
7_3042946,overcome_grief_expectation_wonderbread_vulcan_uranus,3042946,7,1,0,1,0
7_4411393,overcome_grief_love_wonderbread_vulcan_uranus,4411393,7,1,0,1,0
7_2346841,overcome_grief_aesthetics_wonderbread_uranus_saturn,2346841,7,1,0,1,0
7_1480031,overcome_grief_lubricity_wonderbread_uranus_saturn,1480031,7,1,0,1,0
7_6177213,overcome_grief_aesthetics_wonderbread_vulcan_uranus,6177213,7,1,0,1,0
7_1238012,overcome_grief_entertainment_wonderbread_vulcan_uranus,1238012,7,1,0,1,0
7_4113858,overcome_grief_lubricity_wonderbread_saturn_earth,4113858,7,1,0,1,0
7_7653449,succumb_laceration_lubricity_lemon_vulcan_uranus,7653449,7,1,0,1,0
7_7046197,succumb_jealousy_lubricity_flounder_vulcan_uranus,7046197,7,1,0,1,0
7_5684845,succumb_jealousy_lubricity_ham_vulcan_uranus,5684845,7,1,0,1,0
7_7193795,succumb_laceration_lubricity_beef_vulcan_uranus,7193795,7,1,0,1,0
7_65395,succumb_anger_lubricity_flounder_vulcan_uranus,65395,7,1,0,1,0
7_3121143,succumb_anger_lubricity_lamb_vulcan_uranus,3121143,7,1,0,1,0
7_1703691,succumb_anger_lubricity_ham_vulcan_uranus,1703691,7,1,0,1,0
7_6172488,succumb_jealousy_lubricity_lamb_vulcan_uranus,6172488,7,1,0,1,0
7_7165638,succumb_grief_lubricity_lamb_vulcan_uranus,7165638,7,1,0,1,0
7_1263184,succumb_laceration_lubricity_lamb_vulcan_uranus,1263184,7,1,0,1,0
7_3232333,succumb_anger_lubricity_lemon_vulcan_uranus,3232333,7,1,0,1,0
7_3987733,succumb_abrasion_lubricity_lamb_vulcan_uranus,3987733,7,1,0,1,0
7_2327531,succumb_abrasion_lubricity_flounder_vulcan_uranus,2327531,7,1,0,1,0
7_2203277,succumb_abrasion_lubricity_marzipan_vulcan_uranus,2203277,7,1,0,1,0
7_4102122,succumb_jealousy_lubricity_beef_vulcan_uranus,4102122,7,1,0,1,0
7_6780071,succumb_grief_lubricity_flounder_vulcan_uranus,6780071,7,1,0,1,0
7_1917367,succumb_abrasion_lubricity_beef_vulcan_uranus,1917367,7,1,0,1,0
7_1052017,succumb_abrasion_lubricity_lemon_vulcan_uranus,1052017,7,1,0,1,0
7_762711,succumb_laceration_lubricity_flounder_vulcan_uranus,762711,7,1,0,1,0
7_7757860,succumb_abrasion_lubricity_cantelope_vulcan_uranus,7757860,7,1,0,1,0
7_638457,succumb_laceration_lubricity_marzipan_vulcan_uranus,638457,7,1,0,1,0
7_1093743,overcome_sciatica_lubricity_bacon_saturn_earth,1093743,7,1,0,1,0
7_7822436,overcome_sciatica_aesthetics_bacon_vulcan_uranus,7822436,7,1,0,1,0
7_3736378,overcome_sciatica_entertainment_bacon_vulcan_uranus,3736378,7,1,0,1,0
7_3992064,overcome_sciatica_aesthetics_bacon_uranus_saturn,3992064,7,1,0,1,0
7_975261,overcome_sciatica_love_bacon_vulcan_uranus,975261,7,1,0,1,0
7_2185747,overcome_laceration_lubricity_beef_uranus_saturn,2185747,7,1,0,1,0
7_6070497,overcome_laceration_love_beef_vulcan_uranus,6070497,7,1,0,1,0
7_491172,overcome_laceration_lubricity_beef_saturn_earth,491172,7,1,0,1,0
7_6035322,overcome_laceration_entertainment_beef_vulcan_uranus,6035322,7,1,0,1,0
7_2602255,overcome_laceration_aesthetics_beef_uranus_saturn,2602255,7,1,0,1,0
7_1513392,overcome_jealousy_aesthetics_bacon_uranus_saturn,1513392,7,1,0,1,0
7_2573834,overcome_jealousy_love_bacon_vulcan_uranus,2573834,7,1,0,1,0
7_5343764,overcome_jealousy_aesthetics_bacon_vulcan_uranus,5343764,7,1,0,1,0
7_5210749,succumb_sciatica_stimulation_haroset_vulcan_uranus,5210749,7,1,0,1,0
7_973541,succumb_sciatica_stimulation_lobster_vulcan_uranus,973541,7,1,0,1,0
7_3500124,succumb_hangover_lubricity_onion_saturn_earth,3500124,7,1,0,1,0
7_4707416,succumb_hangover_lubricity_wonderbread_saturn_earth,4707416,7,1,0,1,0
7_2787547,succumb_jealousy_stimulation_lamb_vulcan_uranus,2787547,7,1,0,1,0
7_717181,succumb_jealousy_stimulation_beef_vulcan_uranus,717181,7,1,0,1,0
7_7411475,succumb_jealousy_stimulation_lobster_vulcan_uranus,7411475,7,1,0,1,0
7_7358219,succumb_jealousy_stimulation_flounder_vulcan_uranus,7358219,7,1,0,1,0
7_7233965,succumb_jealousy_stimulation_marzipan_vulcan_uranus,7233965,7,1,0,1,0
7_3647706,succumb_jealousy_stimulation_haroset_vulcan_uranus,3647706,7,1,0,1,0
7_5842504,succumb_jealousy_stimulation_lemon_vulcan_uranus,5842504,7,1,0,1,0
7_2972091,succumb_depression_learning_wonderbread_vulcan_uranus,2972091,7,1,0,1,0
7_6490525,succumb_depression_learning_snickers_vulcan_uranus,6490525,7,1,0,1,0
7_5252072,succumb_depression_learning_onion_vulcan_uranus,5252072,7,1,0,1,0
7_850069,succumb_depression_learning_okra_vulcan_uranus,850069,7,1,0,1,0
7_3800745,succumb_hangover_expectation_onion_vulcan_uranus,3800745,7,1,0,1,0
7_5814941,succumb_hangover_expectation_wonderbread_vulcan_uranus,5814941,7,1,0,1,0
7_1210430,succumb_hangover_expectation_snickers_vulcan_uranus,1210430,7,1,0,1,0
7_1822920,succumb_anxiety_expectation_onion_vulcan_uranus,1822920,7,1,0,1,0
7_1313207,succumb_hangover_expectation_okra_vulcan_uranus,1313207,7,1,0,1,0
7_4910645,feast_love_marzipan_tofu_pennsylvania_oregon,4910645,7,1,0,1,0
7_2441894,feast_love_marzipan_beef_pennsylvania_oregon,2441894,7,1,0,1,0
7_3096043,feast_love_marzipan_cantelope_pennsylvania_oregon,3096043,7,1,0,1,0
7_136884,feast_love_marzipan_beef_manitoba_pennsylvania,136884,7,1,0,1,0
7_1210982,feast_love_marzipan_cantelope_manitoba_pennsylvania,1210982,7,1,0,1,0
7_183107,feast_love_marzipan_wonderbread_pennsylvania_oregon,183107,7,1,0,1,0
7_2348506,feast_love_marzipan_wonderbread_manitoba_pennsylvania,2348506,7,1,0,1,0
7_4446503,feast_love_marzipan_tofu_manitoba_pennsylvania,4446503,7,1,0,1,0
7_1444092,overcome_laceration_lubricity_marzipan_saturn_earth,1444092,7,1,0,1,0
7_3735719,overcome_laceration_entertainment_marzipan_vulcan_uranus,3735719,7,1,0,1,0
7_6533463,overcome_laceration_love_marzipan_vulcan_uranus,6533463,7,1,0,1,0
7_6103957,overcome_laceration_lubricity_marzipan_uranus_saturn,6103957,7,1,0,1,0
7_6375147,overcome_laceration_lubricity_lemon_uranus_saturn,6375147,7,1,0,1,0
7_5758178,overcome_laceration_lubricity_lemon_saturn_earth,5758178,7,1,0,1,0
7_7120510,overcome_laceration_entertainment_lemon_vulcan_uranus,7120510,7,1,0,1,0
7_123356,overcome_laceration_love_lemon_vulcan_uranus,123356,7,1,0,1,0
7_7813735,overcome_hangover_love_onion_vulcan_uranus,7813735,7,1,0,1,0
7_753624,overcome_hangover_lubricity_onion_uranus_saturn,753624,7,1,0,1,0
7_6352815,overcome_hangover_expectation_onion_vulcan_uranus,6352815,7,1,0,1,0
7_2829614,overcome_hangover_lubricity_onion_saturn_earth,2829614,7,1,0,1,0
7_1867886,feast_lubricity_ham_lemon_manitoba_pennsylvania,1867886,7,1,0,1,0
7_2015325,feast_lubricity_ham_flounder_manitoba_pennsylvania,2015325,7,1,0,1,0
7_1437825,feast_entertainment_ham_lemon_manitoba_pennsylvania,1437825,7,1,0,1,0
7_776910,feast_entertainment_ham_flounder_manitoba_pennsylvania,776910,7,1,0,1,0
7_4170357,feast_stimulation_ham_flounder_manitoba_pennsylvania,4170357,7,1,0,1,0
7_6538550,feast_stimulation_ham_lemon_manitoba_pennsylvania,6538550,7,1,0,1,0
7_6789549,succumb_abrasion_lubricity_marzipan_saturn_earth,6789549,7,1,0,1,0
7_7407546,succumb_abrasion_lubricity_lobster_saturn_earth,7407546,7,1,0,1,0
7_3765295,succumb_abrasion_lubricity_onion_saturn_earth,3765295,7,1,0,1,0
7_6475894,succumb_abrasion_lubricity_beef_saturn_earth,6475894,7,1,0,1,0
7_7592592,succumb_abrasion_lubricity_cantelope_saturn_earth,7592592,7,1,0,1,0
7_6852542,succumb_abrasion_lubricity_flounder_saturn_earth,6852542,7,1,0,1,0
7_6546489,succumb_abrasion_lubricity_lamb_saturn_earth,6546489,7,1,0,1,0
7_1659426,succumb_abrasion_lubricity_lemon_saturn_earth,1659426,7,1,0,1,0
7_6948323,succumb_abrasion_lubricity_tofu_saturn_earth,6948323,7,1,0,1,0
7_3532515,succumb_abrasion_lubricity_wonderbread_saturn_earth,3532515,7,1,0,1,0
7_6674006,succumb_abrasion_lubricity_haroset_saturn_earth,6674006,7,1,0,1,0
7_499397,succumb_dread_aesthetics_wonderbread_vulcan_uranus,499397,7,1,0,1,0
7_1032191,succumb_dread_aesthetics_wonderbread_saturn_earth,1032191,7,1,0,1,0
7_4670002,succumb_dread_aesthetics_wonderbread_uranus_saturn,4670002,7,1,0,1,0
7_6955647,feast_lubricity_lemon_ham_bavaria_manitoba,6955647,7,1,0,1,0
7_2330190,feast_lubricity_lemon_beef_bavaria_manitoba,2330190,7,1,0,1,0
7_4239139,feast_entertainment_lemon_beef_bavaria_manitoba,4239139,7,1,0,1,0
7_1001185,feast_stimulation_lemon_cantelope_bavaria_manitoba,1001185,7,1,0,1,0
7_7375813,feast_entertainment_lemon_cantelope_bavaria_manitoba,7375813,7,1,0,1,0
7_1351859,feast_stimulation_lemon_beef_bavaria_manitoba,1351859,7,1,0,1,0
7_806102,feast_entertainment_lemon_ham_bavaria_manitoba,806102,7,1,0,1,0
7_4295251,feast_stimulation_lemon_ham_bavaria_manitoba,4295251,7,1,0,1,0
7_5457751,feast_lubricity_lemon_cantelope_bavaria_manitoba,5457751,7,1,0,1,0
7_6447545,locale_lemon_bavaria,6447545,7,0,0,0,0
7_423799,succumb_grief_lubricity_haroset_saturn_earth,423799,7,1,0,1,0
7_2055647,overcome_jealousy_lubricity_haroset_uranus_saturn,2055647,7,1,0,1,0
7_4518496,overcome_sciatica_lubricity_haroset_uranus_saturn,4518496,7,1,0,1,0
7_5250294,overcome_prostatitis_lubricity_wonderbread_uranus_saturn,5250294,7,1,0,1,0
7_1293294,succumb_jealousy_lubricity_haroset_saturn_earth,1293294,7,1,0,1,0
7_4238840,overcome_angina_lubricity_ham_uranus_saturn,4238840,7,1,0,1,0
7_1157339,succumb_grief_lubricity_lobster_saturn_earth,1157339,7,1,0,1,0
7_3623688,overcome_abrasion_lubricity_marzipan_uranus_saturn,3623688,7,1,0,1,0
7_1561788,succumb_grief_lubricity_wonderbread_saturn_earth,1561788,7,1,0,1,0
7_792836,succumb_anger_lubricity_lemon_saturn_earth,792836,7,1,0,1,0
7_2026834,succumb_jealousy_lubricity_lobster_saturn_earth,2026834,7,1,0,1,0
7_389934,succumb_jealousy_lubricity_beef_saturn_earth,389934,7,1,0,1,0
7_484533,overcome_boils_lubricity_flounder_uranus_saturn,484533,7,1,0,1,0
7_5849983,succumb_anger_lubricity_ham_saturn_earth,5849983,7,1,0,1,0
7_6835481,overcome_laceration_lubricity_cantelope_uranus_saturn,6835481,7,1,0,1,0
7_1407780,succumb_laceration_lubricity_marzipan_saturn_earth,1407780,7,1,0,1,0
7_460529,succumb_jealousy_lubricity_lamb_saturn_earth,460529,7,1,0,1,0
7_6593675,succumb_anger_lubricity_flounder_saturn_earth,6593675,7,1,0,1,0
7_433474,succumb_laceration_lubricity_haroset_saturn_earth,433474,7,1,0,1,0
7_1470773,succumb_laceration_lubricity_flounder_saturn_earth,1470773,7,1,0,1,0
7_126872,overcome_abrasion_lubricity_wonderbread_uranus_saturn,126872,7,1,0,1,0
7_7944871,overcome_angina_lubricity_flounder_uranus_saturn,7944871,7,1,0,1,0
7_7803271,succumb_jealousy_lubricity_ham_saturn_earth,7803271,7,1,0,1,0
7_7527771,succumb_grief_lubricity_lamb_saturn_earth,7527771,7,1,0,1,0
7_2941918,overcome_sciatica_lubricity_wonderbread_uranus_saturn,2941918,7,1,0,1,0
7_7602217,overcome_jealousy_lubricity_beef_uranus_saturn,7602217,7,1,0,1,0
7_7468717,overcome_prostatitis_lubricity_tofu_uranus_saturn,7468717,7,1,0,1,0
7_4909767,succumb_dread_lubricity_wonderbread_saturn_earth,4909767,7,1,0,1,0
7_3112916,overcome_laceration_lubricity_tofu_uranus_saturn,3112916,7,1,0,1,0
7_4121215,succumb_laceration_lubricity_beef_saturn_earth,4121215,7,1,0,1,0
7_5558314,succumb_jealousy_lubricity_flounder_saturn_earth,5558314,7,1,0,1,0
7_1167014,succumb_laceration_lubricity_lobster_saturn_earth,1167014,7,1,0,1,0
7_1079463,overcome_grief_lubricity_ham_uranus_saturn,1079463,7,1,0,1,0
7_4766512,succumb_anger_lubricity_haroset_saturn_earth,4766512,7,1,0,1,0
7_6228211,overcome_laceration_lubricity_flounder_uranus_saturn,6228211,7,1,0,1,0
7_6242161,overcome_depression_lubricity_onion_uranus_saturn,6242161,7,1,0,1,0
7_4191810,succumb_laceration_lubricity_lamb_saturn_earth,4191810,7,1,0,1,0
7_1671606,overcome_jealousy_lubricity_lamb_uranus_saturn,1671606,7,1,0,1,0
7_2143556,overcome_boils_lubricity_beef_uranus_saturn,2143556,7,1,0,1,0
7_6935854,succumb_laceration_lubricity_lemon_saturn_earth,6935854,7,1,0,1,0
7_6924903,overcome_boils_lubricity_ham_uranus_saturn,6924903,7,1,0,1,0
7_5500052,succumb_anger_lubricity_lobster_saturn_earth,5500052,7,1,0,1,0
7_4480352,succumb_anger_lubricity_lamb_saturn_earth,4480352,7,1,0,1,0
7_2058750,overcome_anxiety_lubricity_onion_uranus_saturn,2058750,7,1,0,1,0
7_6994950,succumb_grief_lubricity_flounder_saturn_earth,6994950,7,1,0,1,0
7_7388917,feast_aesthetics_flounder_ham_manitoba_pennsylvania,7388917,7,1,0,1,0
7_2426101,feast_aesthetics_flounder_haroset_manitoba_pennsylvania,2426101,7,1,0,1,0
7_2951898,overcome_abrasion_love_marzipan_vulcan_uranus,2951898,7,1,0,1,0
7_1340642,overcome_abrasion_lubricity_marzipan_saturn_earth,1340642,7,1,0,1,0
7_2434455,overcome_abrasion_entertainment_marzipan_vulcan_uranus,2434455,7,1,0,1,0
7_5137098,feast_entertainment_lamb_haroset_manitoba_pennsylvania,5137098,7,1,0,1,0
7_6466845,feast_entertainment_lamb_beef_bavaria_manitoba,6466845,7,1,0,1,0
7_6739043,feast_entertainment_lamb_beef_manitoba_pennsylvania,6739043,7,1,0,1,0
7_4147678,feast_entertainment_lamb_beef_goias_bosnia,4147678,7,1,0,1,0
7_5647759,feast_entertainment_lamb_haroset_bavaria_manitoba,5647759,7,1,0,1,0
7_6294953,feast_entertainment_lamb_haroset_goias_bosnia,6294953,7,1,0,1,0
7_5757847,overcome_boils_entertainment_flounder_vulcan_uranus,5757847,7,1,0,1,0
7_291644,overcome_boils_entertainment_beef_vulcan_uranus,291644,7,1,0,1,0
7_272742,overcome_jealousy_entertainment_beef_vulcan_uranus,272742,7,1,0,1,0
7_6962491,overcome_laceration_entertainment_tofu_vulcan_uranus,6962491,7,1,0,1,0
7_5574087,overcome_angina_entertainment_ham_vulcan_uranus,5574087,7,1,0,1,0
7_106781,overcome_boils_entertainment_ham_vulcan_uranus,106781,7,1,0,1,0
7_7830278,overcome_prostatitis_entertainment_wonderbread_vulcan_uranus,7830278,7,1,0,1,0
7_3859973,overcome_laceration_entertainment_flounder_vulcan_uranus,3859973,7,1,0,1,0
7_4713773,overcome_angina_entertainment_flounder_vulcan_uranus,4713773,7,1,0,1,0
7_2138017,overcome_abrasion_entertainment_wonderbread_vulcan_uranus,2138017,7,1,0,1,0
7_1053216,overcome_jealousy_entertainment_haroset_vulcan_uranus,1053216,7,1,0,1,0
7_14162,overcome_laceration_entertainment_cantelope_vulcan_uranus,14162,7,1,0,1,0
7_3543510,overcome_prostatitis_entertainment_tofu_vulcan_uranus,3543510,7,1,0,1,0
7_2343108,overcome_jealousy_entertainment_lamb_vulcan_uranus,2343108,7,1,0,1,0
7_6009202,overcome_grief_entertainment_ham_vulcan_uranus,6009202,7,1,0,1,0
7_5138251,overcome_sciatica_entertainment_wonderbread_vulcan_uranus,5138251,7,1,0,1,0
7_6245149,feast_expectation_snickers_onion_bavaria_manitoba,6245149,7,1,0,1,0
7_7618197,feast_expectation_snickers_wonderbread_bavaria_manitoba,7618197,7,1,0,1,0
7_7665601,feast_expectation_snickers_okra_bavaria_manitoba,7665601,7,1,0,1,0
7_1078849,overcome_boils_aesthetics_flounder_vulcan_uranus,1078849,7,1,0,1,0
7_916447,overcome_jealousy_aesthetics_haroset_vulcan_uranus,916447,7,1,0,1,0
7_856444,succumb_anger_aesthetics_haroset_uranus_saturn,856444,7,1,0,1,0
7_7281626,overcome_laceration_aesthetics_flounder_vulcan_uranus,7281626,7,1,0,1,0
7_3246324,overcome_prostatitis_aesthetics_wonderbread_vulcan_uranus,3246324,7,1,0,1,0
7_3810520,overcome_abrasion_aesthetics_wonderbread_vulcan_uranus,3810520,7,1,0,1,0
7_4374366,overcome_sciatica_aesthetics_wonderbread_vulcan_uranus,4374366,7,1,0,1,0
7_5507766,succumb_anger_aesthetics_flounder_uranus_saturn,5507766,7,1,0,1,0
7_2949315,overcome_jealousy_aesthetics_lamb_vulcan_uranus,2949315,7,1,0,1,0
7_6692851,overcome_angina_aesthetics_flounder_vulcan_uranus,6692851,7,1,0,1,0
7_6305720,harmony_aesthetics_earth,6305720,7,3,0,3,0
7_5527085,overcome_boils_love_beef_vulcan_uranus,5527085,7,1,0,1,0
7_5460364,overcome_boils_lubricity_beef_saturn_earth,5460364,7,1,0,1,0
7_7803313,overcome_boils_aesthetics_beef_uranus_saturn,7803313,7,1,0,1,0
7_7608485,feast_stimulation_bacon_lobster_bavaria_manitoba,7608485,7,1,0,1,0
7_938483,feast_stimulation_bacon_wonderbread_bavaria_manitoba,938483,7,1,0,1,0
7_3042773,feast_stimulation_haroset_lamb_bavaria_manitoba,3042773,7,1,0,1,0
7_7292320,feast_stimulation_haroset_flounder_bavaria_manitoba,7292320,7,1,0,1,0
7_7068455,feast_stimulation_haroset_lobster_bavaria_manitoba,7068455,7,1,0,1,0
7_5532191,feast_aesthetics_lamb_haroset_goias_bosnia,5532191,7,1,0,1,0
7_2162827,feast_aesthetics_lamb_beef_manitoba_pennsylvania,2162827,7,1,0,1,0
7_5543773,feast_aesthetics_lamb_beef_goias_bosnia,5543773,7,1,0,1,0
7_3223221,feast_aesthetics_lamb_beef_bavaria_manitoba,3223221,7,1,0,1,0
7_7986915,feast_aesthetics_lamb_haroset_manitoba_pennsylvania,7986915,7,1,0,1,0
7_6283509,feast_aesthetics_lamb_haroset_bavaria_manitoba,6283509,7,1,0,1,0
7_2466891,feast_learning_snickers_onion_bavaria_manitoba,2466891,7,1,0,1,0
7_5107816,feast_learning_snickers_wonderbread_bavaria_manitoba,5107816,7,1,0,1,0
7_1212556,feast_learning_snickers_okra_bavaria_manitoba,1212556,7,1,0,1,0
7_5395676,locale_bacon_bavaria,5395676,7,0,0,0,0
7_328749,feast_love_haroset_flounder_bavaria_manitoba,328749,7,1,0,1,0
7_7135015,feast_love_haroset_lobster_bavaria_manitoba,7135015,7,1,0,1,0
7_5112850,feast_love_haroset_lamb_bavaria_manitoba,5112850,7,1,0,1,0
7_4951120,overcome_jealousy_love_haroset_vulcan_uranus,4951120,7,1,0,1,0
7_115618,overcome_jealousy_lubricity_haroset_saturn_earth,115618,7,1,0,1,0
7_5087052,overcome_jealousy_aesthetics_haroset_uranus_saturn,5087052,7,1,0,1,0
7_2505325,overcome_hangover_expectation_snickers_vulcan_uranus,2505325,7,1,0,1,0
7_726895,feast_aesthetics_haroset_flounder_bavaria_manitoba,726895,7,1,0,1,0
7_3524044,feast_lubricity_haroset_lobster_bavaria_manitoba,3524044,7,1,0,1,0
7_7114488,feast_lubricity_haroset_lamb_bavaria_manitoba,7114488,7,1,0,1,0
7_6997780,feast_entertainment_haroset_flounder_bavaria_manitoba,6997780,7,1,0,1,0
7_5442106,feast_entertainment_haroset_lobster_bavaria_manitoba,5442106,7,1,0,1,0
7_4033505,feast_lubricity_haroset_flounder_bavaria_manitoba,4033505,7,1,0,1,0
7_718803,feast_entertainment_haroset_lamb_bavaria_manitoba,718803,7,1,0,1,0
7_1354553,feast_aesthetics_haroset_lamb_bavaria_manitoba,1354553,7,1,0,1,0
7_2073452,feast_aesthetics_haroset_lobster_bavaria_manitoba,2073452,7,1,0,1,0
7_7733722,locale_haroset_bavaria,7733722,7,0,0,0,0
7_6563539,succumb_dread_learning_wonderbread_vulcan_uranus,6563539,7,1,0,1,0
7_5717126,succumb_anxiety_learning_onion_vulcan_uranus,5717126,7,1,0,1,0
7_3537385,feast_lubricity_lamb_haroset_goias_bosnia,3537385,7,1,0,1,0
7_4042467,feast_lubricity_lamb_haroset_bavaria_manitoba,4042467,7,1,0,1,0
7_6375513,feast_lubricity_lamb_haroset_manitoba_pennsylvania,6375513,7,1,0,1,0
7_4615413,feast_lubricity_lamb_beef_bavaria_manitoba,4615413,7,1,0,1,0
7_5680061,feast_lubricity_lamb_beef_goias_bosnia,5680061,7,1,0,1,0
7_7169104,feast_lubricity_lamb_beef_manitoba_pennsylvania,7169104,7,1,0,1,0
7_2304645,feast_lubricity_ham_lemon_bavaria_manitoba,2304645,7,1,0,1,0
7_716016,feast_lubricity_ham_flounder_bavaria_manitoba,716016,7,1,0,1,0
7_6896196,overcome_jealousy_lubricity_lamb_saturn_earth,6896196,7,1,0,1,0
7_646945,overcome_anxiety_lubricity_onion_saturn_earth,646945,7,1,0,1,0
7_2594290,overcome_sciatica_lubricity_haroset_saturn_earth,2594290,7,1,0,1,0
7_1507085,overcome_laceration_lubricity_flounder_saturn_earth,1507085,7,1,0,1,0
7_7885585,overcome_boils_lubricity_ham_saturn_earth,7885585,7,1,0,1,0
7_4909931,overcome_prostatitis_lubricity_wonderbread_saturn_earth,4909931,7,1,0,1,0
7_5889325,overcome_angina_lubricity_flounder_saturn_earth,5889325,7,1,0,1,0
7_569525,overcome_depression_lubricity_onion_saturn_earth,569525,7,1,0,1,0
7_4699820,overcome_prostatitis_lubricity_tofu_saturn_earth,4699820,7,1,0,1,0
7_422019,overcome_boils_lubricity_flounder_saturn_earth,422019,7,1,0,1,0
7_7322667,overcome_laceration_lubricity_cantelope_saturn_earth,7322667,7,1,0,1,0
7_1650517,overcome_sciatica_lubricity_wonderbread_saturn_earth,1650517,7,1,0,1,0
7_4827410,overcome_abrasion_lubricity_wonderbread_saturn_earth,4827410,7,1,0,1,0
7_5862507,overcome_grief_lubricity_ham_saturn_earth,5862507,7,1,0,1,0
7_1843106,overcome_angina_lubricity_ham_saturn_earth,1843106,7,1,0,1,0
7_963601,overcome_laceration_lubricity_tofu_saturn_earth,963601,7,1,0,1,0
7_6825601,overcome_jealousy_lubricity_beef_saturn_earth,6825601,7,1,0,1,0
7_5899270,overcome_depression_love_onion_vulcan_uranus,5899270,7,1,0,1,0
7_3190658,overcome_depression_expectation_onion_vulcan_uranus,3190658,7,1,0,1,0
7_2862479,overcome_angina_aesthetics_flounder_uranus_saturn,2862479,7,1,0,1,0
7_939869,overcome_angina_love_flounder_vulcan_uranus,939869,7,1,0,1,0
7_5663830,overcome_sciatica_love_haroset_vulcan_uranus,5663830,7,1,0,1,0
7_3499213,overcome_sciatica_aesthetics_haroset_uranus_saturn,3499213,7,1,0,1,0
7_4686816,succumb_anger_aesthetics_haroset_vulcan_uranus,4686816,7,1,0,1,0
7_1475265,feast_love_flounder_ham_manitoba_pennsylvania,1475265,7,1,0,1,0
7_1518752,feast_love_flounder_haroset_manitoba_pennsylvania,1518752,7,1,0,1,0
7_3595591,feast_entertainment_beef_lamb_pennsylvania_oregon,3595591,7,1,0,1,0
7_6207230,feast_entertainment_beef_marzipan_pennsylvania_oregon,6207230,7,1,0,1,0
7_7065323,feast_entertainment_beef_marzipan_manitoba_pennsylvania,7065323,7,1,0,1,0
7_1092171,feast_entertainment_beef_lemon_manitoba_pennsylvania,1092171,7,1,0,1,0
7_5289058,feast_entertainment_beef_lemon_pennsylvania_oregon,5289058,7,1,0,1,0
7_7591803,feast_entertainment_beef_lamb_manitoba_pennsylvania,7591803,7,1,0,1,0
7_6657717,overcome_laceration_love_flounder_vulcan_uranus,6657717,7,1,0,1,0
7_3451254,overcome_laceration_aesthetics_flounder_uranus_saturn,3451254,7,1,0,1,0
7_3139599,succumb_prostatitis_stimulation_lemon_vulcan_uranus,3139599,7,1,0,1,0
7_1981143,succumb_boils_stimulation_beef_vulcan_uranus,1981143,7,1,0,1,0
7_4711081,succumb_boils_stimulation_flounder_vulcan_uranus,4711081,7,1,0,1,0
7_4586827,succumb_boils_stimulation_marzipan_vulcan_uranus,4586827,7,1,0,1,0
7_1376719,succumb_boils_stimulation_lemon_vulcan_uranus,1376719,7,1,0,1,0
7_7988762,succumb_prostatitis_stimulation_beef_vulcan_uranus,7988762,7,1,0,1,0
7_4051509,succumb_boils_stimulation_lamb_vulcan_uranus,4051509,7,1,0,1,0
7_3574155,succumb_prostatitis_stimulation_marzipan_vulcan_uranus,3574155,7,1,0,1,0
7_2058151,succumb_prostatitis_stimulation_lamb_vulcan_uranus,2058151,7,1,0,1,0
7_5724494,feast_aesthetics_beef_lemon_manitoba_pennsylvania,5724494,7,1,0,1,0
7_4231341,feast_aesthetics_beef_lamb_pennsylvania_oregon,4231341,7,1,0,1,0
7_528591,feast_aesthetics_beef_marzipan_manitoba_pennsylvania,528591,7,1,0,1,0
7_20541,feast_aesthetics_beef_lemon_pennsylvania_oregon,20541,7,1,0,1,0
7_3015587,feast_aesthetics_beef_lamb_manitoba_pennsylvania,3015587,7,1,0,1,0
7_7937322,feast_aesthetics_beef_marzipan_pennsylvania_oregon,7937322,7,1,0,1,0
7_543994,overcome_sciatica_aesthetics_wonderbread_uranus_saturn,543994,7,1,0,1,0
7_6911181,succumb_anger_aesthetics_flounder_saturn_earth,6911181,7,1,0,1,0
7_7416929,overcome_prostatitis_aesthetics_wonderbread_uranus_saturn,7416929,7,1,0,1,0
7_7981125,overcome_abrasion_aesthetics_wonderbread_uranus_saturn,7981125,7,1,0,1,0
7_7119920,overcome_jealousy_aesthetics_lamb_uranus_saturn,7119920,7,1,0,1,0
7_39918,overcome_boils_aesthetics_ham_uranus_saturn,39918,7,1,0,1,0
7_88513,succumb_anger_aesthetics_ham_saturn_earth,88513,7,1,0,1,0
7_491812,overcome_angina_aesthetics_ham_uranus_saturn,491812,7,1,0,1,0
7_7705611,succumb_anger_aesthetics_haroset_saturn_earth,7705611,7,1,0,1,0
7_5049554,overcome_jealousy_aesthetics_beef_uranus_saturn,5049554,7,1,0,1,0
7_5249454,overcome_boils_aesthetics_flounder_uranus_saturn,5249454,7,1,0,1,0
7_2250911,overcome_jealousy_love_lamb_vulcan_uranus,2250911,7,1,0,1,0
7_7535671,feast_entertainment_flounder_haroset_manitoba_pennsylvania,7535671,7,1,0,1,0
7_4539100,feast_entertainment_flounder_ham_manitoba_pennsylvania,4539100,7,1,0,1,0
7_20887,feast_lubricity_beef_lamb_manitoba_pennsylvania,20887,7,1,0,1,0
7_7175086,feast_lubricity_beef_lemon_manitoba_pennsylvania,7175086,7,1,0,1,0
7_4060483,feast_lubricity_beef_marzipan_manitoba_pennsylvania,4060483,7,1,0,1,0
7_5381035,succumb_hangover_expectation_snickers_uranus_saturn,5381035,7,1,0,1,0
7_1984569,succumb_hangover_expectation_wonderbread_uranus_saturn,1984569,7,1,0,1,0
7_5483812,succumb_hangover_expectation_okra_uranus_saturn,5483812,7,1,0,1,0
7_7971350,succumb_hangover_expectation_onion_uranus_saturn,7971350,7,1,0,1,0
7_765503,locale_okra_bavaria,765503,7,0,0,0,0
7_5993525,succumb_anxiety_expectation_onion_uranus_saturn,5993525,7,1,0,1,0
7_645244,overcome_anxiety_expectation_onion_vulcan_uranus,645244,7,1,0,1,0
7_1062052,overcome_anxiety_love_onion_vulcan_uranus,1062052,7,1,0,1,0
7_180545,overcome_jealousy_love_beef_vulcan_uranus,180545,7,1,0,1,0
7_7096833,overcome_boils_love_ham_vulcan_uranus,7096833,7,1,0,1,0
7_3625932,overcome_boils_love_flounder_vulcan_uranus,3625932,7,1,0,1,0
7_7050231,overcome_prostatitis_love_tofu_vulcan_uranus,7050231,7,1,0,1,0
7_7529475,overcome_angina_love_ham_vulcan_uranus,7529475,7,1,0,1,0
7_4149673,overcome_laceration_love_cantelope_vulcan_uranus,4149673,7,1,0,1,0
7_146217,overcome_sciatica_love_wonderbread_vulcan_uranus,146217,7,1,0,1,0
7_6997666,overcome_laceration_love_tofu_vulcan_uranus,6997666,7,1,0,1,0
7_6153114,overcome_prostatitis_love_wonderbread_vulcan_uranus,6153114,7,1,0,1,0
7_3048257,overcome_abrasion_love_wonderbread_vulcan_uranus,3048257,7,1,0,1,0
7_1990299,feast_lubricity_beef_lamb_pennsylvania_oregon,1990299,7,1,0,1,0
7_2384133,feast_lubricity_beef_lemon_pennsylvania_oregon,2384133,7,1,0,1,0
7_3242955,feast_lubricity_beef_marzipan_pennsylvania_oregon,3242955,7,1,0,1,0
7_5243790,overcome_abrasion_expectation_wonderbread_vulcan_uranus,5243790,7,1,0,1,0
7_4827200,overcome_prostatitis_expectation_wonderbread_vulcan_uranus,4827200,7,1,0,1,0
7_5570780,overcome_sciatica_expectation_wonderbread_vulcan_uranus,5570780,7,1,0,1,0
7_2639657,locale_snickers_bavaria,2639657,7,0,0,0,0
